601,19143,9349,9794,3865,4274,1210,3553,4782,1459
602,42042,20714,21328,7955,10322,2437,7612,10903,2813
603,55592,27290,28302,9404,13625,4261,9157,14079,5066
604,3844,1827,2017,867,798,162,755,1085,177
606,6449,3136,3313,1252,1454,430,1292,1612,409
610,28005,13582,14423,5003,6675,1904,4836,7444,2143
612,72865,34890,37975,12128,16806,5956,11419,19076,7480
616,10525,5022,5503,1780,2403,839,1717,2887,899
617,23223,11394,11829,4201,5686,1507,3986,5989,1854
622,8284,4135,4149,1261,2002,872,1155,2065,929
623,38627,18485,20142,6156,9029,3300,5967,10244,3931
624,26719,13262,13457,5663,6037,1562,5345,6489,1623
627,35244,17315,17929,6544,8574,2197,6157,9028,2744
631,2169,1112,1057,458,463,191,350,528,179
637,25935,12416,13519,4717,5711,1988,4339,6899,2281
638,19648,9758,9890,3860,4531,1367,3952,4526,1412
641,35095,17335,17760,6763,8068,2504,6239,8655,2866
646,34114,16355,17759,6024,8188,2143,5989,9348,2422
647,5352,2655,2697,851,1222,582,842,1217,638
650,12207,5901,6306,2257,2816,828,2203,3315,788
652,2903,1503,1400,491,771,241,479,643,278
653,16536,8042,8494,3416,3675,951,3079,4120,1295
656,23072,11253,11819,4456,5236,1561,4154,5805,1860
659,38925,18748,20177,6891,9224,2633,6925,10223,3029
660,16614,7710,8904,2400,3746,1564,2376,4587,1941
662,42178,20344,21834,7108,10061,3175,7178,10921,3735
664,17318,8745,8573,3587,4148,1010,3416,4081,1076
667,26637,12981,13656,4538,6326,2117,4262,6849,2545
669,32246,15803,16443,6095,7402,2306,5809,7992,2642
670,11174,5510,5664,2081,2696,733,2063,2837,764
674,45874,21987,23887,8247,10476,3264,8096,12015,3776
676,39697,19522,20175,7351,9760,2411,7289,10408,2478
677,14767,7217,7550,2466,3511,1240,2286,3844,1420
678,27271,13439,13832,5106,6521,1812,4977,6919,1936
680,75090,36219,38871,13121,17324,5774,12393,18692,7786
682,25138,11860,13278,4637,5263,1960,4167,6422,2689
683,35165,16915,18250,5912,8119,2884,5721,9185,3344
685,44649,21816,22833,7889,10188,3739,7462,11306,4065
687,29965,14875,15090,6368,6841,1666,6007,7307,1776
688,13501,7043,6458,2413,3772,858,2206,3287,965
690,5249,2616,2633,1038,1198,380,756,1435,442
692,35223,16842,18381,6862,7860,2120,6326,9464,2591
693,64054,30601,33453,11532,14964,4105,11719,16695,5039
698,46384,22639,23745,8861,10637,3141,7957,12067,3721
703,28752,14153,14599,5279,6881,1993,5296,7230,2073
704,7593,3643,3950,1567,1645,431,1508,1884,558
705,26493,12865,13628,5001,6091,1773,4866,6682,2080
707,12741,6232,6509,2371,2959,902,2348,3209,952
714,19117,9082,10035,3629,4223,1230,3586,4947,1502
715,2268,1176,1092,396,540,240,343,523,226
716,38859,17994,20865,6974,8284,2736,7072,10125,3668
717,23083,10162,12921,3607,4437,2118,3798,5629,3494
718,23753,11759,11994,4375,5678,1706,4080,6026,1888
719,29921,14877,15044,5818,7314,1745,5725,7305,2014
720,23844,12048,11796,5096,5575,1377,4727,5389,1680
723,20152,10002,10150,3855,4700,1447,3424,5060,1666
725,144024,68178,75846,24900,33190,10088,23804,38840,13202
728,52069,25980,26089,10353,12687,2940,9496,13060,3533
729,50982,24719,26263,10011,11932,2776,9671,13539,3053
730,38828,19022,19806,6952,9301,2769,6660,9524,3622
731,21351,10304,11047,4155,4790,1359,4287,5266,1494
735,18004,8980,9024,3215,4782,983,3036,4694,1294
736,49673,24102,25571,8829,11764,3509,8494,12959,4118
738,38173,17993,20180,6465,8590,2938,6386,10072,3722
739,40450,20028,20422,7864,9847,2317,7420,10507,2495
740,2539,1156,1383,451,530,175,465,690,228
741,5819,2719,3100,1129,1237,353,1048,1597,455
745,52362,25631,26731,9725,12484,3422,9213,13827,3691
751,23895,11514,12381,4534,5377,1603,4404,6075,1902
754,40997,20217,20780,7705,9844,2668,7260,10468,3052
757,21665,10300,11365,4329,4721,1250,4191,5600,1574
765,9106,4467,4639,1695,1949,823,1575,2110,954
766,27913,14034,13879,6273,6309,1452,5503,6706,1670
767,39246,19297,19949,7326,9569,2402,7166,10126,2657
769,37597,18382,19215,7428,8422,2532,6889,9364,2962
771,34485,16831,17654,6391,8334,2106,6121,9270,2263
772,24890,11894,12996,5362,5312,1220,5212,6305,1479
773,19817,9613,10204,3587,4570,1456,3489,5040,1675
775,1868,909,959,308,441,160,277,506,176
777,36452,17589,18863,6607,8861,2121,6358,9864,2641
778,36743,18022,18721,6705,9160,2157,6359,9929,2433
780,10017,4983,5034,1955,2554,474,1734,2629,671
782,18897,9375,9522,3826,4359,1190,3448,4716,1358
783,36867,18179,18688,7285,8677,2217,7042,9145,2501
784,43926,21751,22175,8141,11023,2587,8050,10888,3237
791,53216,25346,27870,9693,12123,3530,9143,14298,4429
794,28909,14096,14813,6258,6339,1499,6089,6902,1822
795,50531,24602,25929,10068,11700,2834,9840,12726,3363
901,7418,3356,4062,1074,1633,649,1072,2099,891
906,545,289,256,162,99,28,93,134,29
907,22173,10524,11649,2529,5705,2290,2132,6179,3338
909,7671,3339,4332,1059,1746,534,1114,2308,910
911,9345,4331,5014,817,2608,906,980,2427,1607
912,7992,3748,4244,1195,1956,597,1041,2157,1046
913,10893,4747,6146,2280,2036,431,2326,2799,1021
915,35993,16957,19036,6161,8175,2621,6052,9341,3643
917,26165,12140,14025,4023,5921,2196,3791,7006,3228
918,18144,7715,10429,2239,4082,1394,2296,5429,2704
920,19424,8667,10757,2302,4308,2057,2392,5022,3343
921,45230,21590,23640,6844,11407,3339,6889,11326,5425
923,31410,14315,17095,5214,6751,2350,5108,8374,3613
924,62205,28114,34091,11439,12263,4412,11280,16234,6577
925,8101,3682,4419,1152,2068,462,1799,2079,541
926,102545,47812,54733,17035,23841,6936,16428,28606,9699
927,16560,7211,9349,2102,3657,1452,2002,4848,2499
934,722,373,349,63,310,0,147,202,0
949,81694,39072,42622,14986,19301,4785,14291,22390,5941
952,12028,5958,6070,2262,2856,840,2104,2954,1012
953,62470,30397,32073,12249,15131,3017,11985,16880,3208
956,80844,38840,42004,14241,18206,6393,13072,20886,8046
957,50620,23572,27048,8832,11223,3517,8703,13645,4700
959,53465,24824,28641,8606,12066,4152,8389,14038,6214
961,39407,20189,19218,6858,10913,2418,5772,10251,3195
962,30071,14303,15768,6036,6455,1812,5718,7800,2250
965,9397,5037,4360,1635,2758,644,1518,2048,794
966,15785,7349,8436,2128,3746,1475,2019,4399,2018
968,3885,1559,2326,318,797,444,353,1187,786
969,48787,22713,26074,8759,11009,2945,7985,13899,4190
971,29136,14380,14756,5111,7149,2120,4690,7580,2486
976,73465,35117,38348,13085,17659,4373,12679,20280,5389
979,18681,8788,9893,2190,4830,1768,1990,5600,2303
982,14641,6753,7888,2004,3178,1571,1814,3716,2358
983,47396,21530,25866,8003,10222,3305,7720,13336,4810
985,60824,28765,32059,10443,14224,4098,9852,17049,5158
987,40879,19286,21593,7936,9512,1838,7484,11763,2346
1001,16475,7738,8737,1952,4233,1553,1805,4436,2496
1002,36776,17593,19183,8748,7570,1275,9844,7494,1845
1005,5079,2493,2586,781,1361,351,854,1267,465
1007,12997,6376,6621,2049,3663,664,1912,3845,864
1008,1234,632,602,186,371,75,171,350,81
1010,3350,1660,1690,551,884,225,497,920,273
1011,2085,1086,999,371,571,144,297,545,157
1012,521,272,249,87,156,29,68,155,26
1013,22963,10499,12464,3154,5544,1801,3510,6103,2851
1020,29325,14197,15128,4025,7299,2873,3633,7554,3941
1022,2365,1170,1195,432,524,214,303,567,325
1026,1079,543,536,190,268,85,158,301,77
1027,17493,8453,9040,2331,4958,1164,2080,5282,1678
1028,14195,6893,7302,2177,3368,1348,1839,3544,1919
1029,581,303,278,92,151,60,64,155,59
1030,11669,5655,6014,1808,3170,677,1775,3231,1008
1031,1243,599,644,200,313,86,203,302,139
1032,201,78,123,11,56,11,23,89,11
1033,6134,2984,3150,896,1654,434,866,1774,510
1034,1929,979,950,297,524,158,266,541,143
1035,4793,2245,2548,572,1224,449,593,1295,660
1036,5076,2438,2638,741,1254,443,759,1322,557
1037,740,394,346,157,181,56,121,180,45
1038,2652,1291,1361,359,688,244,304,721,336
1039,1085,498,587,98,312,88,125,347,115
1040,39838,18699,21139,7153,8678,2868,6677,9919,4543
1050,2385,1185,1200,392,653,140,362,665,173
1053,1514,654,860,164,328,162,230,380,250
1054,1453,737,716,206,422,109,183,422,111
1056,21149,10911,10238,2958,6204,1749,2565,5269,2404
1057,8299,4101,4198,1304,2248,549,1247,2290,661
1060,16261,6375,9886,1336,4078,961,3298,4916,1672
1062,11172,5425,5747,1419,3131,875,1381,3307,1059
1068,1713,869,844,306,479,84,281,478,85
1069,9879,4920,4959,1637,2533,750,1259,2592,1108
1070,548,262,286,68,132,62,79,151,56
1071,1649,829,820,265,459,105,236,455,129
1072,1489,722,767,246,427,49,236,473,58
1073,5387,2617,2770,769,1527,321,810,1534,426
1075,17254,7166,10088,1927,3690,1549,3346,4540,2202
1077,8835,4439,4396,1403,2439,597,1302,2315,779
1080,2585,1171,1414,405,595,171,398,684,332
1081,1620,806,814,252,462,92,212,495,107
1082,9955,4797,5158,1504,2575,718,1478,2588,1092
1083,2297,1102,1195,338,624,140,393,630,172
1084,161,91,70,40,34,17,14,40,16
1085,40734,19929,20805,6751,10386,2792,6501,10273,4031
1088,522,242,280,25,177,40,71,161,48
1089,27899,13435,14464,3929,7067,2439,3776,7332,3356
1092,1126,522,604,111,287,124,208,264,132
1095,13672,6584,7088,2091,3249,1244,1960,3449,1679
1096,2641,1288,1353,321,763,204,370,785,198
1098,1169,558,611,165,316,77,160,348,103
1103,2721,1274,1447,338,764,172,396,798,253
1104,22401,10578,11823,3837,4896,1845,3417,5460,2946
1105,13161,6341,6820,2587,3159,595,2387,3423,1010
1106,15903,7447,8456,2387,3465,1595,2303,4047,2106
1107,11336,5545,5791,2532,2478,535,2335,2749,707
1108,25755,12290,13465,4615,6381,1294,4421,7147,1897
1109,30851,14272,16579,6520,6088,1664,6467,7461,2651
1118,14199,6612,7587,2099,3317,1196,1950,3931,1706
1119,13138,6229,6909,2443,2888,898,2375,3342,1192
1128,2917,1372,1545,372,779,221,389,789,367
1129,7043,3412,3631,1093,1866,453,911,2066,654
1151,8290,3986,4304,1496,1975,515,1331,2155,818
1201,47658,22662,24996,6516,11739,4407,6356,12261,6379
1220,9404,4443,4961,1246,2245,952,1222,2373,1366
1222,825,368,457,114,198,56,154,222,81
1223,1764,889,875,247,471,171,244,484,147
1225,2806,1409,1397,433,727,249,363,777,257
1226,7858,3826,4032,1286,1975,565,1100,2060,872
1230,9242,4387,4855,1343,2185,859,1256,2328,1271
1235,2538,1287,1251,399,704,184,355,705,191
1236,2015,936,1079,255,493,188,253,577,249
1237,2449,1192,1257,358,654,180,336,708,213
1238,6402,3173,3229,912,1656,605,832,1636,761
1240,5285,2402,2883,614,1161,627,562,1423,898
1242,106,67,39,26,23,18,9,23,7
1244,0,0,0,0,0,0,0,0,0
1245,973,472,501,101,272,99,104,283,114
1247,17052,7985,9067,2383,4106,1496,2590,4115,2362
1253,644,337,307,88,188,61,74,170,63
1254,998,486,512,127,256,103,107,264,141
1255,783,425,358,83,223,119,88,181,89
1256,692,377,315,111,202,64,54,200,61
1257,2335,1153,1182,326,593,234,274,663,245
1258,134,71,63,12,37,22,8,32,23
1259,521,274,247,70,150,54,55,133,59
1262,772,317,455,46,188,83,62,262,131
1264,233,109,124,10,54,45,39,48,37
1266,1742,886,856,269,457,160,215,442,199
1267,8749,4055,4694,1616,1627,812,1691,1798,1205
1301,18483,8639,9844,2477,4730,1432,2439,4984,2421
1330,1601,788,813,258,428,102,199,494,120
1331,12899,6281,6618,2007,3235,1039,1923,3159,1536
1337,2619,1286,1333,376,700,210,356,700,277
1338,21,11,10,3,8,0,0,7,3
1339,2051,1031,1020,319,532,180,314,554,152
1340,1875,965,910,322,497,146,268,495,147
1341,1745,873,872,264,499,110,231,521,120
1342,1013,476,537,125,268,83,149,301,87
1344,832,412,420,111,248,53,108,248,64
1346,334,156,178,50,91,15,71,88,19
1349,1644,852,792,224,511,117,234,410,148
1350,55,21,34,7,11,3,6,13,15
1351,2422,1089,1333,267,675,147,343,774,216
1355,889,464,425,135,270,59,105,261,59
1360,2951,1412,1539,458,745,209,428,829,282
1364,7564,3678,3886,1237,1870,571,1080,2021,785
1366,1174,582,592,160,324,98,122,323,147
1367,374,175,199,37,97,41,60,98,41
1368,1269,680,589,230,377,73,205,308,76
1370,4351,2120,2231,671,1078,371,497,1178,556
1373,5300,2607,2693,684,1492,431,682,1446,565
1375,3787,1833,1954,544,1147,142,576,1163,215
1376,6422,3085,3337,932,1603,550,857,1609,871
1378,753,360,393,97,214,49,122,190,81
1379,938,499,439,191,267,41,112,303,24
1380,40,15,25,2,13,0,12,9,4
1420,39102,18694,20408,6326,9639,2729,6282,9799,4327
1430,5569,2818,2751,986,1524,308,876,1531,344
1431,2845,1428,1417,483,777,168,449,761,207
1432,8029,4188,3841,1058,2747,383,972,2097,772
1436,3053,1534,1519,487,743,304,366,769,384
1438,128,53,75,20,28,5,35,40,0
1440,21111,10756,10355,3004,6005,1747,2888,5083,2384
1450,9547,4770,4777,1786,2568,416,1630,2614,533
1451,5031,2492,2539,865,1243,384,783,1427,329
1452,3909,1989,1920,699,1119,171,646,1070,204
1453,41447,19930,21517,6475,10713,2742,5905,11407,4205
1460,8184,3897,4287,1181,2161,555,1329,2219,739
1462,9401,4722,4679,1502,2477,743,1267,2619,793
1463,11142,5502,5640,2006,3017,479,1873,3144,623
1464,6368,3684,2684,872,2447,365,792,1487,405
1467,208,88,120,36,52,0,45,53,22
1468,3300,1700,1600,580,924,196,496,899,205
1469,6072,3026,3046,1152,1612,262,1008,1753,285
1473,6907,3395,3512,1087,1844,464,1039,1921,552
1474,3131,1557,1574,531,899,127,555,841,178
1475,9571,4742,4829,1769,2425,548,1598,2471,760
1501,15827,7442,8385,1935,4084,1423,2068,4232,2085
1503,2380,1195,1185,359,659,177,334,636,215
1504,8804,4383,4421,1467,2451,465,1354,2334,733
1505,4008,1978,2030,532,1155,291,529,1152,349
1506,3051,1498,1553,468,793,237,441,811,301
1507,11263,5546,5717,1942,3066,538,1807,3281,629
1510,13435,6395,7040,1792,3566,1037,1770,3697,1573
1515,2097,1039,1058,316,557,166,292,563,203
1516,7067,3529,3538,1220,2005,304,1135,1983,420
1518,2306,1105,1201,380,604,121,380,643,178
1519,5701,2841,2860,948,1615,278,791,1681,388
1520,12702,6158,6544,1973,3102,1083,1844,3242,1458
1521,2407,1226,1181,382,704,140,358,678,145
1522,2919,1458,1461,474,774,210,448,835,178
1523,7236,4079,3157,1007,2615,457,950,1649,558
1524,6178,2998,3180,980,1589,429,1015,1583,582
1527,12784,6106,6678,1737,3310,1059,1634,3533,1511
1529,2724,1360,1364,497,747,116,453,748,163
1531,907,459,448,167,251,41,147,238,63
1532,14013,6857,7156,2323,3710,824,2232,3902,1022
1534,4710,2259,2451,689,1286,284,661,1241,549
1535,4683,2310,2373,741,1228,341,684,1239,450
1536,6430,2931,3499,802,1692,437,1012,1862,625
1537,1798,837,961,223,479,135,247,577,137
1540,11523,5570,5953,1864,3048,658,1728,3210,1015
1541,3353,1705,1648,602,907,196,502,957,189
1542,1926,895,1031,292,477,126,286,443,302
1543,6353,3216,3137,1183,1758,275,1039,1761,337
1545,31658,15387,16271,4560,8568,2259,4366,8811,3094
1550,17214,8055,9159,2588,4243,1224,2621,4613,1925
1560,2776,1357,1419,464,733,160,390,760,269
1562,11691,5730,5961,1735,3126,869,1715,3175,1071
1564,7257,3596,3661,1167,1974,455,1069,2147,445
1566,5531,2758,2773,818,1408,532,684,1508,581
1568,5629,2768,2861,966,1528,274,830,1606,425
1569,11089,5483,5606,1909,2951,623,1743,3064,799
1570,15700,7521,8179,2214,4035,1272,2161,4044,1974
1571,10751,5243,5508,1733,2753,757,1607,2874,1027
1581,17997,8880,9117,2976,4905,999,2685,4853,1579
1583,6195,2983,3212,896,1463,624,845,1619,748
1585,5569,2577,2992,786,1282,509,722,1454,816
1588,8517,4030,4487,1392,2040,598,1342,2309,836
1590,8250,4099,4151,1359,2276,464,1370,2286,495
1602,22983,10666,12317,3177,5500,1989,3312,6141,2864
1603,17606,8490,9116,2782,4593,1115,2738,4628,1750
1604,33519,16031,17488,4534,8751,2746,4034,9175,4279
1605,24410,11237,13173,3973,5807,1457,4124,6249,2800
1606,19905,10088,9817,2632,5802,1654,2367,5175,2275
1607,7416,3501,3915,1071,1911,519,1134,2149,632
1608,3222,1681,1541,750,850,81,534,906,101
1609,21314,10815,10499,4355,5027,1433,3988,4557,1954
1610,23615,11831,11784,5232,5601,998,5029,5299,1456
1611,2398,1224,1174,430,639,155,346,682,146
1612,4386,2072,2314,718,1012,342,851,1069,394
1701,31010,14822,16188,3863,8399,2560,3764,8971,3453
1702,36061,17054,19007,4747,10178,2129,5216,10719,3072
1718,438,237,201,83,147,7,28,166,7
1719,4868,2501,2367,835,1495,171,782,1408,177
1720,19813,9751,10062,3165,5608,978,3076,5718,1268
1721,14674,7074,7600,2069,4137,868,2031,4478,1091
1730,12566,6214,6352,1681,3083,1450,1591,3251,1510
1731,2933,1538,1395,650,888,0,597,792,6
1740,4148,2074,2074,683,1197,194,628,1252,194
1741,4717,2354,2363,817,1189,348,731,1289,343
1742,17073,8478,8595,2279,4571,1628,2373,4197,2025
1745,340,169,171,28,117,24,20,84,67
1746,13801,6844,6957,2412,3637,795,2131,3903,923
1747,5696,2680,3016,813,1450,417,809,1565,642
1748,13346,6596,6750,2538,3526,532,2269,3772,709
1749,18113,8968,9145,2628,5062,1278,2374,5028,1743
1752,36255,17769,18486,4835,10672,2262,4710,10550,3226
1754,10433,5024,5409,1529,2852,643,1249,3159,1001
1756,5286,2607,2679,881,1461,265,862,1477,340
1757,27010,13135,13875,3999,7406,1730,3693,7590,2592
1760,31887,15163,16724,4196,8513,2454,3913,9347,3464
1770,4200,2027,2173,709,990,328,715,1121,337
1772,8441,4219,4222,1565,2216,438,1414,2347,461
1773,5152,2376,2776,714,1167,495,704,1468,604
1775,5902,2922,2980,1003,1587,332,856,1671,453
1776,16841,8258,8583,2999,4192,1067,2826,4531,1226
1778,13222,6360,6862,2066,3162,1132,1906,3603,1353
1801,37258,18340,18918,4727,10512,3101,4369,10325,4224
1803,22876,11219,11657,3139,6221,1859,2978,6345,2334
1810,31247,15068,16179,5209,7779,2080,4666,8599,2914
1821,29274,14619,14655,4757,8177,1685,4257,8368,2030
1824,25428,12335,13093,3671,6671,1993,3484,6929,2680
1826,28562,13961,14601,4393,7670,1898,4017,8145,2439
1827,2822,1414,1408,517,749,148,455,811,142
1830,24122,11582,12540,3639,6183,1760,3322,6335,2883
1832,21431,10177,11254,3302,5617,1258,3219,6128,1907
1833,7377,3730,3647,1333,1973,424,1048,2099,500
1834,6038,3005,3033,1048,1553,404,955,1598,480
1835,13416,6298,7118,2015,3552,731,2090,3936,1092
1840,4450,2231,2219,686,1165,380,621,1069,529
1841,44339,20977,23362,9220,9997,1760,9004,11250,3108
1843,23189,11159,12030,4297,5603,1259,3886,6167,1977
1844,43854,20897,22957,6426,11201,3270,6031,12005,4921
1845,27202,13053,14149,4693,6624,1736,4198,7198,2753
1850,15808,7599,8209,2619,4163,817,2977,4071,1161
1851,29631,14838,14793,5239,8202,1397,5084,7786,1923
1852,32904,15904,17000,4986,8934,1984,5062,8820,3118
1854,26824,13169,13655,5169,6528,1472,4536,6681,2438
1860,6138,2990,3148,1020,1592,378,945,1740,463
1862,10074,5436,4638,1585,3332,519,1294,2504,840
1863,8430,3996,4434,1226,2262,508,1075,2542,817
1864,13865,6858,7007,2194,3708,956,2096,3845,1066
1867,23708,11420,12288,3597,6062,1761,3323,6429,2536
1876,28484,13892,14592,4194,7762,1936,3995,8104,2493
1879,11088,5446,5642,1850,3150,446,1890,3196,556
1880,24804,11777,13027,3213,6600,1964,3198,7010,2819
1886,20754,10288,10466,3743,5499,1046,3442,5797,1227
1887,21335,10548,10787,3368,5822,1358,3156,5763,1868
1890,20810,9858,10952,3003,4894,1961,2717,5618,2617
1902,47625,23013,24612,7953,12223,2837,7496,12537,4579
1904,18052,8826,9226,2678,4652,1496,2280,4884,2062
1905,23410,11400,12010,4268,5701,1431,3944,5862,2204
1906,26041,12533,13508,3339,6659,2535,2906,7206,3396
1907,14412,6786,7626,2091,3425,1270,1769,3958,1899
1908,3632,1721,1911,389,955,377,348,1071,492
1913,16397,7917,8480,2398,4458,1061,2339,4588,1553
1915,39862,18810,21052,5364,10413,3033,5384,10971,4697
1921,7921,3957,3964,1456,2024,477,1348,2098,518
1922,2854,1405,1449,442,813,150,498,765,186
1923,25212,11673,13539,3344,6181,2148,3543,6825,3171
1929,3267,1636,1631,495,885,256,426,869,336
1930,30273,14574,15699,4005,8083,2486,3746,8378,3575
1938,12987,6127,6860,1691,3365,1071,1670,3634,1556
1940,11542,5645,5897,1704,2751,1190,1493,2997,1407
1944,5228,2453,2775,689,1264,500,723,1410,642
1945,20377,9565,10812,2783,4998,1784,2600,5937,2275
1949,7744,4520,3224,1219,2777,524,903,1676,645
1950,18387,8558,9829,2226,4928,1404,2073,5855,1901
1951,2718,1330,1388,442,722,166,365,748,275
1952,7827,3859,3968,1116,2148,595,1037,2194,737
1960,48129,23006,25123,6412,12240,4354,6153,12692,6278
1966,7767,3617,4150,997,1838,782,882,2104,1164
1969,5500,2729,2771,964,1533,232,788,1619,364
1970,40407,18844,21563,5143,10927,2774,5303,12091,4169
1982,8315,4032,4283,1232,2259,541,1275,2410,598
1983,6141,2949,3192,963,1405,581,912,1627,653
1984,4440,2000,2440,824,858,318,1102,880,458
1985,4149,2071,2078,694,1134,243,626,1170,282
2019,15314,7538,7776,2322,4385,831,2240,4409,1127
2021,20614,9660,10954,2791,5112,1757,2766,5636,2552
2025,7261,3500,3761,1121,1761,618,992,1995,774
2026,23527,11523,12004,3038,6385,2100,2871,6298,2835
2030,5558,2702,2856,974,1350,378,937,1445,474
2032,3914,1916,1998,573,1022,321,621,964,413
2035,16246,7970,8276,2465,4403,1102,2291,4505,1480
2038,29560,14542,15018,5383,7790,1369,4939,8222,1857
2043,19882,9428,10454,3068,4790,1570,2870,5423,2161
2045,11050,5272,5778,1419,3030,823,1356,3418,1004
2048,22414,11229,11185,3968,6501,760,3552,6501,1132
2050,24757,12168,12589,3915,6676,1577,3630,7141,1818
2052,12273,6013,6260,2246,3068,699,2158,3236,866
2053,12448,6042,6406,2200,3242,600,2075,3464,867
2054,7902,3836,4066,1211,2184,441,1120,2331,615
2056,10460,6145,4315,1682,3982,481,1487,2394,434
2061,9765,4746,5019,1636,2350,760,1426,2609,984
2062,28587,13439,15148,3409,7511,2519,3424,7921,3803
2066,17430,8350,9080,2568,4261,1521,2467,4665,1948
2067,17396,8356,9040,2848,4364,1144,2823,4767,1450
2071,995,510,485,171,251,88,168,254,63
2072,27149,13097,14052,3797,7063,2237,3356,7502,3194
2081,17927,9072,8855,2636,4976,1460,2353,4578,1924
2090,14100,6734,7366,2186,3123,1425,1986,3491,1889
2093,10554,5138,5416,1692,2872,574,1586,2906,924
2108,3309,1818,1491,143,1338,337,117,1092,282
2109,3492,1786,1706,155,1350,281,46,1251,409
2110,1356,667,689,26,450,191,72,465,152
2111,5180,2743,2437,643,1564,536,597,1083,757
2113,6378,2852,3526,216,2247,389,186,2684,656
2114,11200,5761,5439,551,4456,754,426,4248,765
2115,25202,13272,11930,5850,6476,946,4577,6006,1347
2116,19448,9882,9566,1623,7039,1220,2001,6134,1431
2118,22074,12733,9341,2176,9334,1223,1982,5874,1485
2119,23781,10826,12955,4270,5318,1238,4268,6776,1911
2120,11218,5453,5765,2128,3012,313,2019,3151,595
2121,24880,10920,13960,4931,4851,1138,5104,7158,1698
2122,23870,11511,12359,3925,6346,1240,3750,6791,1818
2124,51344,23654,27690,9408,11987,2259,9266,14895,3529
2125,33952,16798,17154,5869,9293,1636,5670,9215,2269
2126,28147,12843,15304,5032,6449,1362,4870,8395,2039
2127,29530,13590,15940,3251,8424,1915,3228,9499,3213
2128,38413,19969,18444,6349,11420,2200,5060,9966,3418
2129,15195,7011,8184,1636,4492,883,1501,5456,1227
2130,36232,16951,19281,4518,10658,1775,4009,12287,2985
2131,32404,14958,17446,4519,8338,2101,4684,9463,3299
2132,23826,11149,12677,2484,6261,2404,2359,6701,3617
2134,21333,11456,9877,2859,7954,643,2169,6837,871
2135,44016,20691,23325,4098,14150,2443,3299,15883,4143
2136,28337,13100,15237,4555,6758,1787,4136,7810,3291
2138,35556,16881,18675,5185,9958,1738,5272,10875,2528
2139,34638,17544,17094,4417,11846,1281,4105,10980,2009
2140,16846,7726,9120,1788,5087,851,1757,5909,1454
2141,12271,6306,5965,1350,4131,825,1184,3674,1107
2142,2065,997,1068,329,611,57,368,590,110
2143,25135,12343,12792,2118,8864,1361,1824,8699,2269
2144,25062,11764,13298,2666,7893,1205,2814,8495,1989
2145,26861,13360,13501,3380,8623,1357,3526,7941,2034
2148,56340,27129,29211,6790,16220,4119,6587,16879,5745
2149,38037,18323,19714,5295,10331,2697,4652,10817,4245
2150,35080,17819,17261,6111,9593,2115,5571,8897,2793
2151,47283,22894,24389,6135,12703,4056,5616,12922,5851
2152,18303,8657,9646,2101,5077,1479,2043,5349,2254
2155,56185,26214,29971,6819,14619,4776,6972,15720,7279
2163,1134,654,480,46,608,0,75,405,0
2169,52117,24716,27401,5465,15047,4204,5321,15318,6762
2170,19327,9288,10039,2443,5258,1587,1948,5762,2329
2171,16581,8014,8567,1754,4993,1267,1786,5055,1726
2176,27134,12896,14238,3581,7212,2103,3179,7869,3190
2180,22219,10481,11738,2726,5747,2008,2560,6049,3129
2184,33828,16050,17778,4638,8309,3103,4159,8915,4704
2186,26062,12182,13880,4281,5893,2008,4090,6689,3101
2188,14789,6840,7949,1928,3584,1328,1795,3971,2183
2189,14897,7121,7776,2098,4018,1005,1881,4273,1622
2190,15561,7436,8125,2058,4315,1063,1980,4625,1520
2191,8741,4176,4565,1075,2272,829,1027,2486,1052
2199,995,450,545,20,300,130,31,308,206
2210,509,272,237,62,190,20,63,167,7
2215,22331,9757,12574,4066,5300,391,7381,4592,601
2222,55,21,34,0,9,12,0,13,21
2301,61551,29511,32040,10455,15145,3911,10176,16337,5527
2302,32753,15701,17052,5496,7976,2229,5212,8917,2923
2322,4443,2105,2338,609,1079,417,594,1172,572
2324,25179,13183,11996,3986,7925,1272,4321,6029,1646
2330,11163,5471,5692,1822,2800,849,1695,2883,1114
2332,14248,6846,7402,2356,3520,970,2247,3933,1222
2333,12974,6365,6609,2142,3479,744,2002,3668,939
2338,7513,3661,3852,1177,1934,550,1010,2118,724
2339,13164,6441,6723,2314,3370,757,2105,3496,1122
2341,9482,4649,4833,1579,2524,546,1511,2742,580
2343,10682,5214,5468,1546,2779,889,1320,2929,1219
2346,19897,9677,10220,3228,5370,1079,3126,5452,1642
2347,9865,4699,5166,1505,2544,650,1551,2741,874
2351,14605,7104,7501,2239,3876,989,2083,4109,1309
2356,12614,6088,6526,2359,3075,654,2432,3238,856
2358,13,5,8,0,5,0,0,8,0
2359,16927,8421,8506,2919,4597,905,2542,4969,995
2360,51547,25521,26026,8194,14212,3115,7300,14457,4269
2364,11780,5663,6117,1878,2963,822,1711,3307,1099
2366,136,136,0,20,116,0,0,0,0
2367,2637,1296,1341,460,692,144,413,779,149
2368,31227,14866,16361,4329,8272,2265,4024,8850,3487
2370,17670,8413,9257,2837,4397,1179,2533,4915,1809
2375,9685,4782,4903,1483,2740,559,1296,2885,722
2379,6640,3205,3435,964,1664,577,895,1673,867
2382,13882,6856,7026,2334,3778,744,2125,3894,1007
2420,14126,6577,7549,2017,3206,1354,2028,3691,1830
2421,16239,7630,8609,2278,3760,1592,2231,4118,2260
2445,26259,11792,14467,2953,7061,1778,3208,8743,2516
2446,29647,12921,16726,2378,8796,1747,2825,11014,2887
2451,17774,8682,9092,1961,5346,1375,2025,5304,1763
2452,12306,5992,6314,1937,3062,993,1865,2933,1516
2453,29146,14532,14614,3989,8790,1753,3885,8072,2657
2458,11864,5462,6402,1186,3431,845,1280,3816,1306
2459,17893,8261,9632,2736,4104,1421,3033,4505,2094
2460,9672,4474,5198,1273,2532,669,1133,3064,1001
2461,6362,3015,3347,816,1681,518,850,1879,618
2462,1464,653,811,129,333,191,119,371,321
2464,2849,1214,1635,293,756,165,311,977,347
2465,10995,5273,5722,1488,2844,941,1245,3180,1297
2466,7235,3313,3922,1013,1805,495,1108,2033,781
2467,10759,4777,5982,1972,1922,883,2358,2355,1269
2468,5891,2885,3006,935,1466,484,882,1586,538
2472,32986,15358,17628,3102,9737,2519,3005,10589,4034
2474,25682,11884,13798,2789,7068,2027,2583,7930,3285
2476,16697,7791,8906,1665,4730,1396,1581,5168,2157
2478,24173,11354,12819,3136,6029,2189,2888,6925,3006
2481,14128,6810,7318,2455,3276,1079,2254,3636,1428
2482,12485,4842,7643,1703,2255,884,3413,2992,1238
2492,19697,9348,10349,3210,4417,1721,2907,4926,2516
2493,11469,5368,6101,1835,2394,1139,2045,2689,1367
2494,9214,4317,4897,1328,2133,856,1183,2346,1368
2532,14793,7182,7611,2193,3559,1430,1874,3856,1881
2534,815,419,396,26,220,173,77,178,141
2535,1196,589,607,159,305,125,129,357,121
2536,19699,9484,10215,2790,4551,2143,2661,5057,2497
2537,5945,2909,3036,968,1401,540,853,1526,657
2538,2910,1430,1480,526,731,173,488,787,205
2539,3779,1910,1869,481,1145,284,465,1084,320
2540,8892,4056,4836,732,1811,1513,634,2032,2170
2542,1602,923,679,414,509,0,275,404,0
2543,750,344,406,73,196,75,64,230,112
2554,9520,4870,4650,1074,3199,597,985,2918,747
2556,3301,1503,1798,364,718,421,409,822,567
2558,1928,860,1068,262,411,187,279,516,273
2559,3205,1517,1688,366,754,397,355,797,536
2563,10874,5181,5693,1756,2553,872,1525,2895,1273
2568,9555,4642,4913,1433,2504,705,1208,2668,1037
2571,10500,5089,5411,1652,2556,881,1343,2822,1246
2575,398,199,199,45,117,37,37,104,58
2576,2982,1388,1594,348,695,345,373,718,503
2601,16181,7644,8537,2175,4178,1291,2014,4473,2050
2630,1752,808,944,186,409,213,172,503,269
2631,9988,4647,5341,1270,2094,1283,1173,2420,1748
2632,11204,5365,5839,1306,2662,1397,1221,2699,1919
2633,4237,2091,2146,380,898,813,340,881,925
2635,3362,1655,1707,360,805,490,328,827,552
2638,3892,1824,2068,411,800,613,348,988,732
2639,3245,1448,1797,267,733,448,401,908,488
2642,5453,2631,2822,640,1147,844,540,1299,983
2644,3773,1907,1866,808,913,186,617,1043,206
2645,9575,4368,5207,1106,1972,1290,1023,2306,1878
2646,1886,839,1047,111,351,377,145,370,532
2647,73,43,30,4,7,32,0,14,16
2648,7437,3611,3826,1284,1775,552,1182,1982,662
2649,12964,6130,6834,1814,2978,1338,1748,3332,1754
2650,1046,472,574,27,224,221,54,219,301
2652,1351,623,728,140,373,110,145,412,171
2653,6287,2862,3425,465,1255,1142,491,1280,1654
2655,4121,1859,2262,375,759,725,416,1012,834
2657,3431,1808,1623,174,1289,345,216,979,428
2659,1219,559,660,155,209,195,88,288,284
2660,7252,3323,3929,748,1417,1158,730,1649,1550
2661,7,0,7,0,0,0,0,7,0
2664,9836,4535,5301,1128,1880,1527,863,2127,2311
2666,732,328,404,68,161,99,69,218,117
2667,2753,1289,1464,302,661,326,265,795,404
2668,3358,1713,1645,564,832,317,494,843,308
2669,178,66,112,12,24,30,15,33,64
2670,1584,710,874,61,347,302,133,366,375
2671,1023,447,576,88,198,161,121,207,248
2672,201,88,113,4,55,29,15,55,43
2673,8331,3996,4335,1054,1940,1002,837,2093,1405
2675,6808,3139,3669,626,1286,1227,527,1567,1575
2702,4092,2101,1991,708,1226,167,581,1157,253
2703,42068,20399,21669,6408,11136,2855,5882,11720,4067
2713,59,30,29,4,21,5,7,18,4
2715,2202,1099,1103,403,560,136,311,630,162
2717,4380,2220,2160,775,1187,258,545,1311,304
2718,6809,3298,3511,1199,1842,257,1119,1978,414
2719,16159,7614,8545,2078,4045,1491,1987,4216,2342
2720,31683,14588,17095,4334,7835,2419,4332,8615,4148
2721,26336,12467,13869,4224,6246,1997,3965,6506,3398
2723,15941,7468,8473,2464,3718,1286,2426,4043,2004
2724,17479,8097,9382,2550,4192,1355,2527,4666,2189
2725,2813,1335,1478,326,723,286,313,703,462
2726,15383,7279,8104,1932,3675,1672,1808,3907,2389
2738,5123,2466,2657,731,1217,518,703,1322,632
2739,6268,2919,3349,794,1484,641,892,1663,794
2740,43159,20280,22879,6800,10115,3365,5751,11289,5839
2743,10072,4924,5148,1443,2599,882,1340,2749,1059
2744,11718,5619,6099,1944,2794,881,1814,3011,1274
2745,23984,11292,12692,3470,5624,2198,3309,6289,3094
2746,15073,7055,8018,2510,3543,1002,2729,3802,1487
2747,19359,9703,9656,3274,5245,1184,3372,4562,1722
2748,11315,5392,5923,1533,2653,1206,1381,2831,1711
2760,24889,12099,12790,3779,6930,1390,3761,7199,1830
2762,7683,3806,3877,1183,2112,511,1142,2037,698
2763,2254,1115,1139,388,613,114,384,624,131
2764,3973,1931,2042,635,993,303,576,1071,395
2766,18036,8599,9437,3142,4651,806,3442,4967,1028
2767,11488,5552,5936,1703,3032,817,1568,3229,1139
2769,10122,5015,5107,1589,2787,639,1448,2913,746
2770,4390,2196,2194,735,1249,212,597,1290,307
2771,13425,6570,6855,2022,3448,1100,1862,3668,1325
2777,15989,7877,8112,2263,4254,1360,1932,4344,1836
2779,5749,2846,2903,1005,1612,229,984,1663,256
2780,49418,24001,25417,7133,13232,3636,6814,13501,5102
2790,14597,7202,7395,1900,4025,1277,1781,4059,1555
2804,2829,1408,1421,407,823,178,448,782,191
2806,16819,8207,8612,2784,4075,1348,2529,4321,1762
2807,1010,478,532,99,275,104,110,287,135
2808,2297,1182,1115,511,562,109,364,614,137
2809,22469,10790,11679,3370,5262,2158,3274,5675,2730
2812,1250,597,653,204,328,65,196,413,44
2813,7859,3894,3965,1024,2175,695,955,2225,785
2814,7603,3843,3760,1305,2086,452,1147,2179,434
2815,275,131,144,36,71,24,43,77,24
2816,31239,15069,16170,4544,8190,2335,4370,8703,3097
2817,5122,2550,2572,846,1503,201,827,1518,227
2818,18349,8974,9375,2734,4669,1571,2426,5027,1922
2822,5619,2667,2952,785,1585,297,848,1654,450
2825,5171,2609,2562,830,1429,350,765,1434,363
2827,2392,1191,1201,424,630,137,348,701,152
2828,7199,3359,3840,923,1656,780,859,1874,1107
2830,6860,3308,3552,975,1934,399,1007,1988,557
2831,3152,1588,1564,539,853,196,471,856,237
2832,4755,2362,2393,783,1277,302,667,1309,417
2833,659,341,318,93,198,50,70,190,58
2835,5622,2754,2868,754,1549,451,660,1608,600
2836,116,70,46,37,24,9,7,39,0
2837,3593,1744,1849,458,867,419,471,938,440
2838,3214,1581,1633,503,812,266,385,866,382
2839,1185,607,578,176,319,112,126,362,90
2840,26509,12764,13745,3699,7333,1732,3837,7267,2641
2842,17300,8406,8894,2517,4564,1325,2308,4653,1933
2852,23657,11357,12300,3595,6197,1565,3392,6891,2017
2857,8388,4065,4323,1187,2309,569,1123,2400,800
2858,829,421,408,183,231,7,155,232,21
2859,7265,3578,3687,1227,1933,418,1132,1867,688
2860,46398,22175,24223,7650,11505,3020,7089,12505,4629
2861,26617,12627,13990,3589,6584,2454,3443,6985,3562
2863,18946,9206,9740,3431,4862,913,3342,4685,1713
2864,31840,15116,16724,4461,7923,2732,4324,8541,3859
2865,17684,8379,9305,2616,4182,1581,2448,4660,2197
2871,17149,8465,8684,2537,4482,1446,2197,4858,1629
2874,4712,2356,2356,724,1367,265,681,1356,319
2875,263,122,141,33,66,23,44,87,10
2878,15260,7446,7814,1997,4071,1378,1892,4132,1790
2879,18897,9070,9827,2820,4896,1354,2748,5102,1977
2881,6973,3160,3813,2034,837,289,2588,887,338
2882,14626,7157,7469,2070,3928,1159,2076,3922,1471
2885,11360,5406,5954,1535,2931,940,1404,3045,1505
2886,30315,14076,16239,3614,7589,2873,3681,8014,4544
2888,20637,9815,10822,2722,5277,1816,2457,5735,2630
2889,29455,14226,15229,4305,7851,2070,4081,8193,2955
2891,21327,10235,11092,2895,5378,1962,2749,5529,2814
2892,4341,2264,2077,752,1193,319,575,1249,253
2893,29581,14228,15353,4112,7958,2158,3953,8316,3084
2894,538,277,261,106,129,42,85,152,24
2895,43224,20758,22466,6996,10479,3283,6467,11078,4921
2896,10332,4863,5469,1323,2570,970,1274,2795,1400
2898,1818,919,899,357,463,99,289,506,104
2903,9655,4742,4913,1701,2313,728,2009,1893,1011
2904,29483,13634,15849,3569,7086,2979,3490,8008,4351
2905,25272,11994,13278,5111,5638,1245,4820,6370,2088
2906,30469,14440,16029,4992,7762,1686,5592,8043,2394
2907,27579,13353,14226,6207,6025,1121,5626,6907,1693
2908,38129,17793,20336,7234,8289,2270,7771,9223,3342
2909,41239,20189,21050,8280,10089,1820,7543,10721,2786
2910,20881,9822,11059,2954,5236,1632,2714,6028,2317
2911,14151,6496,7655,1643,3674,1179,1737,3790,2128
2914,22555,10613,11942,3230,5512,1871,2733,6161,3048
2915,17980,8296,9684,2298,4351,1647,2183,4849,2652
2916,8121,3779,4342,1010,2088,681,979,2173,1190
2917,13390,6626,6764,2742,2927,957,2135,3241,1388
2919,28248,13201,15047,3593,6962,2646,3338,7781,3928
2920,37672,18811,18861,5158,9720,3933,3948,9158,5755
2921,10596,5196,5400,1745,2787,664,1652,2815,933
3031,10776,5372,5404,1975,2792,605,1778,2991,635
3032,4682,2397,2285,784,1396,217,723,1386,176
3033,4181,2126,2055,812,1163,151,697,1162,196
3034,3911,1965,1946,602,1190,173,571,1162,213
3036,3792,1869,1923,676,994,199,651,1097,175
3037,3678,1801,1877,607,1014,180,613,1090,174
3038,34137,16918,17219,5865,9785,1268,5694,9815,1710
3042,5476,2718,2758,879,1493,346,827,1535,396
3043,1811,921,890,297,488,136,266,485,139
3044,3523,1747,1776,563,1021,163,579,1024,173
3045,14953,7215,7738,2257,4058,900,2365,4105,1268
3047,1194,624,570,245,333,46,198,327,45
3048,3343,1716,1627,557,946,213,476,920,231
3049,7015,3526,3489,1182,1930,414,1059,2017,413
3051,22928,11413,11515,3781,6527,1105,3446,6640,1429
3052,7360,3645,3715,1354,2089,202,1432,2093,190
3053,23120,11479,11641,4474,6241,764,4148,6548,945
3054,25149,12409,12740,4118,7084,1207,4032,7477,1231
3055,13634,6779,6855,2314,3758,707,1912,3901,1042
3057,2197,1130,1067,372,626,132,335,586,146
3060,29388,14333,15055,4475,8102,1756,4318,7738,2999
3062,26388,13037,13351,4054,7340,1643,3656,7542,2153
3063,16175,8110,8065,2308,4822,980,1986,4819,1260
3064,14654,7258,7396,2265,4069,924,2234,3876,1286
3070,4060,2053,2007,679,1227,147,672,1180,155
3071,4299,2192,2107,923,1058,211,764,1125,218
3076,10914,5417,5497,1811,2977,629,1804,3074,619
3077,9674,4794,4880,1655,2700,439,1546,2828,506
3079,28112,13934,14178,4017,7888,2029,4000,7711,2467
3082,1143,570,573,155,344,71,173,342,58
3084,866,439,427,142,248,49,154,223,50
3086,4262,2089,2173,624,1180,285,634,1235,304
3087,10709,5396,5313,1849,2979,568,1656,3078,579
3101,2793,1359,1434,351,820,188,326,740,368
3102,30268,14640,15628,4356,8326,1958,4408,8120,3100
3103,36875,18705,18170,6127,10265,2313,5451,9455,3264
3104,32197,15373,16824,4087,9033,2253,4304,9063,3457
3106,11721,5858,5863,2042,3151,665,1879,3195,789
3109,9101,4560,4541,1567,2597,396,1229,2556,756
3110,18274,9038,9236,2904,4935,1199,2664,5028,1544
3215,258,136,122,32,70,34,35,65,22
3216,2099,1054,1045,311,543,200,280,584,181
3217,2805,1351,1454,391,728,232,420,799,235
3218,1088,559,529,186,282,91,169,263,97
3220,7135,3543,3592,1080,2028,435,986,1965,641
3221,1815,907,908,282,488,137,246,484,178
3222,4971,2482,2489,742,1309,431,639,1328,522
3223,3885,1915,1970,520,1068,327,537,1079,354
3224,1977,958,1019,268,550,140,280,596,143
3225,3294,1667,1627,529,917,221,466,919,242
3226,457,231,226,50,125,56,55,113,58
3227,1037,474,563,120,216,138,142,245,176
3229,5399,2571,2828,766,1385,420,806,1524,498
3230,1268,653,615,188,361,104,168,332,115
3233,263,89,174,16,52,21,72,84,18
3234,6228,3014,3214,883,1657,474,882,1785,547
3235,8479,4164,4315,1470,2089,605,1154,2219,942
3237,1476,717,759,173,421,123,209,426,124
3240,1035,542,493,160,313,69,126,295,72
3241,828,424,404,110,203,111,91,199,114
3242,4438,2252,2186,846,1221,185,766,1162,258
3243,992,502,490,147,287,68,153,272,65
3244,6783,3410,3373,1107,1788,515,951,1855,567
3246,23578,11406,12172,3122,6124,2160,3138,6146,2888
3251,1273,629,644,154,357,118,141,335,168
3253,6532,3288,3244,898,1648,742,794,1650,800
3254,4413,2177,2236,534,1073,570,503,1128,605
3255,1784,928,856,288,461,179,178,466,212
3256,1098,524,574,188,245,91,191,268,115
3257,4369,1998,2371,596,699,703,635,866,870
3259,170,86,84,12,56,18,8,48,28
3260,474,217,257,56,110,51,75,128,54
3261,3724,1871,1853,602,1041,228,562,1050,241
3262,895,459,436,132,272,55,105,252,79
3263,3948,1884,2064,612,1021,251,697,1088,279
3264,9058,4503,4555,1963,1998,542,1999,1946,610
3266,2105,1078,1027,313,567,198,291,515,221
3268,1022,520,502,160,293,67,132,292,78
3269,2606,1296,1310,391,712,193,370,719,221
3273,230,112,118,26,64,22,28,68,22
3275,11769,5789,5980,1911,3209,669,1768,3281,931
3276,8025,4017,4008,1239,2191,587,1185,2155,668
3278,3011,1502,1509,479,828,195,416,817,276
3279,874,416,458,137,220,59,133,236,89
3280,847,446,401,124,220,102,100,220,81
3281,7808,3909,3899,1369,2216,324,1362,2265,272
3282,706,368,338,106,183,79,98,178,62
3284,357,163,194,47,95,21,49,119,26
3287,947,450,497,131,225,94,145,260,92
3290,3554,1802,1752,555,1073,174,540,1028,184
3291,63,32,31,4,24,4,5,22,4
3301,31701,15740,15961,4270,9241,2229,3996,8317,3648
3303,14239,6902,7337,2160,3870,872,2127,3965,1245
3304,7138,3549,3589,1300,1842,407,1220,1993,376
3307,4464,2199,2265,701,1267,231,713,1286,266
3431,24745,11661,13084,3877,5876,1908,4034,6107,2943
3440,2668,1310,1358,441,657,212,441,689,228
3441,287,152,135,26,94,32,15,100,20
3442,1396,690,706,215,411,64,250,371,85
3443,604,311,293,83,188,40,83,160,50
3444,1175,596,579,182,317,97,147,321,111
3445,556,294,262,102,159,33,81,151,30
3446,5797,2923,2874,967,1548,408,732,1646,496
3447,2033,1043,990,310,568,165,294,553,143
3448,726,364,362,85,220,59,103,207,52
3449,1743,836,907,244,393,199,241,458,208
3450,567,287,280,89,141,57,67,156,57
3451,4082,2023,2059,659,1064,300,570,1109,380
3452,5476,2622,2854,835,1356,431,794,1385,675
3455,2882,1400,1482,415,734,251,409,773,300
3456,727,381,346,111,208,62,82,196,68
3457,411,211,200,70,107,34,54,104,42
3458,6820,3145,3675,963,1501,681,947,1806,922
3461,5451,2785,2666,1273,1210,302,1242,1144,280
3462,1729,888,841,285,465,138,211,503,127
3464,782,393,389,101,210,82,92,223,74
3465,2087,989,1098,291,550,148,312,596,190
3466,1209,618,591,211,330,77,180,326,85
3467,1747,862,885,214,476,172,210,426,249
3470,4912,2419,2493,778,1229,412,784,1232,477
3561,5845,2757,3088,883,1416,458,809,1583,696
3570,10601,5056,5545,1428,2464,1164,1290,2488,1767
3574,2178,1103,1075,309,655,139,285,627,163
3576,3840,1925,1915,566,981,378,456,959,500
3579,382,182,200,29,103,50,49,101,50
3580,1215,595,620,154,308,133,105,322,193
3581,3278,1611,1667,434,848,329,421,787,459
3582,2778,1421,1357,428,738,255,367,696,294
3583,954,494,460,116,283,95,105,245,110
3584,3584,1694,1890,503,906,285,567,922,401
3585,2997,1440,1557,389,787,264,445,813,299
3588,1664,869,795,248,487,134,214,426,155
3590,1227,575,652,159,297,119,196,338,118
3592,1168,595,573,140,302,153,138,291,144
3595,647,335,312,80,181,74,79,177,56
3598,2988,1454,1534,445,738,271,430,738,366
3601,398,213,185,71,123,19,58,101,26
3602,2125,1096,1029,349,567,180,266,561,202
3603,5342,2647,2695,813,1376,458,738,1368,589
3605,877,450,427,114,246,90,127,226,74
3607,268,144,124,39,57,48,30,50,44
3608,2978,1444,1534,427,738,279,393,795,346
3609,806,370,436,88,221,61,160,188,88
3741,3188,1568,1620,492,880,196,518,875,227
3743,13831,6645,7186,1920,3527,1198,1848,3567,1771
3745,1635,809,826,229,431,149,228,450,148
3748,5873,2855,3018,760,1680,415,759,1711,548
3750,792,417,375,106,202,109,81,202,92
3751,391,183,208,66,96,21,74,100,34
3752,750,363,387,110,175,78,91,209,87
3753,1994,980,1014,202,483,295,224,520,270
3755,10062,4970,5092,2366,1980,624,2341,1761,990
3765,344,149,195,35,56,58,35,75,85
3766,8423,3897,4526,961,2362,574,1121,2422,983
3768,1928,978,950,303,485,190,242,524,184
3770,294,152,142,44,82,26,35,83,24
3771,755,382,373,100,192,90,91,167,115
3773,7679,3810,3869,1228,1949,633,1009,2041,819
3774,1314,685,629,251,341,93,146,377,106
3777,825,388,437,95,215,78,107,243,87
3779,699,353,346,119,176,58,81,198,67
3780,511,298,213,119,112,67,52,97,64
3781,1959,989,970,297,557,135,247,585,138
3782,2724,1381,1343,375,673,333,313,728,302
3784,3793,1864,1929,614,972,278,527,1088,314
3785,3455,1678,1777,427,919,332,489,817,471
3801,21563,10409,11154,2302,6338,1769,2089,6427,2638
3809,3623,1846,1777,564,956,326,462,912,403
3810,492,247,245,48,123,76,48,142,55
3811,6178,3032,3146,813,1741,478,879,1741,526
3812,848,421,427,118,237,66,110,245,72
3813,2738,1327,1411,380,783,164,423,706,282
3814,3588,1767,1821,509,927,331,557,923,341
3815,537,281,256,120,137,24,70,168,18
3816,1566,775,791,183,396,196,200,401,190
3817,598,320,278,87,166,67,66,155,57
3818,3168,1621,1547,470,781,370,302,846,399
3819,3912,1981,1931,636,1129,216,586,1101,244
3820,28526,13800,14726,3756,8150,1894,3669,8091,2966
3824,16809,7901,8908,3831,3377,693,4979,3121,808
3825,7055,3619,3436,1226,2098,295,1034,2052,350
3826,2065,992,1073,293,603,96,381,582,110
3827,2634,1263,1371,357,763,143,419,768,184
3830,1206,613,593,175,306,132,186,275,132
3832,333,181,152,49,93,39,29,98,25
3833,19129,9175,9954,2736,4879,1560,2584,5126,2244
3835,4996,2477,2519,879,1255,343,766,1314,439
3836,1303,630,673,102,324,204,136,323,214
3837,934,470,464,149,246,75,119,277,68
3838,917,468,449,114,248,106,113,253,83
3839,3444,1755,1689,561,1015,179,538,972,179
3840,3205,1566,1639,490,842,234,456,910,273
3841,6280,3103,3177,1084,1638,381,891,1777,509
3842,14809,7192,7617,1839,3933,1420,1834,4134,1649
3844,1896,960,936,286,518,156,246,520,170
3845,980,467,513,118,266,83,122,307,84
3846,819,393,426,69,201,123,92,217,117
3848,5862,2928,2934,869,1749,310,839,1699,396
3849,1552,799,753,248,448,103,200,440,113
3852,397,164,233,39,74,51,54,114,65
3853,559,265,294,43,128,94,47,135,112
3854,1009,481,528,120,214,147,140,241,147
3855,2219,1158,1061,365,634,159,314,592,155
3856,1551,766,785,270,421,75,274,425,86
3857,8027,3985,4042,1211,2366,408,1097,2483,462
3858,4289,2131,2158,701,1252,178,695,1220,243
3860,3663,1727,1936,461,977,289,535,974,427
3862,4259,2104,2155,574,1124,406,524,1187,444
3864,2149,1133,1016,299,525,309,235,493,288
3865,7747,3873,3874,1211,2121,541,1069,2217,588
3867,23103,11199,11904,3514,5858,1827,3325,6267,2312
3868,5132,2490,2642,762,1402,326,717,1445,480
3869,2433,1216,1217,395,643,178,335,661,221
3870,5182,2435,2747,660,1264,511,637,1383,727
3872,2861,1387,1474,434,711,242,393,774,307
3873,5206,2653,2553,988,1506,159,860,1517,176
3874,8046,4001,4045,954,2199,848,932,2121,992
3875,488,246,242,87,108,51,54,135,53
3878,11510,5464,6046,1748,3064,652,1860,3084,1102
3882,157,79,78,21,44,14,21,41,16
3883,239,131,108,35,66,30,24,64,20
3884,1920,935,985,291,543,101,309,575,101
3885,6355,3096,3259,1006,1739,351,961,1864,434
3886,1793,909,884,295,423,191,221,454,209
3887,4267,2176,2091,702,1217,257,672,1157,262
3894,6098,2852,3246,737,1376,739,771,1430,1045
3897,66,38,28,13,17,8,7,16,5
3901,6337,3081,3256,1097,1632,352,1094,1714,448
3902,2018,945,1073,266,480,199,278,599,196
3903,5954,2847,3107,861,1555,431,873,1721,513
3904,7660,3745,3915,993,2100,652,949,2074,892
3905,1883,925,958,207,510,208,211,587,160
3906,4334,2127,2207,682,1186,259,632,1215,360
3907,1226,647,579,93,292,262,60,256,263
3908,6687,3281,3406,1152,1765,364,1074,1878,454
3909,10836,5107,5729,1310,2678,1119,1440,2891,1398
4001,2143,1066,1077,311,532,223,291,556,230
4002,6251,3148,3103,960,1660,528,861,1664,578
4003,412,159,253,25,99,35,46,134,73
4005,21995,10293,11702,3049,5549,1695,3284,5855,2563
4008,2627,1317,1310,393,782,142,395,758,157
4009,4883,2447,2436,846,1174,427,655,1204,577
4010,1229,617,612,170,331,116,173,338,101
4011,21172,10284,10888,3669,4926,1689,3367,4984,2537
4015,3517,1764,1753,546,963,255,453,986,314
4017,340,168,172,37,101,30,15,93,64
4019,100,55,45,14,20,21,9,24,12
4020,1287,638,649,195,335,108,168,312,169
4021,5648,2733,2915,1034,1414,285,1020,1493,402
4022,1030,492,538,130,266,96,133,296,109
4024,503,245,258,65,136,44,68,143,47
4027,5101,2584,2517,880,1343,361,800,1367,350
4029,1502,753,749,215,401,137,176,404,169
4030,1513,777,736,303,364,110,216,405,115
4032,7850,3887,3963,1249,2047,591,943,2270,750
4037,3268,1556,1712,435,796,325,491,837,384
4038,15976,7762,8214,2922,3918,922,2881,4099,1234
4039,6407,3249,3158,930,1900,419,885,1835,438
4040,2315,1126,1189,344,597,185,340,634,215
4041,1418,689,729,218,363,108,221,383,125
4042,4087,2080,2007,716,1122,242,537,1221,249
4043,10494,4889,5605,1539,2435,915,1439,2845,1321
4046,7291,3567,3724,1016,1904,647,923,2062,739
4047,1575,794,781,241,428,125,214,418,149
4048,2247,1127,1120,356,603,168,331,602,187
4049,3342,1652,1690,550,899,203,537,888,265
4050,201,86,115,26,42,18,37,50,28
4051,1367,684,683,187,370,127,180,367,136
4055,3226,1640,1586,519,830,291,402,840,344
4061,2836,1426,1410,503,826,97,541,802,67
4062,14904,7551,7353,2174,4385,992,2046,4192,1115
4064,8806,4342,4464,1005,2632,705,990,2523,951
4066,652,314,338,62,130,122,81,165,92
4068,1443,723,720,241,363,119,209,366,145
4069,1430,710,720,181,387,142,159,410,151
4071,4712,2345,2367,711,1317,317,668,1311,388
4072,19143,9183,9960,2671,5179,1333,2674,5400,1886
4073,15971,7670,8301,2474,3908,1288,2478,4061,1762
4074,16896,8239,8657,2470,4432,1337,2347,4720,1590
4076,2335,1140,1195,306,620,214,344,624,227
4079,4175,2078,2097,555,1025,498,417,1144,536
4083,4769,2273,2496,740,1180,353,769,1224,503
4084,7619,3729,3890,1315,1975,439,1335,2070,485
4085,1666,790,876,274,486,30,288,530,58
4086,9100,4390,4710,1488,2304,598,1425,2407,878
4087,1841,934,907,312,510,112,293,492,122
4088,1435,719,716,209,355,155,196,364,156
4090,9382,4579,4803,1213,2379,987,1074,2560,1169
4091,718,340,378,95,178,67,111,180,87
4092,16142,7712,8430,2422,4011,1279,2073,4474,1883
4093,4235,2126,2109,747,1190,189,630,1260,219
4095,1328,696,632,220,365,111,181,347,104
4096,8505,4105,4400,1312,2148,645,1081,2434,885
4097,3031,1480,1551,479,833,168,495,888,168
4101,17519,9001,8518,1869,6193,939,1776,5041,1701
4102,16745,7902,8843,1982,4871,1049,1974,5215,1654
4103,28973,13330,15643,3775,7452,2103,3665,8535,3443
4105,10310,4907,5403,1551,2521,835,1498,2689,1216
4106,23398,11020,12378,3258,6085,1677,3014,6742,2622
4107,9068,4305,4763,1355,2194,756,1267,2465,1031
4108,920,449,471,145,240,64,120,290,61
4110,1204,579,625,148,267,164,180,296,149
4210,23208,11069,12139,3292,5908,1869,3237,5884,3018
4216,711,374,337,115,178,81,84,199,54
4217,3148,1565,1583,463,815,287,405,816,362
4219,1505,776,729,239,407,130,197,373,159
4220,1998,997,1001,314,560,123,304,557,140
4221,1674,803,871,208,430,165,265,396,210
4222,3381,1692,1689,514,1019,159,535,993,161
4224,3084,1523,1561,469,794,260,450,795,316
4226,138,68,70,6,46,16,17,43,10
4228,741,370,371,161,169,40,133,189,49
4231,271,133,138,32,73,28,28,81,29
4236,4099,2086,2013,666,1157,263,587,1172,254
4237,177,79,98,24,45,10,20,58,20
4238,1053,541,512,166,327,48,160,297,55
4239,4863,2393,2470,758,1234,401,719,1226,525
4240,35690,17136,18554,5316,8654,3166,5103,8671,4780
4250,4048,1971,2077,617,1080,274,584,1071,422
4252,5029,2476,2553,792,1298,386,758,1316,479
4253,2120,1104,1016,319,626,159,237,584,195
4254,2486,1183,1303,367,603,213,362,629,312
4255,782,385,397,110,193,82,108,210,79
4256,3138,1530,1608,510,813,207,481,864,263
4257,2855,1416,1439,456,659,301,382,675,382
4258,2248,1130,1118,351,649,130,368,617,133
4259,2999,1450,1549,477,803,170,493,836,220
4260,4808,2385,2423,778,1355,252,757,1393,273
4261,435,231,204,54,129,48,59,105,40
4263,1978,995,983,341,527,127,316,535,132
4265,805,378,427,87,211,80,135,216,76
4268,4611,2144,2467,579,1127,438,628,1156,683
4270,5520,2739,2781,885,1435,419,805,1506,470
4274,4861,2479,2382,758,1423,298,629,1397,356
4275,505,273,232,64,144,65,52,131,49
4276,6749,3197,3552,869,1540,788,921,1601,1030
4280,5808,2920,2888,929,1615,376,840,1618,430
4281,4793,2284,2509,631,1183,470,630,1208,671
4282,4958,2462,2496,888,1287,287,790,1373,333
4284,1093,557,536,169,274,114,128,287,121
4285,408,210,198,52,111,47,41,109,48
4287,2712,1347,1365,447,732,168,410,804,151
4289,1749,833,916,266,421,146,235,434,247
4290,1334,665,669,208,328,129,199,318,152
4292,903,439,464,117,270,52,156,229,79
4294,4424,2135,2289,686,1108,341,690,1112,487
4330,24507,11773,12734,3181,6553,2039,3239,6632,2863
4342,1634,831,803,243,468,120,221,465,117
4344,2734,1244,1490,345,669,230,377,791,322
4345,11716,5775,5941,1844,3083,848,1588,3248,1105
4346,2097,994,1103,289,498,207,308,546,249
4347,2467,1178,1289,304,684,190,301,708,280
4348,2886,1430,1456,427,747,256,413,773,270
4349,917,452,465,126,255,71,121,273,71
4350,3110,1539,1571,441,887,211,473,864,234
4351,2407,1166,1241,374,581,211,320,645,276
4352,1529,783,746,241,431,111,198,434,114
4353,2303,1100,1203,291,638,171,377,639,187
4354,1221,616,605,171,324,121,169,330,106
4355,2482,1261,1221,436,648,177,380,641,200
4357,3298,1627,1671,505,898,224,480,936,255
4358,3867,1904,1963,619,1043,242,624,1060,279
4360,519,269,250,77,147,45,66,144,40
4363,2200,1061,1139,311,586,164,339,618,182
4364,6232,3044,3188,830,1599,615,810,1656,722
4401,40524,19224,21300,5936,10620,2668,5946,11183,4171
4406,668,340,328,80,198,62,68,187,73
4408,159,86,73,26,46,14,20,41,12
4410,1166,611,555,201,332,78,168,296,91
4411,1242,617,625,173,343,101,162,337,126
4412,8951,4282,4669,1244,2183,855,1105,2486,1078
4413,187,86,101,21,43,22,28,50,23
4414,1481,741,740,188,386,167,166,369,205
4416,4622,2252,2370,708,1212,332,611,1244,515
4417,319,156,163,42,89,25,55,75,33
4418,1421,718,703,243,411,64,245,394,64
4419,3488,1784,1704,541,1024,219,455,1004,245
4421,1343,885,458,425,346,114,126,198,134
4422,1393,738,655,202,457,79,212,365,78
4423,302,161,141,62,78,21,33,86,22
4424,843,429,414,120,215,94,120,192,102
4426,5257,2571,2686,787,1303,481,699,1340,647
4427,2511,1222,1289,384,668,170,374,705,210
4428,2783,1384,1399,373,771,240,370,797,232
4429,4271,2161,2110,661,1209,291,545,1227,338
4430,1858,888,970,251,419,218,258,457,255
4431,142,73,69,19,38,16,10,44,15
4434,1012,490,522,144,280,66,152,297,73
4435,993,513,480,147,279,87,117,281,82
4438,1106,536,570,169,304,63,169,325,76
4441,1364,656,708,161,330,165,148,352,208
4442,556,270,286,91,141,38,76,153,57
4443,2544,1245,1299,365,646,234,343,659,297
4444,7721,3759,3962,1201,2063,495,1109,2212,641
4448,1471,706,765,196,364,146,200,373,192
4449,1368,698,670,210,408,80,221,376,73
4450,1171,567,604,154,324,89,161,347,96
4451,198,89,109,11,48,30,25,46,38
4453,931,472,459,153,265,54,151,248,60
4455,900,471,429,159,240,72,121,216,92
4456,2161,1074,1087,350,592,132,373,585,129
4457,7219,3509,3710,1078,1718,713,1033,1825,852
4459,835,406,429,111,224,71,126,220,83
4460,1738,897,841,276,477,144,243,460,138
4461,2952,1456,1496,459,806,191,399,832,265
4462,5351,2587,2764,698,1274,615,576,1343,845
4463,2776,1319,1457,356,651,312,413,678,366
4464,668,342,326,96,173,73,90,158,78
4468,9823,4693,5130,1585,2378,730,1561,2564,1005
4471,559,290,269,64,163,63,67,154,48
4472,3343,1646,1697,508,886,252,445,911,341
4473,9112,4564,4548,2268,1845,451,2167,1737,644
4474,3560,1757,1803,480,1029,248,509,1049,245
4475,430,216,214,65,112,39,68,96,50
4476,838,400,438,94,197,109,86,211,141
4478,301,175,126,54,87,34,22,72,32
4479,1269,630,639,176,323,131,142,323,174
4487,944,510,434,153,240,117,101,222,111
4488,981,491,490,143,282,66,147,278,65
4490,253,127,126,33,72,22,24,73,29
4493,730,385,345,108,216,61,79,206,60
4495,317,151,166,43,67,41,46,70,50
4496,3602,1771,1831,577,958,236,513,1055,263
4497,395,173,222,47,84,42,72,98,52
4530,11607,5510,6097,1657,2964,889,1604,3221,1272
4535,665,336,329,106,177,53,80,189,60
4537,2203,1120,1083,340,580,200,287,557,239
4538,2523,1185,1338,254,552,379,274,579,485
4539,1000,488,512,143,265,80,136,266,110
4541,21,12,9,0,5,7,0,0,9
4543,2060,940,1120,261,387,292,220,458,442
4544,568,243,325,35,123,85,49,159,117
4547,1204,592,612,151,301,140,148,290,174
4548,998,498,500,125,277,96,153,243,104
4551,784,370,414,82,202,86,85,206,123
4553,1768,819,949,211,418,190,241,467,241
4554,662,323,339,41,148,134,39,117,183
4555,1607,758,849,218,397,143,233,436,180
4556,1062,500,562,131,262,107,150,280,132
4558,464,256,208,72,114,70,44,107,57
4562,2110,1083,1027,289,584,210,253,579,195
4563,1322,666,656,182,346,138,170,345,141
4564,500,257,243,54,138,65,52,140,51
4568,477,245,232,47,103,95,24,138,70
4572,4916,2430,2486,764,1196,470,655,1283,548
4573,418,209,209,58,91,60,53,87,69
4574,1325,665,660,199,357,109,176,378,106
4576,677,327,350,42,140,145,57,142,151
4578,4339,2143,2196,596,1146,401,597,1192,407
4579,2762,1404,1358,396,793,215,377,744,237
4605,11051,5380,5671,1558,2867,955,1456,3036,1179
4606,1209,596,613,161,320,115,164,334,115
4607,1886,940,946,284,465,191,242,492,212
4609,4763,2262,2501,652,1232,378,599,1331,571
4611,604,307,297,91,162,54,69,158,70
4612,275,132,143,34,63,35,25,79,39
4613,434,248,186,99,111,38,31,114,41
4614,2082,981,1101,284,509,188,255,561,285
4615,207,95,112,33,41,21,39,39,34
4616,853,414,439,116,209,89,97,233,109
4617,828,405,423,104,210,91,75,224,124
4619,3460,1583,1877,421,849,313,493,850,534
4622,1215,573,642,137,295,141,157,289,196
4623,1086,554,532,165,274,115,139,298,95
4624,293,144,149,36,78,30,54,47,48
4625,53,27,26,3,11,13,2,14,10
4626,606,312,294,100,167,45,90,144,60
4627,1193,562,631,181,245,136,126,292,213
4628,718,343,375,103,173,67,122,174,79
4629,62,38,24,14,21,3,0,24,0
4630,1717,825,892,245,427,153,264,435,193
4631,1640,774,866,182,418,174,191,425,250
4634,1769,882,887,273,474,135,215,501,171
4635,28,18,10,4,10,4,3,5,2
4640,2104,1002,1102,271,521,210,281,577,244
4642,70,35,35,0,14,21,6,15,14
4643,887,429,458,111,239,79,116,234,108
4645,81,37,44,4,27,6,20,20,4
4646,75,35,40,1,22,12,11,15,14
4648,557,277,280,83,141,53,81,140,59
4649,1420,692,728,185,348,159,190,314,224
4650,229,115,114,26,61,28,25,48,41
4652,1971,962,1009,258,479,225,217,501,291
4653,548,253,295,56,156,41,65,174,56
4654,3637,1726,1911,539,804,383,559,876,476
4655,913,535,378,104,338,93,84,199,95
4657,331,158,173,33,88,37,36,97,40
4658,1279,634,645,175,311,148,110,303,232
4660,1318,647,671,167,325,155,137,367,167
4662,551,243,308,68,123,52,63,174,71
4664,439,202,237,54,118,30,63,139,35
4666,1195,557,638,136,289,132,177,298,163
4667,1445,670,775,240,353,77,286,406,83
4668,1734,858,876,339,420,99,316,421,139
4669,139,71,68,19,28,24,14,34,20
4671,554,285,269,86,120,79,78,117,74
4672,26,12,14,0,12,0,0,9,5
4673,156,70,86,18,40,12,22,56,8
4674,473,230,243,76,114,40,66,136,41
4675,283,135,148,37,69,29,36,73,39
4676,953,485,468,146,244,95,128,238,102
4677,284,142,142,27,76,39,23,70,49
4679,2187,1030,1157,290,541,199,311,540,306
4680,1126,563,563,178,287,98,135,316,112
4681,1598,778,820,191,420,167,231,391,198
4683,8,5,3,0,3,2,2,1,0
4684,1361,648,713,180,347,121,174,402,137
4685,337,170,167,45,83,42,44,71,52
4691,307,153,154,42,78,33,37,67,50
4693,952,470,482,134,251,85,144,233,105
4694,2536,1292,1244,358,683,251,314,657,273
4730,10586,5127,5459,1610,2530,987,1425,2584,1450
4732,1696,881,815,271,447,163,213,429,173
4733,235,127,108,40,60,27,33,54,21
4735,630,328,302,97,154,77,70,156,76
4736,10312,5024,5288,1445,2626,953,1279,2709,1300
4739,1012,513,499,128,253,132,104,249,146
4740,1249,594,655,177,303,114,187,321,147
4742,3579,1687,1892,550,821,316,533,882,477
4743,4909,2460,2449,823,1214,423,630,1232,587
4745,1222,601,621,162,322,117,165,309,147
4746,548,278,270,64,143,71,61,148,61
4747,1260,612,648,147,333,132,160,339,149
4750,2660,1391,1269,545,666,180,475,600,194
4756,3711,1669,2042,370,881,418,499,945,598
4757,2882,1455,1427,430,772,253,369,788,270
4758,2313,1088,1225,336,522,230,330,555,340
4759,162,91,71,20,55,16,15,44,12
4760,810,388,422,100,202,86,121,195,106
4762,521,259,262,78,134,47,61,141,60
4763,1019,497,522,148,242,107,140,251,131
4764,51,24,27,2,9,13,4,19,4
4765,1449,731,718,196,370,165,148,387,183
4766,434,213,221,51,100,62,67,102,52
4768,356,179,177,24,113,42,15,99,63
4769,9511,4503,5008,1476,2283,744,1429,2421,1158
4772,886,432,454,87,259,86,106,239,109
4773,827,452,375,126,222,104,88,228,59
4774,855,430,425,101,226,103,108,207,110
4776,942,476,466,129,245,102,115,252,99
4777,517,239,278,72,104,63,80,123,75
4779,168,92,76,25,46,21,16,41,19
4780,469,225,244,62,125,38,76,118,50
4781,571,283,288,99,136,48,89,146,53
4783,657,338,319,67,177,94,67,163,89
4785,3019,1431,1588,371,706,354,351,773,464
4786,1704,855,849,250,427,178,191,437,221
4787,610,306,304,82,155,69,74,163,67
4841,7670,3523,4147,913,1932,678,1021,2027,1099
4843,5254,2432,2822,636,1198,598,553,1379,890
4847,1310,642,668,213,339,90,169,390,109
4848,610,280,330,64,149,67,84,157,89
4849,3366,1708,1658,439,936,333,384,929,345
4851,51,26,25,4,14,8,5,13,7
4852,79,41,38,6,30,5,7,25,6
4853,388,197,191,61,107,29,53,108,30
4854,1540,740,800,181,356,203,158,388,254
4856,3222,1561,1661,451,804,306,381,893,387
4857,610,337,273,104,174,59,69,149,55
4858,1416,674,742,190,339,145,190,371,181
4859,691,344,347,123,148,73,102,181,64
4860,1279,606,673,120,292,194,115,304,254
4861,3724,1996,1728,486,1185,325,414,888,426
4862,3487,1709,1778,529,926,254,496,957,325
4863,1226,596,630,160,324,112,170,283,177
4864,3818,2031,1787,577,1205,249,542,966,279
4901,26419,12410,14009,4156,6139,2115,4069,6483,3457
4910,1936,957,979,307,488,162,283,518,178
4911,1931,1000,931,341,501,158,253,497,181
4912,915,452,463,135,244,73,115,242,106
4915,8354,3956,4398,1165,1969,822,1103,2250,1045
4917,2984,1442,1542,437,787,218,438,835,269
4920,1756,874,882,247,453,174,242,435,205
4921,1516,751,765,248,387,116,210,414,141
4922,1139,567,572,170,314,83,184,314,74
4923,547,273,274,95,119,59,75,154,45
4924,2013,990,1023,309,564,117,323,566,134
4925,124,66,58,22,33,11,11,29,18
4927,3335,1703,1632,583,896,224,489,922,221
4928,2145,1074,1071,316,535,223,312,536,223
4929,780,394,386,108,228,58,118,211,57
4930,4296,2021,2275,565,1012,444,593,1065,617
4932,1070,538,532,147,319,72,139,324,69
4936,215,112,103,29,54,29,20,48,35
4937,6548,3194,3354,1081,1672,441,1026,1762,566
4938,9260,4198,5062,1396,2094,708,1807,2226,1029
4939,989,498,491,172,243,83,167,256,68
4941,1534,791,743,231,465,95,226,406,111
4942,991,478,513,109,256,113,130,264,119
4943,1805,875,930,257,466,152,262,449,219
4945,1034,531,503,153,296,82,133,272,98
4947,1834,915,919,287,485,143,229,517,173
4949,1053,504,549,147,265,92,169,286,94
4950,4501,2130,2371,548,1148,434,582,1130,659
4951,894,438,456,127,246,65,144,239,73
4952,1666,803,863,242,432,129,228,474,161
4953,3023,1478,1545,469,737,272,425,797,323
4954,271,123,148,32,65,26,29,82,37
4955,1315,654,661,198,334,122,193,356,112
4956,746,360,386,109,206,45,127,197,62
4957,4007,1949,2058,555,1121,273,618,1089,351
4958,2028,1019,1009,282,554,183,288,503,218
4961,832,392,440,102,221,69,126,223,91
4962,1147,515,632,154,267,94,189,319,124
4963,6937,3396,3541,1073,1833,490,1058,1932,551
4964,180,92,88,10,51,31,11,45,32
4965,1979,974,1005,299,510,165,269,518,218
4966,1494,725,769,208,385,132,201,398,170
4967,4228,2031,2197,685,1044,302,678,1067,452
4969,1251,629,622,211,345,73,203,342,77
4970,1317,669,648,157,344,168,168,321,159
4971,1836,933,903,283,499,151,255,503,145
4973,1159,593,566,174,344,75,158,319,89
4974,2693,1298,1395,406,617,275,337,749,309
4976,10061,4835,5226,1442,2545,848,1337,2643,1246
4978,930,465,465,120,249,96,125,247,93
4979,951,495,456,140,266,89,119,248,89
4981,2123,1079,1044,318,578,183,269,571,204
4982,632,340,292,110,189,41,98,142,52
4983,1731,858,873,282,419,157,240,462,171
4984,543,274,269,76,162,36,79,160,30
4985,113,61,52,2,46,13,3,34,15
4986,1473,750,723,246,386,118,221,384,118
4987,954,485,469,165,256,64,126,278,65
4988,1812,884,928,318,431,135,301,428,199
4989,2675,1381,1294,432,734,215,357,706,231
5001,9173,4279,4894,1288,2251,740,1240,2666,988
5031,93,48,45,5,23,20,8,22,15
5032,2665,1280,1385,399,680,201,394,748,243
5033,2771,1303,1468,414,662,227,447,695,326
5034,291,132,159,45,65,22,48,79,32
5035,741,398,343,108,223,67,80,195,68
5036,1019,523,496,156,283,84,129,287,80
5037,401,216,185,64,98,54,49,115,21
5038,1310,674,636,232,311,131,153,312,171
5039,1119,561,558,186,293,82,165,290,103
5040,453,252,201,88,132,32,59,118,24
5041,205,110,95,33,57,20,32,63,0
5042,585,306,279,83,149,74,69,138,72
5043,590,306,284,92,187,27,70,176,38
5045,1608,778,830,225,427,126,226,468,136
5046,1152,546,606,170,268,108,193,293,120
5048,1916,942,974,316,498,128,279,557,138
5051,541,282,259,95,122,65,55,116,88
5052,212,105,107,26,57,22,30,56,21
5053,224,121,103,38,58,25,24,54,25
5054,226,119,107,52,57,10,29,70,8
5055,3477,1682,1795,589,860,233,532,938,325
5056,338,173,165,52,78,43,38,88,39
5058,71,33,38,6,15,12,3,19,16
5059,688,404,284,65,241,98,42,182,60
5060,4613,2224,2389,649,1181,394,683,1169,537
5061,1521,850,671,492,298,60,287,295,89
5062,731,358,373,96,204,58,80,216,77
5065,1193,630,563,217,339,74,160,337,66
5067,211,106,105,33,62,11,26,59,20
5068,2993,1499,1494,393,905,201,412,869,213
5069,724,367,357,135,172,60,112,180,65
5070,444,212,232,66,111,35,73,127,32
5071,436,208,228,48,98,62,43,118,67
5072,483,245,238,72,134,39,55,131,52
5073,268,110,158,13,67,30,36,75,47
5074,147,68,79,23,36,9,27,42,10
5075,1528,761,767,262,407,92,230,426,111
5076,552,256,296,69,136,51,99,144,53
5077,1271,618,653,176,332,110,164,369,120
5079,620,291,329,90,173,28,109,175,45
5081,845,391,454,93,223,75,133,232,89
5083,207,101,106,36,51,14,34,52,20
5084,89,44,45,6,21,17,8,15,22
5085,190,90,100,19,50,21,25,56,19
5086,771,386,385,113,230,43,126,219,40
5088,763,331,432,88,174,69,161,191,80
5089,5543,2641,2902,700,1423,518,698,1330,874
5091,3359,1712,1647,481,881,350,335,933,379
5101,4909,2391,2518,789,1165,437,696,1239,583
5142,783,381,402,99,208,74,94,206,102
5143,4658,2311,2347,651,1260,400,611,1233,503
5146,605,319,286,77,161,81,64,146,76
5148,751,369,382,84,193,92,104,200,78
5149,2647,1324,1323,342,689,293,311,654,358
5150,722,340,382,73,198,69,80,188,114
5151,1266,614,652,171,340,103,176,368,108
5152,566,286,280,90,131,65,64,149,67
5153,808,384,424,71,225,88,118,206,100
5154,349,161,188,46,82,33,47,103,38
5155,1053,559,494,147,303,109,128,249,117
5156,9081,4356,4725,1237,2201,918,1234,2352,1139
5158,947,462,485,176,217,69,151,229,105
5161,609,309,300,81,120,108,52,164,84
5201,15863,7459,8404,2395,3692,1372,2343,4124,1937
5250,3317,1573,1744,420,834,319,446,877,421
5251,1870,914,956,245,411,258,214,442,300
5252,311,170,141,42,106,22,45,85,11
5253,568,319,249,88,183,48,60,147,42
5254,218,103,115,16,55,32,11,45,59
5255,3962,1852,2110,518,947,387,492,1054,564
5257,2588,1232,1356,462,596,174,551,595,210
5260,290,152,138,64,70,18,52,62,24
5261,2388,1226,1162,378,681,167,328,625,209
5262,2457,1166,1291,328,635,203,327,690,274
5301,16421,7745,8676,2273,4178,1294,2087,4717,1872
5340,696,348,348,74,195,79,80,183,85
5341,614,322,292,97,174,51,79,171,42
5342,575,296,279,101,140,55,80,139,60
5343,888,461,427,124,255,82,98,241,88
5344,290,131,159,77,51,3,109,42,8
5345,1730,892,838,260,482,150,226,463,149
5346,5246,2588,2658,900,1379,309,820,1477,361
5350,803,394,409,101,212,81,122,177,110
5351,131,70,61,19,42,9,15,44,2
5352,828,441,387,155,218,68,100,211,76
5353,1020,485,535,133,245,107,122,287,126
5354,2134,1066,1068,368,541,157,292,561,215
5355,697,353,344,105,186,62,89,183,72
5356,796,412,384,92,230,90,101,215,68
5358,134,74,60,15,36,23,6,34,20
5359,402,186,216,53,93,40,76,103,37
5360,261,138,123,34,86,18,34,77,12
5361,855,422,433,123,229,70,128,237,68
5362,328,123,205,32,73,18,65,109,31
5363,2261,1129,1132,326,573,230,263,638,231
5401,38924,18704,20220,6198,10568,1938,6691,10275,3254
5403,15746,7362,8384,2309,4102,951,2489,4297,1598
5404,6561,3246,3315,881,1952,413,781,1841,693
5440,1952,959,993,277,521,161,281,509,203
5441,477,222,255,87,107,28,93,131,31
5442,286,144,142,50,74,20,39,75,28
5443,6353,3117,3236,996,1784,337,976,1802,458
5444,1453,776,677,276,418,82,192,428,57
5445,3543,1809,1734,646,951,212,516,1005,213
5446,17256,8478,8778,2817,4909,752,3007,4877,894
5448,1437,730,707,258,396,76,228,387,92
5450,4991,2497,2494,867,1289,341,792,1296,406
5452,18471,9017,9454,2902,5165,950,3056,5305,1093
5454,4053,2187,1866,700,1341,146,672,1061,133
5455,1129,550,579,187,314,49,214,309,56
5456,1260,624,636,191,351,82,186,347,103
5457,1551,767,784,237,426,104,280,377,127
5458,2008,1016,992,300,572,144,255,580,157
5459,1918,949,969,331,506,112,333,512,124
5461,4412,2172,2240,766,1213,193,684,1317,239
5462,1873,934,939,292,577,65,280,591,68
5463,498,235,263,67,111,57,77,124,62
5464,2426,1221,1205,322,754,145,357,677,171
5465,5380,2636,2744,911,1467,258,847,1644,253
5468,11331,5639,5692,1884,3295,460,1877,3334,481
5471,671,330,341,85,200,45,85,187,69
5472,1641,829,812,257,469,103,237,473,102
5473,1262,628,634,197,372,59,159,397,78
5474,800,416,384,105,229,82,93,227,64
5476,3256,1603,1653,520,811,272,481,810,362
5477,4581,2241,2340,699,1371,171,748,1388,204
5478,14641,7126,7515,2406,3702,1018,2033,3965,1517
5482,6977,3326,3651,1059,1700,567,1042,1844,765
5483,1373,691,682,228,388,75,242,350,90
5486,1643,816,827,245,451,120,223,472,132
5487,1572,776,796,253,459,64,298,432,66
5488,7334,3480,3854,1065,1950,465,1206,2010,638
5489,3163,1614,1549,536,906,172,465,926,158
5491,6141,3098,3043,1117,1549,432,935,1631,477
5492,722,394,328,146,193,55,78,198,52
5494,1843,924,919,325,528,71,307,543,69
5495,8348,4080,4268,1314,2189,577,1237,2296,735
5602,12275,5734,6541,1582,3295,857,1651,3540,1350
5640,54,15,39,5,6,4,19,16,4
5641,17229,8226,9003,2410,4436,1380,2267,4525,2211
5647,892,436,456,142,237,57,167,227,62
5648,449,222,227,51,136,35,74,112,41
5649,276,153,123,50,78,25,34,71,18
5650,875,459,416,138,279,42,87,287,42
5651,1454,720,734,263,342,115,210,412,112
5652,681,347,334,130,176,41,111,178,45
5653,471,248,223,79,145,24,80,118,25
5654,1249,582,667,224,296,62,212,342,113
5655,2804,1443,1361,455,774,214,361,753,247
5656,3305,1683,1622,695,822,166,624,793,205
5657,87,37,50,13,14,10,16,26,8
5658,1495,769,726,254,420,95,229,382,115
5660,1238,630,608,191,380,59,185,358,65
5661,5458,2635,2823,818,1406,411,763,1440,620
5663,6248,3426,2822,1637,1401,388,884,1434,504
5664,328,182,146,73,88,21,20,97,29
5666,71,32,39,6,24,2,18,21,0
5667,2422,1166,1256,345,673,148,368,742,146
5669,454,219,235,67,124,28,73,131,31
5672,4339,2200,2139,564,1247,389,475,1272,392
5673,2344,1178,1166,287,682,209,279,686,201
5674,1681,864,817,216,514,134,213,484,120
5675,960,502,458,167,278,57,129,260,69
5676,4751,2366,2385,708,1417,241,631,1391,363
5677,1874,921,953,276,468,177,248,565,140
5678,93,51,42,26,4,21,0,16,26
5679,2944,1528,1416,496,858,174,402,799,215
5680,2003,1024,979,352,559,113,312,573,94
5681,267,144,123,47,76,21,28,74,21
5682,1161,556,605,156,340,60,177,349,79
5701,22034,10445,11589,2990,5575,1880,2963,5683,2943
5730,354,179,175,59,98,22,48,107,20
5732,552,334,218,100,169,65,34,121,63
5733,5663,2703,2960,762,1474,467,796,1619,545
5734,1252,645,607,205,342,98,183,309,115
5735,4342,2108,2234,828,1027,253,860,1010,364
5736,379,183,196,58,88,37,45,105,46
5737,694,341,353,94,203,44,117,189,47
5738,1160,548,612,162,293,93,157,336,119
5739,1266,653,613,179,365,109,171,337,105
5742,468,234,234,50,140,44,65,127,42
5743,4435,2168,2267,710,1108,350,651,1182,434
5744,604,292,312,80,162,50,85,175,52
5746,76,38,38,14,19,5,11,23,4
5747,311,160,151,52,79,29,46,82,23
5748,333,180,153,41,87,52,29,70,54
5750,82,41,41,14,27,0,0,31,10
5751,1095,587,508,124,364,99,114,320,74
5753,10129,4881,5248,2101,2074,706,2031,2237,980
5757,864,416,448,121,219,76,109,259,80
5758,821,417,404,120,213,84,122,212,70
5759,1994,979,1015,251,548,180,246,580,189
5760,1188,579,609,180,305,94,193,320,96
5761,1039,543,496,157,291,95,130,262,104
5762,430,223,207,58,111,54,42,122,43
5763,2848,1428,1420,438,763,227,362,782,276
5764,3706,1839,1867,645,855,339,628,813,426
5765,1921,895,1026,262,477,156,296,491,239
5766,591,309,282,97,185,27,74,187,21
5767,1171,560,611,128,309,123,155,316,140
5769,1127,564,563,170,303,91,144,311,108
5770,1058,521,537,161,273,87,167,290,80
5772,525,264,261,73,126,65,45,144,72
5773,2330,1138,1192,322,635,181,302,674,216
5774,1050,522,528,150,247,125,120,277,131
5775,648,310,338,90,156,64,105,149,84
5776,186,88,98,29,37,22,32,47,19
5777,3643,1779,1864,521,983,275,542,984,338
5778,712,352,360,110,193,49,104,199,57
5819,9208,4492,4716,1408,2269,815,1270,2245,1201
5820,286,144,142,31,89,24,31,83,28
5821,1461,762,699,249,368,145,164,388,147
5822,1715,824,891,240,464,120,274,467,150
5824,731,359,372,82,206,71,124,191,57
5825,129,73,56,28,34,11,20,25,11
5826,872,410,462,124,204,82,118,219,125
5827,323,154,169,45,68,41,52,75,42
5828,2058,989,1069,322,498,169,295,559,215
5829,1815,894,921,329,407,158,219,476,226
5830,1450,727,723,238,364,125,194,366,163
5832,853,444,409,117,270,57,97,244,68
5833,176,82,94,24,54,4,43,51,0
5836,1197,559,638,168,330,61,204,342,92
5837,293,147,146,42,73,32,51,72,23
5839,801,411,390,123,219,69,92,212,86
5840,77,37,40,5,23,9,15,19,6
5841,407,174,233,44,78,52,37,103,93
5842,354,186,168,58,88,40,39,77,52
5843,2629,1287,1342,471,642,174,427,681,234
5845,1115,581,534,213,296,72,149,307,78
5846,1305,642,663,204,307,131,181,315,167
5847,743,365,378,126,185,54,135,180,63
5851,6334,3197,3137,1251,1489,457,963,1546,628
5853,526,273,253,102,124,47,60,143,50
5855,7924,3960,3964,1165,2141,654,1040,1936,988
5857,1464,747,717,223,414,110,205,376,136
5858,399,204,195,68,120,16,48,111,36
5859,1838,925,913,303,470,152,281,444,188
5860,2454,1224,1230,358,643,223,323,587,320
5866,712,345,367,97,192,56,136,190,41
5867,874,441,433,161,217,63,143,221,69
5868,121,63,58,19,33,11,15,26,17
5871,1558,785,773,248,427,110,250,405,118
5872,683,322,361,98,179,45,105,199,57
5873,612,314,298,127,149,38,102,131,65
5874,496,250,246,70,135,45,53,149,44
5875,543,268,275,88,122,58,81,125,69
5902,229,102,127,38,52,12,35,69,23
5903,1026,510,516,179,251,80,148,274,94
5904,429,238,191,91,114,33,60,88,43
5905,786,413,373,122,212,79,102,184,87
5906,1085,529,556,139,283,107,159,273,124
5907,99,58,41,9,28,21,8,16,17
6001,16110,7663,8447,2298,3920,1445,2276,4437,1734
6002,19587,8833,10754,2449,4350,2034,2341,5243,3170
6010,60157,28960,31197,8161,16100,4699,8049,16441,6707
6013,8245,4108,4137,1312,2375,421,1264,2409,464
6016,5142,2576,2566,848,1420,308,675,1427,464
6018,2762,1291,1471,353,700,238,343,682,446
6019,4086,1942,2144,571,1073,298,575,1179,390
6020,388,233,155,109,110,14,33,103,19
6021,294,149,145,48,77,24,45,77,23
6022,4469,2120,2349,552,1258,310,652,1296,401
6023,1403,706,697,238,357,111,154,402,141
6024,588,304,284,72,191,41,141,134,9
6026,4790,2363,2427,658,1324,381,708,1298,421
6027,1437,728,709,249,383,96,210,410,89
6029,12904,6463,6441,1934,3737,792,1740,3801,900
6031,1603,771,832,199,352,220,207,436,189
6032,16239,7542,8697,2055,4075,1412,1973,4616,2108
6033,27253,12846,14407,4141,6660,2045,3941,7643,2823
6035,7226,3470,3756,1011,1902,557,1018,2039,699
6037,16796,8123,8673,2354,4309,1460,2335,4312,2026
6039,2132,1037,1095,316,497,224,241,585,269
6040,54745,26134,28611,7446,14824,3864,6973,16032,5606
6043,4989,2448,2541,721,1351,376,762,1349,430
6051,28335,13712,14623,5125,6772,1815,4761,7065,2797
6052,8042,3849,4193,947,2105,797,965,2096,1132
6053,35177,16981,18196,5649,8462,2870,5291,8790,4115
6057,5006,2520,2486,746,1383,391,649,1439,398
6058,1771,876,895,223,490,163,257,443,195
6059,929,452,477,90,279,83,104,299,74
6060,2274,1214,1060,394,706,114,334,658,68
6062,17200,8413,8787,2298,4790,1325,1990,4837,1960
6063,625,344,281,94,185,65,62,166,53
6065,199,97,102,32,45,20,33,55,14
6066,28108,13668,14440,3824,7816,2028,3467,8010,2963
6067,17942,8802,9140,2041,5077,1684,1938,5215,1987
6068,1356,599,757,160,278,161,167,317,273
6069,2745,1340,1405,351,679,310,298,677,430
6070,14463,6885,7578,2338,3396,1151,2223,3840,1515
6071,10437,6400,4037,1532,4187,681,1159,2138,740
6073,4623,2242,2381,678,1268,296,697,1357,327
6074,24466,11737,12729,3844,6287,1606,3669,6871,2189
6076,11965,5887,6078,1722,3298,867,1758,3190,1130
6078,10415,5768,4647,1584,3357,827,1158,2333,1156
6081,1332,701,631,222,374,105,158,367,106
6082,45212,23597,21615,6243,13866,3488,5845,11235,4535
6084,13163,6435,6728,2062,3614,759,2110,3821,797
6085,7063,3476,3587,1210,1866,400,1037,1973,577
6088,4676,2287,2389,560,1291,436,443,1297,649
6089,3186,1651,1535,546,903,202,381,925,229
6090,847,464,383,169,231,64,131,213,39
6091,575,283,292,59,187,37,97,140,55
6092,4253,2106,2147,806,1010,290,742,1065,340
6093,3092,1507,1585,387,854,266,472,830,283
6095,28250,13340,14910,3992,7257,2091,4040,7701,3169
6096,12043,5826,6217,1654,3100,1072,1633,3129,1455
6098,14345,7048,7297,2168,3834,1046,1844,3984,1469
6103,746,384,362,67,279,38,121,209,32
6105,19835,9390,10445,2892,5332,1166,2917,5825,1703
6106,40559,19451,21108,8047,9410,1994,8012,10152,2944
6107,18468,8678,9790,2622,4247,1809,2237,4863,2690
6108,23484,11447,12037,3694,6085,1668,3522,6351,2164
6109,26236,12134,14102,2991,5917,3226,2986,6668,4448
6110,12143,5746,6397,1880,2810,1056,1473,3240,1684
6111,29306,13732,15574,3593,7281,2858,3275,8261,4038
6112,22308,10058,12250,4526,4218,1314,4308,5982,1960
6114,25869,12219,13650,4779,6081,1359,4675,6854,2121
6117,17538,8034,9504,3063,3178,1793,3374,3292,2838
6118,26091,12215,13876,3465,6340,2410,3349,6887,3640
6119,14961,6865,8096,1802,3954,1109,1850,4364,1882
6120,12766,6324,6442,3002,2763,559,2587,3126,729
6226,18126,8697,9429,3242,4478,977,3555,4387,1487
6231,3254,1614,1640,448,1019,147,519,1026,95
6232,3019,1512,1507,453,907,152,426,899,182
6234,5297,2777,2520,744,1734,299,712,1391,417
6235,583,309,274,109,168,32,85,162,27
6237,4971,2471,2500,775,1364,332,671,1446,383
6238,11504,5800,5704,1776,3358,666,1705,3257,742
6239,12899,6348,6551,2252,3122,974,1823,3326,1402
6241,6245,2978,3267,824,1706,448,908,1773,586
6242,1292,650,642,200,328,122,172,350,120
6247,2374,1173,1201,374,654,145,347,699,155
6248,5356,2648,2708,1002,1424,222,887,1495,326
6249,6907,3468,3439,1153,1874,441,1024,1961,454
6250,4525,2197,2328,628,1265,304,601,1287,440
6254,1835,923,912,263,513,147,245,505,162
6255,4846,2379,2467,708,1357,314,669,1331,467
6256,3338,1673,1665,493,984,196,414,968,283
6259,4090,1999,2091,630,1098,271,645,1121,325
6260,8927,4265,4662,1290,2303,672,1172,2361,1129
6262,390,180,210,36,72,72,33,86,91
6264,128,66,62,13,41,12,16,41,5
6266,368,176,192,44,101,31,55,128,9
6268,8554,4352,4202,1415,2297,640,1447,1967,788
6269,7515,3555,3960,2876,650,29,3466,488,6
6277,3661,1877,1784,617,966,294,550,957,277
6278,4162,2073,2089,643,1178,252,608,1226,255
6279,5959,3058,2901,860,1847,351,896,1679,326
6280,3262,1566,1696,409,799,358,357,889,450
6281,5886,2912,2974,898,1559,455,742,1654,578
6282,1376,661,715,202,394,65,274,362,79
6320,25671,12371,13300,4423,6406,1542,4483,6509,2308
6330,3780,1772,2008,546,1005,221,622,1024,362
6331,4741,2415,2326,837,1262,316,666,1301,359
6333,5976,2948,3028,1032,1505,411,952,1610,466
6334,2302,1163,1139,335,653,175,291,605,243
6335,6860,3414,3446,1151,1825,438,1035,1861,550
6336,38,21,17,2,15,4,4,9,4
6339,7835,3868,3967,1358,1979,531,1278,2249,440
6340,31677,16152,15525,5385,8997,1770,4867,7930,2728
6351,11350,5612,5738,1654,3228,730,1595,3130,1013
6354,5508,2683,2825,828,1518,337,868,1487,470
6355,12014,5806,6208,1460,3291,1055,1407,3381,1420
6357,12142,5760,6382,1397,3371,992,1295,3783,1304
6359,4991,2508,2483,734,1417,357,695,1407,381
6360,38280,18329,19951,5493,10003,2833,5504,10231,4216
6365,1225,660,565,173,385,102,111,364,90
6370,6674,3288,3386,1066,1865,357,1039,1948,399
6371,9386,4668,4718,1175,2441,1052,1183,2434,1101
6373,234,137,97,34,90,13,30,60,7
6374,8633,4210,4423,1474,2239,497,1232,2404,787
6375,3326,1561,1765,478,786,297,650,743,372
6376,36,15,21,0,0,15,0,7,14
6377,2504,1237,1267,417,720,100,425,690,152
6378,5505,2712,2793,689,1438,585,561,1559,673
6379,8622,4197,4425,1241,2221,735,1170,2353,902
6380,2873,1369,1504,459,723,187,367,793,344
6382,11850,6704,5146,1842,4046,816,1310,2746,1090
6384,4038,2085,1953,619,1190,276,587,1089,277
6385,15848,7564,8284,2067,3803,1694,1995,4118,2171
6390,269,123,146,22,81,20,32,85,29
6401,18554,8942,9612,2802,4654,1486,2447,5037,2128
6403,5239,2684,2555,819,1558,307,651,1532,372
6405,28683,13544,15139,3503,7491,2550,3207,8434,3498
6409,576,286,290,47,183,56,65,101,124
6410,28484,15199,13285,4953,8384,1862,3606,7116,2563
6412,3743,1767,1976,448,1037,282,480,1055,441
6413,13050,6283,6767,1934,3525,824,1837,3781,1149
6415,15211,7340,7871,2369,4201,770,2458,4353,1060
6416,12871,6163,6708,1619,3523,1021,1521,3697,1490
6417,4610,2283,2327,643,1304,336,629,1259,439
6418,12391,5947,6444,1666,3279,1002,1436,3441,1567
6419,6018,2977,3041,870,1626,481,860,1696,485
6420,3834,1910,1924,643,1087,180,657,1104,163
6422,6627,3306,3321,1106,1811,389,998,1843,480
6423,4738,2439,2299,823,1368,248,608,1391,300
6424,13358,6672,6686,2715,3331,626,2624,3318,744
6426,3049,1387,1662,270,748,369,271,799,592
6430,32357,15503,16854,5435,7541,2527,5160,8325,3369
6432,20738,9759,10979,3144,4808,1807,3105,5029,2845
6437,21357,10270,11087,3059,5566,1645,3009,6034,2044
6438,2017,966,1051,312,510,144,234,669,148
6441,4818,2464,2354,715,1404,345,630,1395,329
6442,2880,1436,1444,436,849,151,388,786,270
6443,17858,8611,9247,2772,4382,1457,2698,4629,1920
6447,5709,2856,2853,897,1664,295,772,1744,337
6450,34288,16660,17628,4963,9181,2516,4790,9146,3692
6451,23956,11587,12369,4047,5929,1611,3550,6332,2487
6455,2906,1467,1439,431,824,212,412,758,269
6457,43167,20901,22266,5952,11894,3055,5185,12661,4420
6460,52305,25160,27145,7007,13957,4196,6472,14841,5832
6468,19247,9457,9790,3095,5127,1235,3009,5271,1510
6469,2959,1463,1496,406,871,186,373,816,307
6470,14614,7678,6936,2395,4306,977,2130,3862,944
6471,7853,3788,4065,1151,2015,622,1054,2138,873
6472,6094,3004,3090,944,1644,416,882,1723,485
6473,23234,11254,11980,3218,5751,2285,2791,6077,3112
6475,10367,4878,5489,1271,2446,1161,1247,2643,1599
6477,13233,6403,6830,1774,3270,1359,1825,3280,1725
6478,9821,4927,4894,1589,2781,557,1488,2777,629
6479,10287,4942,5345,1437,2743,762,1386,2883,1076
6480,9048,4408,4640,1340,2343,725,1216,2444,980
6481,1297,628,669,166,322,140,184,308,177
6482,10417,5173,5244,1739,2950,484,1604,2970,670
6483,15454,7539,7915,2122,4240,1177,2130,4219,1566
6484,38101,18450,19651,5288,10122,3040,4873,10530,4248
6488,18567,8636,9931,2370,4190,2076,2209,4247,3475
6489,29441,14317,15124,4162,7717,2438,3785,8022,3317
6490,4207,1990,2217,607,939,444,526,1064,627
6492,43026,20692,22334,6053,11286,3353,5740,11812,4782
6498,6336,3097,3239,856,1656,585,746,1697,796
6504,50,17,33,10,0,7,12,6,15
6510,2239,1173,1066,340,798,35,331,688,47
6511,53272,26155,27117,9660,14353,2142,9096,14627,3394
6512,28222,13521,14701,3672,7351,2498,3320,7657,3724
6513,35394,16490,18904,6250,7992,2248,6005,9495,3404
6514,24863,11513,13350,3543,5925,2045,3416,6746,3188
6515,16445,7514,8931,3008,3598,908,3046,4421,1464
6516,52360,25094,27266,7537,13718,3839,7169,14486,5611
6517,14325,6676,7649,1933,3396,1347,1718,3755,2176
6518,17672,7977,9695,2601,4065,1311,3479,4276,1940
6519,16047,7711,8336,3388,3465,858,3202,3793,1341
6524,5040,2508,2532,794,1345,369,739,1373,420
6525,8983,4370,4613,1375,2151,844,1317,2249,1047
6604,30081,14755,15326,5379,7686,1690,5159,7424,2743
6605,23750,11538,12212,4394,6021,1123,4213,6313,1686
6606,42592,19991,22601,6830,10344,2817,6601,11780,4220
6607,7528,3347,4181,1310,1647,390,1609,2083,489
6608,13396,6354,7042,2998,2868,488,2884,3394,764
6610,22099,10332,11767,3513,5325,1494,3394,5792,2581
6611,34326,16551,17775,5097,8221,3233,4882,8647,4246
6612,7272,3539,3733,1114,1846,579,1103,1972,658
6614,32289,15170,17119,4147,7616,3407,3960,8160,4999
6615,17687,8376,9311,2668,4301,1407,2583,4776,1952
6702,3785,1719,2066,543,766,410,641,710,715
6704,25993,12355,13638,4724,6042,1589,4446,6760,2432
6705,24484,11389,13095,3389,6116,1884,3375,6599,3121
6706,14055,6779,7276,2416,3336,1027,2504,3378,1394
6708,28604,13460,15144,3857,7203,2400,4020,7724,3400
6710,10324,4796,5528,1787,2360,649,1982,2655,891
6712,8656,4217,4439,1254,2323,640,1212,2357,870
6716,15208,7301,7907,2229,4027,1045,2312,4102,1493
6750,1427,646,781,181,343,122,257,330,194
6751,3570,1734,1836,483,1003,248,481,1039,316
6752,1824,892,932,235,468,189,233,512,187
6754,1263,654,609,196,350,108,153,345,111
6755,1094,538,556,165,314,59,213,262,81
6756,2596,1260,1336,330,654,276,340,711,285
6757,2197,1073,1124,278,552,243,224,555,345
6759,5720,2752,2968,744,1361,647,729,1498,741
6762,6924,3359,3565,1002,1769,588,851,1828,886
6763,2105,1051,1054,292,547,212,299,543,212
6770,30666,14938,15728,4885,8173,1880,4645,8432,2651
6776,25842,12805,13037,4173,7176,1456,3700,7474,1863
6777,1912,971,941,261,512,198,233,495,213
6778,66,38,28,20,18,0,7,15,6
6779,8198,3882,4316,1129,2155,598,1258,2221,837
6782,2064,1031,1033,308,563,160,278,591,164
6783,2076,1065,1011,294,582,189,231,598,182
6784,3989,1986,2003,594,1034,358,551,1069,383
6785,619,318,301,109,193,16,96,160,45
6786,9570,4768,4802,1459,2671,638,1359,2549,894
6787,8802,4364,4438,1251,2553,560,1213,2472,753
6790,35325,17188,18137,4994,9224,2970,4392,9258,4487
6791,5289,2641,2648,773,1442,426,728,1421,499
6793,1333,661,672,200,337,124,173,377,122
6794,1032,512,520,187,226,99,125,280,115
6795,13487,6557,6930,2078,3536,943,1797,3657,1476
6796,954,448,506,131,211,106,130,259,117
6798,9208,4505,4703,1301,2470,734,1121,2695,887
6801,18024,8735,9289,2760,4855,1120,2746,5153,1390
6804,16039,7781,8258,2424,4297,1060,2446,4507,1305
6807,6914,3292,3622,976,1729,587,955,2020,647
6810,44772,22606,22166,6214,13843,2549,6272,12022,3872
6811,29744,13837,15907,3891,7980,1966,3872,9547,2488
6812,13953,6949,7004,2366,3781,802,2174,3821,1009
6820,19607,9631,9976,3539,4662,1430,3189,5102,1685
6830,24618,11575,13043,3270,6201,2104,2990,6960,3093
6831,15005,6991,8014,1890,3569,1532,2094,3874,2046
6840,19427,9321,10106,3289,4580,1452,3135,5122,1849
6850,16913,8280,8633,2153,4841,1286,1887,5007,1739
6851,26215,12650,13565,3287,7355,2008,2919,7673,2973
6853,3401,1644,1757,390,960,294,359,1007,391
6854,28421,13972,14449,4310,8077,1585,3845,8366,2238
6855,7969,3855,4114,957,2242,656,883,2303,928
6870,7124,3438,3686,1085,1767,586,1096,1844,746
6877,23668,11367,12301,3920,5895,1552,3760,6536,2005
6878,7620,3710,3910,1335,1717,658,1142,1956,812
6880,25787,12224,13563,3847,5986,2391,3799,6964,2800
6883,10037,4966,5071,1807,2457,702,1704,2719,648
6896,8245,4117,4128,1288,2206,623,1222,2266,640
6897,17633,8516,9117,3168,4084,1264,2769,4654,1694
6901,6260,3238,3022,637,2172,429,390,1917,715
6902,59746,28679,31067,8253,16670,3756,7989,17084,5994
6903,14368,7137,7231,2197,3624,1316,1824,4017,1390
6905,19708,9539,10169,2186,5758,1595,2185,5584,2400
6906,7670,3679,3991,792,2328,559,904,2320,767
6907,9151,4396,4755,1090,2558,748,1062,2650,1043
7001,14263,7378,6885,1875,4663,840,1917,3933,1035
7002,61842,29248,32594,8196,15975,5077,8017,16921,7656
7003,47674,22429,25245,5926,13038,3465,6129,14135,4981
7004,7063,3447,3616,932,1829,686,875,1924,817
7005,15179,7520,7659,2199,4206,1115,1818,4303,1538
7006,26192,12709,13483,3401,6968,2340,3373,6903,3207
7008,20709,10137,10572,3336,5171,1630,2883,5408,2281
7009,12300,5743,6557,1425,3008,1310,1286,3196,2075
7010,23007,11134,11873,2442,6554,2138,2311,6452,3110
7011,37001,17523,19478,5474,9699,2350,5453,10130,3895
7012,12282,5895,6387,1293,3146,1456,1261,3194,1932
7013,24754,11809,12945,2886,6263,2660,2733,6411,3801
7014,4248,1994,2254,511,1147,336,528,1271,455
7016,22578,10680,11898,2984,5667,2029,2785,6260,2853
7017,39538,17891,21647,6793,8741,2357,6359,11210,4078
7018,30379,13464,16915,5067,6657,1740,5205,8801,2909
7020,7677,3692,3985,672,2606,414,652,2810,523
7021,2146,1052,1094,347,495,210,339,519,236
7022,13255,6784,6471,2053,3814,917,1663,3487,1321
7023,7174,3455,3719,1090,1828,537,947,1987,785
7024,35461,16320,19141,3426,9110,3784,3754,10205,5182
7026,29851,14566,15285,4214,8330,2022,3950,8262,3073
7027,4153,1974,2179,493,1122,359,436,1251,492
7028,7392,3551,3841,1245,1872,434,1202,2013,626
7029,16801,8552,8249,2461,5113,978,2177,4696,1376
7030,38669,19786,18883,3101,14881,1804,2509,13517,2857
7031,15181,7193,7988,1794,4019,1380,1537,4242,2209
7032,40513,20835,19678,5705,12660,2470,5074,11054,3550
7033,7700,3799,3901,1043,2001,755,877,2051,973
7034,9361,4743,4618,1252,2887,604,1012,2979,627
7035,10906,5197,5709,1306,3044,847,1226,3198,1285
7036,40890,19269,21621,5518,10572,3179,5454,11013,5154
7039,27262,13276,13986,4225,6561,2490,3825,7170,2991
7040,23847,11440,12407,3859,5987,1594,3476,6818,2113
7041,6841,3327,3514,1017,1835,475,934,1927,653
7042,26948,12338,14610,3788,7015,1535,3785,8218,2607
7043,11994,5640,6354,1815,3154,671,1903,3517,934
7044,13969,6518,7451,1816,3497,1205,1643,3894,1914
7045,10694,5122,5572,1518,2804,800,1463,3129,980
7046,4256,2102,2154,825,971,306,766,1165,223
7047,58206,27993,30213,8404,15327,4262,7613,16244,6356
7050,32868,15107,17761,5488,7802,1817,5328,9344,3089
7052,45017,20990,24027,6035,11171,3784,5904,12096,6027
7054,27538,13342,14196,3518,7815,2009,3108,8189,2899
7055,67885,33808,34077,13501,17357,2950,12471,17209,4397
7057,11583,5580,6003,1457,3234,889,1259,3433,1311
7058,5172,2527,2645,649,1574,304,776,1553,316
7059,14229,7115,7114,2419,3644,1052,2172,3858,1084
7060,49265,24494,24771,7813,14159,2522,7275,13645,3851
7062,13217,6252,6965,2142,3373,737,1923,3979,1063
7063,12001,5715,6286,2158,2926,631,2108,3300,878
7064,3696,1758,1938,522,907,329,490,997,451
7065,28291,14269,14022,3747,8545,1977,3740,7389,2893
7066,14597,7002,7595,1818,3604,1580,1617,3784,2194
7067,17993,8621,9372,2515,4412,1694,2393,4787,2192
7068,5314,2510,2804,595,1333,582,597,1381,826
7070,18110,8754,9356,2251,5044,1459,2206,5154,1996
7071,19383,9139,10244,2209,5203,1727,2244,5447,2553
7072,5917,2872,3045,693,1734,445,684,1671,690
7073,8716,4208,4508,998,2520,690,976,2637,895
7074,2754,1353,1401,361,740,252,325,774,302
7075,7643,3722,3921,966,2076,680,790,2134,997
7076,19603,9338,10265,2633,5111,1594,2777,5462,2026
7077,2781,1292,1489,372,772,148,408,795,286
7078,12888,6212,6676,2179,3010,1023,2184,3340,1152
7079,17049,8185,8864,2917,4171,1097,3038,4286,1540
7080,21799,10656,11143,3242,5752,1662,3048,5811,2284
7081,14596,6916,7680,1616,3812,1488,1561,3872,2247
7082,4508,2178,2330,630,1202,346,661,1287,382
7083,50942,24044,26898,7206,12548,4290,6887,13513,6498
7087,80589,39977,40612,12118,22769,5090,11592,22435,6585
7088,3262,1342,1920,451,678,213,439,1042,439
7090,32773,15559,17214,4948,8323,2288,4929,9101,3184
7092,6602,3154,3448,833,1455,866,708,1596,1144
7093,56461,27627,28834,7941,15639,4047,7485,15685,5664
7094,15839,7885,7954,1982,4465,1438,1619,4423,1912
7095,20704,9976,10728,2704,5932,1340,2528,5933,2267
7102,12163,6470,5693,1753,3904,813,1664,2827,1202
7103,31401,14855,16546,6753,6417,1685,5698,8158,2690
7104,51438,25047,26391,8820,13301,2926,9191,13395,3805
7105,44450,22776,21674,6306,14240,2230,6219,12317,3138
7106,33935,15704,18231,6161,7982,1561,5873,9881,2477
7107,36240,17314,18926,6741,8600,1973,6558,9667,2701
7108,25140,11001,14139,5198,4462,1341,5031,6966,2142
7109,35875,17494,18381,4979,10024,2491,4300,10322,3759
7110,27362,12837,14525,3528,7059,2250,3284,7903,3338
7111,60654,28106,32548,10190,15281,2635,10080,18354,4114
7112,26815,11976,14839,4669,5815,1492,4895,7762,2182
7114,11842,7339,4503,1789,5088,462,1394,2438,671
7201,27634,14485,13149,4681,8352,1452,4144,7220,1785
7202,36860,18022,18838,5613,10104,2305,5323,9981,3534
7203,21274,10016,11258,3362,5310,1344,3162,6049,2047
7204,13256,6364,6892,1827,3635,902,1784,3851,1257
7205,21689,10410,11279,3504,5546,1360,3183,6204,1892
7206,23393,11205,12188,4513,5608,1084,4592,6032,1564
7208,32791,15774,17017,4853,9086,1835,5085,9255,2677
7302,31861,16070,15791,3611,11068,1391,3548,9859,2384
7304,41744,19637,22107,7142,10476,2019,7229,11559,3319
7305,58533,26863,31670,9922,13606,3335,9593,16710,5367
7306,55358,28031,27327,8014,16648,3369,8093,14550,4684
7307,46118,22661,23457,7426,12811,2424,6809,13202,3446
7310,6441,3367,3074,423,2809,135,527,2417,130
7401,6676,3284,3392,1251,1525,508,986,1681,725
7403,7563,3686,3877,990,2151,545,986,2197,694
7405,16785,8376,8409,2678,4534,1164,2258,4787,1364
7407,18925,9056,9869,2495,5072,1489,2270,5306,2293
7410,31637,14987,16650,4318,7567,3102,4136,8295,4219
7416,5817,2747,3070,908,1504,335,981,1563,526
7417,10422,5132,5290,1665,2595,872,1572,2854,864
7418,2705,1395,1310,527,748,120,490,681,139
7419,7020,3410,3610,989,1966,455,990,2058,562
7420,4933,2315,2618,705,1242,368,702,1335,581
7421,7622,3882,3740,1313,2296,273,1141,2281,318
7422,7107,3558,3549,1326,1912,320,1185,2006,358
7423,4060,1913,2147,580,974,359,635,1082,430
7424,21842,10349,11493,2485,5885,1979,2398,6280,2815
7428,59,38,21,11,27,0,6,15,0
7430,24062,11542,12520,3459,6533,1550,3406,7032,2082
7432,6947,3366,3581,949,1880,537,944,1905,732
7435,2117,1160,957,363,609,188,193,548,216
7436,12466,6076,6390,1766,3388,922,1753,3416,1221
7438,11890,5867,6023,1860,3299,708,1776,3489,758
7439,2657,1352,1305,496,727,129,395,712,198
7440,4688,2238,2450,641,1157,440,631,1210,609
7442,10866,5236,5630,1488,2951,797,1461,2944,1225
7444,9200,4415,4785,1428,2373,614,1377,2535,873
7446,14374,6969,7405,2244,3739,986,2051,4159,1195
7450,24936,12017,12919,4133,6188,1696,3994,6550,2375
7452,11546,5686,5860,1934,2825,927,1726,3021,1113
7456,12396,6265,6131,2078,3498,689,1731,3660,740
7457,2498,1208,1290,358,680,170,340,729,221
7458,10942,5281,5661,1625,2587,1069,1697,2832,1132
7460,3644,1859,1785,581,1104,174,607,997,181
7461,18410,9080,9330,3169,4954,957,3125,5047,1158
7462,6894,3458,3436,1135,2026,297,1050,2045,341
7463,9622,4639,4983,1344,2569,726,1313,2668,1002
7465,5154,2435,2719,634,1518,283,740,1641,338
7470,54115,25551,28564,7710,13124,4717,7703,14347,6514
7480,15975,7985,7990,2534,4559,892,2239,4606,1145
7481,16508,7850,8658,2555,3907,1388,2547,4121,1990
7501,32857,16147,16710,6643,7930,1574,5913,8478,2319
7502,13948,6644,7304,2459,3373,812,2269,3766,1269
7503,19066,9383,9683,3341,5029,1013,3340,4930,1413
7504,12981,6171,6810,2195,3300,676,2191,3744,875
7505,4669,3242,1427,765,2302,175,426,830,171
7506,18218,8653,9565,2358,4932,1363,2154,5306,2105
7508,21951,10502,11449,3273,5522,1707,3209,5864,2376
7512,9846,4698,5148,1159,2456,1083,947,2630,1571
7513,12971,6022,6949,2315,3255,452,2639,3632,678
7514,18338,8132,10206,2996,4148,988,3241,5269,1696
7522,21448,9890,11558,4123,4927,840,4431,5953,1174
7524,12944,6502,6442,2694,3289,519,2334,3394,714
7601,42677,21202,21475,4966,13476,2760,4398,13069,4008
7603,8249,3986,4263,1332,2134,520,1072,2404,787
7604,11662,5715,5947,1623,3104,988,1402,3127,1418
7605,8914,4207,4707,1241,2234,732,1267,2559,881
7606,2187,1072,1115,271,605,196,236,580,299
7607,9523,4438,5085,1161,2543,734,1081,2700,1304
7608,16,10,6,3,4,3,3,3,0
7620,1576,794,782,228,407,159,175,425,182
7621,26264,12551,13713,3901,6807,1843,3706,7235,2772
7624,8975,4407,4568,1473,2206,728,1313,2348,907
7626,7746,3785,3961,1196,1832,757,1027,2022,912
7627,4845,2415,2430,868,1116,431,671,1277,482
7628,17486,8608,8878,2707,4367,1534,2171,4679,2028
7630,7197,3420,3777,940,1747,733,926,1803,1048
7631,26203,12324,13879,3758,6662,1904,3592,7598,2689
7632,5322,2563,2759,699,1188,676,525,1375,859
7640,4740,2322,2418,801,1153,368,673,1294,451
7641,3390,1655,1735,548,818,289,519,896,320
7642,10087,4856,5231,1490,2539,827,1439,2740,1052
7643,10800,5078,5722,1281,3122,675,1364,3349,1009
7644,23971,11360,12611,2972,6570,1818,2932,7038,2641
7645,7034,3466,3568,1046,1832,588,1001,1926,641
7646,16400,7979,8421,2246,4284,1449,1800,4509,2112
7647,4851,2409,2442,702,1244,463,553,1248,641
7648,5766,2686,3080,835,1375,476,906,1511,663
7649,8047,3848,4199,1091,2054,703,1105,2150,944
7650,17073,8375,8698,2131,5010,1234,2017,5092,1589
7652,25737,12384,13353,3542,5842,3000,3297,6206,3850
7656,8708,4091,4617,1007,2269,815,1172,2425,1020
7657,10830,5339,5491,1528,2798,1013,1221,2885,1385
7660,12873,6073,6800,1630,3522,921,1767,3814,1219
7661,10946,5245,5701,1537,2790,918,1410,2948,1343
7662,5528,2460,3068,613,1327,520,617,1459,992
7663,13155,6259,6896,1557,3400,1302,1524,3619,1753
7666,39260,18396,20864,5976,9306,3114,6033,10432,4399
7670,13806,6727,7079,2359,3165,1203,2037,3536,1506
7675,40613,19381,21232,5663,10323,3395,5514,11095,4623
7701,23114,10961,12153,2953,6009,1999,2734,5861,3558
7702,3590,1826,1764,674,920,232,507,940,317
7703,450,341,109,175,166,0,64,45,0
7704,5937,2888,3049,1104,1400,384,1014,1534,501
7711,1891,995,896,311,550,134,187,555,154
7712,39877,18752,21125,6293,9919,2540,6148,11462,3515
7716,8849,4281,4568,1165,2432,684,1052,2473,1043
7717,2237,1084,1153,254,572,258,208,576,369
7718,5977,2965,3012,807,1764,394,860,1701,451
7719,21540,10469,11071,2922,6130,1417,2743,6225,2103
7720,4793,2436,2357,596,1538,302,421,1538,398
7721,2436,1128,1308,389,657,82,368,760,180
7722,12362,6519,5843,2481,3250,788,1994,3100,749
7723,1702,804,898,260,299,245,253,353,292
7724,23149,11201,11948,3338,6494,1369,3072,6779,2097
7726,40373,19280,21093,6668,10165,2447,6878,10731,3484
7727,6105,3056,3049,1068,1617,371,906,1590,553
7728,50561,24909,25652,7590,13860,3459,6807,13644,5201
7730,18527,8886,9641,2650,4728,1508,2631,4929,2081
7731,38018,18719,19299,7029,10324,1366,6724,10786,1789
7732,5199,2620,2579,561,1667,392,579,1555,445
7733,15558,7379,8179,2506,3859,1014,2442,4241,1496
7734,13856,6689,7167,2235,3643,811,2186,3794,1187
7735,20677,10204,10473,3247,5719,1238,3108,5442,1923
7737,4445,2158,2287,661,1285,212,699,1264,324
7738,6205,3102,3103,1003,1527,572,943,1591,569
7739,6170,2942,3228,972,1400,570,868,1649,711
7740,31605,15281,16324,4807,8388,2086,4552,8755,3017
7746,17414,8696,8718,3082,4511,1103,2708,4766,1244
7747,29208,14213,14995,4110,8181,1922,3947,8406,2642
7748,29057,14266,14791,4733,7769,1764,4351,8147,2293
7750,3595,1686,1909,413,895,378,393,1017,499
7751,16941,8401,8540,3086,4470,845,2771,4867,902
7753,32372,15102,17270,4513,8069,2520,4490,8890,3890
7755,6760,3336,3424,1128,1690,518,1005,1722,697
7756,4263,1903,2360,271,1242,390,243,1238,879
7757,5549,2672,2877,870,1339,463,764,1522,591
7758,4765,2293,2472,816,1200,277,796,1271,405
7760,9592,4719,4873,1454,2514,751,1374,2616,883
7762,9289,4223,5066,1051,1915,1257,979,2181,1906
7764,8258,3927,4331,1605,1628,694,1741,1773,817
7801,24347,12475,11872,3806,7209,1460,3351,6573,1948
7803,3679,1813,1866,518,993,302,442,1023,401
7821,9004,4617,4387,1546,2605,466,1304,2656,427
7822,862,457,405,135,252,70,112,237,56
7823,7337,3642,3695,1064,1944,634,945,1946,804
7825,9376,4668,4708,1429,2489,750,1293,2587,828
7826,5775,2757,3018,829,1481,447,853,1596,569
7827,3899,1998,1901,660,1048,290,539,1046,316
7828,13007,6307,6700,2008,3815,484,2094,3920,686
7830,6546,3148,3398,903,1782,463,972,1902,524
7832,3592,1830,1762,628,975,227,488,1010,264
7833,136,60,76,11,36,13,29,38,9
7834,17163,8269,8894,2311,4612,1346,2155,4871,1868
7836,12276,6235,6041,1900,3750,585,1799,3593,649
7838,3142,1552,1590,546,849,157,522,855,213
7840,26000,12531,13469,3666,7269,1596,3627,7512,2330
7842,47,19,28,0,19,0,0,17,11
7843,12395,6333,6062,2056,3683,594,1762,3601,699
7846,54,23,31,8,13,2,12,16,3
7847,1504,726,778,265,383,78,184,460,134
7848,4385,2128,2257,624,1151,353,583,1167,507
7849,6900,3436,3464,1082,2001,353,976,1959,529
7850,6857,3324,3533,1095,1877,352,1109,2011,413
7851,268,143,125,34,71,38,33,61,31
7852,2623,1192,1431,305,687,200,245,722,464
7853,13383,6493,6890,2269,3590,634,2282,3832,776
7856,3461,1607,1854,406,972,229,367,1099,388
7857,3226,1593,1633,434,921,238,355,975,303
7860,25918,12664,13254,3882,7066,1716,3686,7028,2540
7863,3913,1937,1976,613,1011,313,514,1020,442
7865,1990,935,1055,245,549,141,358,584,113
7866,22559,11069,11490,3430,6233,1406,3144,6603,1743
7869,24295,11939,12356,3802,6837,1300,3897,6980,1479
7871,19229,9474,9755,3387,5092,995,3149,5367,1239
7874,9423,4557,4866,1346,2794,417,1426,2984,456
7876,11098,5430,5668,1879,2904,647,1760,3182,726
7878,812,401,411,143,217,41,124,239,48
7882,14541,7243,7298,2425,3918,900,2223,3917,1158
7885,10491,5108,5383,1514,2903,691,1518,3055,810
7901,22723,10919,11804,3296,5957,1666,3227,6394,2183
7920,24703,11989,12714,3732,6334,1923,3542,7008,2164
7921,7846,3597,4249,819,2332,446,747,2881,621
7922,12417,5945,6472,1830,3016,1099,1725,3246,1501
7924,7277,3598,3679,1070,1943,585,960,1966,753
7927,3176,1580,1596,487,868,225,378,921,297
7928,18037,8657,9380,2775,4535,1347,2544,5044,1792
7930,7987,3960,4027,1339,2071,550,1301,2130,596
7931,2769,1343,1426,428,672,243,421,702,303
7932,8514,4030,4484,1056,2068,906,1021,2294,1169
7933,3185,1514,1671,437,782,295,477,874,320
7934,1602,827,775,260,415,152,208,418,149
7935,529,247,282,70,114,63,88,97,97
7936,11393,5432,5961,1440,2916,1076,1563,3073,1325
7940,16558,7878,8680,2768,3960,1150,3015,4126,1539
7945,9465,4580,4885,1694,2227,659,1496,2499,890
7946,2921,1419,1502,450,728,241,445,770,287
7950,17171,8449,8722,2273,4959,1217,2034,5079,1609
7960,43619,21265,22354,5561,12343,3361,5133,12439,4782
7970,270,113,157,25,69,19,50,80,27
7974,11305,5401,5904,1695,2775,931,1649,2966,1289
7976,804,396,408,117,213,66,144,204,60
7977,751,367,384,70,238,59,99,230,55
7979,389,210,179,75,109,26,54,96,29
7980,2671,1359,1312,371,846,142,340,735,237
7981,8319,4143,4176,1141,2194,808,944,2260,972
8001,420,176,244,60,101,15,132,81,31
8002,20886,9827,11059,2874,4718,2235,2376,5181,3502
8003,30700,14964,15736,4802,7547,2615,4174,8465,3097
8004,14707,7125,7582,2151,4146,828,2230,4192,1160
8005,16755,8233,8522,2693,3946,1594,2391,4073,2058
8006,772,385,387,88,141,156,61,138,188
8007,5350,2569,2781,729,1371,469,659,1387,735
8008,7784,3711,4073,630,1650,1431,607,1714,1752
8009,11877,5977,5900,1946,3179,852,1592,3254,1054
8010,10548,5141,5407,1559,2806,776,1429,2880,1098
8011,62,34,28,16,18,0,0,28,0
8012,39398,18967,20431,5795,10669,2503,5732,11124,3575
8014,604,306,298,96,159,51,77,155,66
8015,21169,10271,10898,3558,5461,1252,3485,5955,1458
8016,30779,14538,16241,4629,7884,2025,4509,8419,3313
8019,1010,470,540,139,263,68,216,259,65
8020,2445,1162,1283,414,632,116,399,656,228
8021,45733,21969,23764,6994,12606,2369,6681,13350,3733
8022,5685,2705,2980,728,1079,898,663,1269,1048
8023,274,141,133,71,70,0,25,68,40
8026,2435,1178,1257,346,601,231,360,664,233
8027,4885,2365,2520,673,1204,488,667,1216,637
8028,20197,9748,10449,3886,4749,1113,4164,4778,1507
8029,4914,2273,2641,640,1173,460,589,1236,816
8030,13474,6455,7019,2090,3391,974,2140,3351,1528
8031,11617,5724,5893,1593,3036,1095,1418,2983,1492
8032,452,216,236,71,100,45,82,114,40
8033,16553,7914,8639,2423,3998,1493,2173,4438,2028
8034,18287,8866,9421,2365,4438,2063,2117,4696,2608
8035,7547,3543,4004,1018,1897,628,986,2048,970
8036,250,97,153,22,64,11,51,88,14
8037,22730,11602,11128,3279,6412,1911,2968,5583,2577
8038,266,133,133,35,66,32,33,78,22
8039,155,73,82,18,37,18,35,39,8
8041,880,465,415,138,256,71,131,218,66
8042,193,89,104,18,61,10,42,50,12
8043,28126,13565,14561,4310,7696,1559,3990,8223,2348
8045,2717,1236,1481,403,568,265,407,667,407
8046,33008,15659,17349,5344,7564,2751,5176,8853,3320
8048,588,286,302,67,138,81,7,140,155
8049,5265,2576,2689,822,1373,381,671,1434,584
8050,20453,9936,10517,2795,4890,2251,2517,5225,2775
8051,10154,4786,5368,1441,2693,652,1380,3013,975
8052,19079,9302,9777,2292,5525,1485,2227,5388,2162
8053,40124,19444,20680,6141,11113,2190,5963,11888,2829
8054,40221,19034,21187,5249,10417,3368,5137,11491,4559
8055,26983,13101,13882,4251,7001,1849,3851,7822,2209
8056,2380,1084,1296,263,569,252,383,605,308
8057,19224,9036,10188,2920,4416,1700,2842,4980,2366
8059,5432,2500,2932,602,1388,510,880,1425,627
8060,36896,18130,18766,6093,9944,2093,5734,10226,2806
8061,583,272,311,74,146,52,88,138,85
8062,10356,5115,5241,1900,2740,475,1710,2910,621
8063,3327,1657,1670,553,848,256,503,881,286
8064,300,232,68,108,111,13,0,47,21
8065,7091,3380,3711,909,1977,494,940,2041,730
8066,8361,4052,4309,1366,2117,569,1280,2234,795
8067,1658,840,818,239,486,115,239,445,134
8068,6475,3165,3310,1019,1677,469,873,1735,702
8069,12505,5892,6613,2060,2926,906,1998,3288,1327
8070,13030,6289,6741,1757,3344,1188,1679,3545,1517
8071,9835,4562,5273,1379,2384,799,1413,2714,1146
8072,191,90,101,19,61,10,24,46,31
8073,244,142,102,50,49,43,10,46,46
8074,77,50,27,22,28,0,0,27,0
8075,26477,13012,13465,3858,7405,1749,3876,7237,2352
8077,17354,8410,8944,2511,4017,1882,2275,4368,2301
8078,8381,4002,4379,1241,2163,598,1209,2153,1017
8079,11937,5539,6398,1934,2583,1022,1987,3096,1315
8080,36876,18075,18801,6707,9623,1745,6268,10477,2056
8081,42876,20793,22083,7992,11353,1448,7811,12358,1914
8083,9795,4754,5041,1350,2573,831,1340,2666,1035
8084,7271,3451,3820,1096,1745,610,1041,1911,868
8085,10705,5363,5342,1985,2947,431,1731,2987,624
8086,5437,2594,2843,698,1540,356,746,1591,506
8087,20124,9779,10345,2906,4819,2054,2713,5064,2568
8088,24364,11864,12500,3468,6049,2347,3304,6247,2949
8089,3877,1943,1934,613,1029,301,525,1070,339
8090,8388,4158,4230,1298,2179,681,1117,2231,882
8091,5274,2585,2689,826,1381,378,790,1397,502
8092,3142,1544,1598,518,749,277,453,795,350
8093,10163,4962,5201,1562,2770,630,1454,2947,800
8094,32534,15596,16938,4981,8390,2225,4753,9111,3074
8095,117,46,71,20,18,8,30,31,10
8096,32743,15566,17177,4812,8223,2531,4585,8505,4087
8097,3276,1599,1677,528,824,247,468,873,336
8098,8283,4088,4195,1239,2153,696,1083,2127,985
8102,10210,5747,4463,1929,3415,403,1807,1962,694
8103,15030,7281,7749,2860,3455,966,2852,3584,1313
8104,24794,11329,13465,5333,4959,1037,5452,6426,1587
8105,30833,14671,16162,6691,6809,1171,6590,8168,1404
8106,10284,4812,5472,1399,2650,763,1424,2774,1274
8107,13559,6685,6874,2177,3633,875,1841,3636,1397
8108,18449,8597,9852,2421,4667,1509,2228,5137,2487
8109,22720,10862,11858,3474,5371,2017,3166,5862,2830
8110,15920,7666,8254,2929,3879,858,2879,4343,1032
8201,34886,16735,18151,6130,8750,1855,5868,9791,2492
8202,2210,1065,1145,192,430,443,162,459,524
8203,12594,6039,6555,1536,3267,1236,1523,3483,1549
8204,18724,8954,9770,2578,4102,2274,2159,4461,3150
8210,14413,6977,7436,2169,3580,1228,2080,3667,1689
8212,238,109,129,16,27,66,5,39,85
8215,12196,5758,6438,1866,2959,933,1882,3242,1314
8217,160,77,83,11,54,12,8,25,50
8221,7195,3299,3896,954,1709,636,1044,1826,1026
8223,4432,2137,2295,666,1087,384,678,1169,448
8224,577,310,267,112,151,47,88,133,46
8225,7744,3638,4106,1080,1870,688,1122,1952,1032
8226,15378,7114,8264,1544,3564,2006,1409,3923,2932
8230,5722,2622,3100,964,1298,360,988,1457,655
8232,18017,8340,9677,3235,3991,1114,3183,4803,1691
8234,30050,14677,15373,5079,7916,1682,4582,8722,2069
8241,1032,521,511,149,311,61,146,296,69
8242,2966,1429,1537,419,699,311,420,707,410
8243,2824,1371,1453,340,550,481,270,606,577
8244,11647,5503,6144,1622,3003,878,1518,3262,1364
8245,80,26,54,17,9,0,14,32,8
8247,1192,556,636,87,231,238,84,280,272
8248,156,85,71,0,33,52,0,42,29
8251,10082,4766,5316,1515,2171,1080,1534,2436,1346
8252,852,372,480,115,112,145,103,131,246
8260,15343,7306,8037,1928,3504,1874,1937,3740,2360
8270,8308,4375,3933,1344,2530,501,1301,2113,519
8302,44505,24117,20388,7198,13870,3049,6311,9829,4248
8310,1689,894,795,160,397,337,169,278,348
8311,1905,1008,897,355,530,123,266,442,189
8312,7112,3444,3668,1256,1874,314,1251,1879,538
8313,199,88,111,16,65,7,40,64,7
8314,1951,1783,168,41,1694,48,49,90,29
8316,258,151,107,34,57,60,24,55,28
8317,1161,555,606,184,301,70,237,300,69
8318,12103,5971,6132,1989,3137,845,1789,3280,1063
8319,1252,630,622,219,305,106,200,348,74
8321,200,106,94,22,49,35,13,51,30
8322,9401,4637,4764,1664,2391,582,1608,2441,715
8323,833,391,442,95,232,64,102,246,94
8324,539,271,268,106,125,40,102,135,31
8326,1258,610,648,219,264,127,158,336,154
8327,2622,2129,493,85,1953,91,157,220,116
8328,1592,831,761,339,418,74,277,394,90
8329,99,68,31,0,51,17,0,31,0
8330,21753,10782,10971,3526,6103,1153,3210,6152,1609
8332,33846,16027,17819,5431,8432,2164,5558,9176,3085
8340,811,411,400,159,230,22,149,189,62
8341,2016,928,1088,326,466,136,319,527,242
8343,4619,2436,2183,935,1153,348,668,1141,374
8344,6041,3138,2903,844,1821,473,753,1467,683
8345,860,433,427,150,188,95,97,230,100
8346,884,388,496,139,202,47,244,203,49
8348,372,178,194,38,104,36,33,111,50
8349,2628,1230,1398,386,600,244,455,620,323
8350,926,474,452,172,254,48,99,288,65
8352,860,462,398,200,224,38,135,211,52
8353,536,271,265,97,148,26,89,140,36
8360,39757,19199,20558,6925,9436,2838,6105,10593,3860
8361,16290,7493,8797,2298,3929,1266,1976,4624,2197
8401,40517,19975,20542,6690,10256,3029,5740,10407,4395
8402,8193,3873,4320,649,1972,1252,709,1866,1745
8403,1180,574,606,115,250,209,65,275,266
8406,12910,6096,6814,1597,3285,1214,1496,3434,1884
8501,5036,2511,2525,804,1347,360,733,1460,332
8502,19536,9691,9845,3796,5106,789,3535,5531,779
8505,15163,7423,7740,2113,4244,1066,1902,4421,1417
8510,2110,1056,1054,357,551,148,367,586,101
8511,1122,566,556,203,286,77,169,287,100
8512,10186,4905,5281,1464,3058,383,1664,2967,650
8514,3106,1505,1601,482,818,205,490,869,242
8515,305,151,154,44,82,25,46,77,31
8518,4848,2407,2441,832,1253,322,663,1304,474
8520,24573,12018,12555,3428,7200,1390,3064,7595,1896
8525,5034,2545,2489,786,1316,443,625,1409,455
8527,42525,20793,21732,7372,11401,2020,6806,11821,3105
8528,112,49,63,16,29,4,10,48,5
8530,7356,3982,3374,854,2512,616,672,1946,756
8533,6703,3340,3363,1204,1836,300,1023,1950,390
8534,11426,5433,5993,1852,2818,763,1827,3237,929
8535,1908,988,920,393,522,73,321,518,81
8536,17778,8982,8796,2428,6190,364,2312,6033,451
8540,43324,21408,21916,6515,11718,3175,6494,11652,3770
8542,3525,1837,1688,432,1145,260,308,974,406
8550,17665,8822,8843,3317,4722,783,3117,4809,917
8551,5041,2531,2510,771,1419,341,673,1456,381
8553,658,326,332,60,175,91,61,201,70
8554,3684,1714,1970,516,971,227,529,1117,324
8555,928,445,483,163,227,55,167,243,73
8558,5069,2513,2556,847,1311,355,805,1414,337
8559,5312,2707,2605,718,1580,409,674,1579,352
8560,3444,1673,1771,410,928,335,515,943,313
8561,265,122,143,28,43,51,62,57,24
8562,4744,2351,2393,877,1209,265,707,1377,309
8608,1233,589,644,174,358,57,188,357,99
8609,15521,7837,7684,2993,4021,823,2644,3856,1184
8610,29725,14150,15575,4072,7602,2476,3803,8043,3729
8611,23666,11781,11885,3900,6489,1392,3441,5935,2509
8618,36916,16819,20097,6320,8308,2191,6485,10117,3495
8619,22646,10569,12077,2666,6011,1892,2564,6335,3178
8620,15705,9436,6269,2901,5634,901,1684,3340,1245
8625,1834,1774,60,32,1638,104,0,60,0
8628,9664,5159,4505,1051,3228,880,874,2366,1265
8629,10639,5191,5448,1662,2770,759,1547,2906,995
8638,26193,12243,13950,4793,5677,1773,5405,6139,2406
8640,7439,6280,1159,721,5350,209,523,617,19
8641,6873,3732,3141,1721,2011,0,1644,1491,6
8648,27883,12842,15041,4156,6711,1975,4425,7894,2722
8690,18365,8810,9555,2666,4721,1423,2588,5209,1758
8691,11157,5169,5988,1547,3077,545,1599,3547,842
8701,60387,28847,31540,11309,12579,4959,10657,12247,8636
8720,816,470,346,165,258,47,109,205,32
8721,17138,8404,8734,2637,4334,1433,2379,4578,1777
8722,10316,4996,5320,1707,2765,524,1760,2881,679
8723,31846,15279,16567,4408,7998,2873,4387,8348,3832
8724,43034,20155,22879,6231,10377,3547,5871,11457,5551
8730,4893,2353,2540,636,1159,558,625,1339,576
8731,17918,8878,9040,2598,4559,1721,2311,4566,2163
8732,1749,841,908,258,423,160,267,437,204
8733,15989,7176,8813,1210,2440,3526,1239,2403,5171
8734,7428,3564,3864,1222,1916,426,1260,2040,564
8735,4327,2009,2318,264,854,891,254,888,1176
8736,13103,6264,6839,1779,3273,1212,1792,3505,1542
8738,1325,654,671,68,356,230,89,281,301
8740,2076,987,1089,347,484,156,295,571,223
8741,2501,1256,1245,347,698,211,303,666,276
8742,26210,12746,13464,3556,6974,2216,3284,7000,3180
8750,3907,1837,2070,456,876,505,479,931,660
8751,4965,2564,2401,610,1488,466,537,1363,501
8752,2875,1370,1505,237,706,427,211,728,566
8753,63402,30783,32619,9579,16510,4694,8824,17451,6344
8755,22973,10813,12160,2960,4864,2989,2761,5273,4126
8757,33300,14303,18997,2053,3708,8542,2022,4229,12746
8758,5375,2659,2716,855,1390,414,857,1394,465
8759,17411,6662,10749,403,1281,4978,466,1543,8740
8801,8074,4537,3537,1457,2700,380,1038,2105,394
8802,3860,1934,1926,595,1123,216,635,1051,240
8804,2020,1025,995,298,578,149,260,560,175
8805,12027,6205,5822,1688,3652,865,1407,3255,1160
8807,36359,17551,18808,5526,9688,2337,4997,10292,3519
8809,6538,2604,3934,661,1605,338,685,2808,441
8810,7472,3524,3948,1341,1974,209,1391,2264,293
8812,12569,6162,6407,1787,3405,970,1712,3464,1231
8816,45560,22084,23476,7003,11968,3113,6336,13189,3951
8817,45452,22532,22920,6327,13524,2681,6172,13212,3536
8820,37549,18331,19218,5446,10205,2680,5049,10845,3324
8821,258,130,128,24,78,28,16,92,20
8822,28564,14035,14529,4614,7873,1548,4220,8223,2086
8823,7674,3396,4278,1058,2094,244,961,2840,477
8824,11867,5705,6162,2063,3026,616,2065,3354,743
8825,4633,2258,2375,681,1236,341,653,1234,488
8826,5951,2968,2983,889,1701,378,805,1753,425
8827,4446,2240,2206,841,1219,180,743,1228,235
8828,1825,896,929,241,581,74,238,593,98
8829,3799,1856,1943,622,1089,145,562,1155,226
8830,16358,8118,8240,2251,4594,1273,1931,4531,1778
8831,34377,15896,18481,3849,6264,5783,3116,6529,8836
8832,2968,1484,1484,543,854,87,461,910,113
8833,8502,4210,4292,1382,2330,498,1329,2338,625
8835,10307,4998,5309,1253,2809,936,1305,2634,1370
8836,3851,1872,1979,580,967,325,582,1035,362
8837,14652,7046,7606,1636,4071,1339,1544,4237,1825
8840,15726,7603,8123,2197,4101,1305,1968,4454,1701
8846,13717,6612,7105,1936,3629,1047,1844,3780,1481
8848,8626,4215,4411,1289,2217,709,1228,2401,782
8850,8460,4086,4374,1135,2191,760,1176,2288,910
8852,13571,6487,7084,1918,4046,523,2000,4528,556
8853,12236,6139,6097,2072,3554,513,1896,3481,720
8854,50527,24877,25650,8307,13995,2575,7725,14569,3356
8857,36014,17604,18410,5596,9815,2193,4875,10507,3028
8858,179,64,115,17,37,10,10,77,28
8859,19971,9760,10211,2873,5688,1199,2736,5682,1793
8861,49417,24382,25035,8750,13001,2631,8283,12693,4059
8863,11649,5686,5963,1497,3277,912,1447,3145,1371
8865,28931,13809,15122,4441,7003,2365,4136,7430,3556
8867,4330,2260,2070,745,1224,291,640,1143,287
8869,6404,3080,3324,840,1730,510,804,1762,758
8872,18833,9378,9455,2969,5212,1197,2464,5418,1573
8873,40844,19791,21053,5453,11692,2646,5055,12160,3838
8876,41944,20729,21215,6272,12176,2281,5742,12354,3119
8879,21962,10679,11283,3169,6023,1487,2938,6151,2194
8880,4492,2336,2156,699,1389,248,545,1262,349
8882,15322,7720,7602,2241,4421,1058,1935,4004,1663
8884,7880,3854,4026,1086,2056,712,940,2050,1036
8886,4812,2363,2449,829,1363,171,862,1390,197
8887,1004,445,559,72,311,62,80,321,158
8889,9609,4802,4807,1512,2662,628,1252,2914,641
8901,48618,23907,24711,9685,12667,1555,11358,11075,2278
8902,36851,18294,18557,5281,10811,2202,4695,10992,2870
8904,13999,6754,7245,1839,4100,815,1724,4262,1259
10001,17007,8048,8959,1144,5774,1130,1760,5288,1911
10002,84838,41801,43037,11363,23496,6942,10132,23040,9865
10003,54084,26187,27897,4394,18897,2896,5756,18583,3558
10004,1245,742,503,71,612,59,128,363,12
10005,928,519,409,33,479,7,23,379,7
10006,1503,809,694,75,716,18,56,589,49
10007,3576,2420,1156,392,1935,93,249,870,37
10009,58491,27100,31391,6046,17637,3417,5687,19441,6263
10010,26471,11883,14588,1613,8405,1865,1817,9760,3011
10011,46694,24058,22636,2292,18474,3292,2674,15817,4145
10012,26031,13140,12891,1509,9867,1764,1745,9198,1948
10013,24782,12447,12335,2769,7804,1874,2684,7084,2567
10014,32760,16812,15948,1332,13322,2158,1481,12162,2305
10016,50882,23877,27005,1891,18811,3175,2964,19905,4136
10017,16458,7529,8929,584,5845,1100,483,6803,1643
10018,4490,2525,1965,227,2062,236,314,1525,126
10019,35814,18041,17773,1672,13769,2600,1716,12705,3352
10020,0,0,0,0,0,0,0,0,0
10021,102299,44803,57496,5789,29855,9159,5835,38928,12733
10022,30481,13672,16809,1018,8845,3809,1424,10801,4584
10023,61926,28958,32968,3686,20229,5043,4210,21868,6890
10024,61174,28496,32678,4902,19131,4463,4558,22181,5939
10025,97281,45245,52036,10363,28917,5965,10650,31598,9788
10026,30760,14363,16397,5105,7967,1291,5124,8802,2471
10027,55449,26396,29053,9435,13934,3027,8488,15803,4762
10028,44881,20090,24791,3000,13587,3503,3199,17040,4552
10029,75919,35188,40731,13620,17354,4214,12437,20435,7859
10030,26239,12070,14169,4802,5811,1457,4376,7599,2194
10031,60341,29504,30837,10228,16304,2972,9224,17022,4591
10032,63513,30301,33212,10319,16722,3260,9873,17761,5578
10033,58300,28261,30039,9754,15280,3227,8781,16051,5207
10034,41753,19545,22208,6686,11028,1831,6716,12252,3240
10035,32052,16030,16022,5701,8570,1759,5001,8256,2765
10036,18774,10817,7957,1077,8269,1471,1102,5643,1212
10037,17089,6938,10151,1892,3652,1394,2323,5124,2704
10038,15547,7173,8374,1925,3865,1383,1961,4137,2276
10039,21792,9514,12278,3950,4362,1202,3774,5911,2593
10040,46772,21600,25172,7464,11723,2413,7461,13393,4318
10041,0,0,0,0,0,0,0,0,0
10044,9520,4525,4995,1223,2479,823,1387,2521,1087
10048,58,14,44,0,14,0,34,10,0
10069,1556,738,818,74,607,57,80,709,29
10103,0,0,0,0,0,0,0,0,0
10111,0,0,0,0,0,0,0,0,0
10112,0,0,0,0,0,0,0,0,0
10115,0,0,0,0,0,0,0,0,0
10119,0,0,0,0,0,0,0,0,0
10128,59875,27316,32559,4559,19134,3623,4989,22299,5271
10152,0,0,0,0,0,0,0,0,0
10153,0,0,0,0,0,0,0,0,0
10154,0,0,0,0,0,0,0,0,0
10162,1778,835,943,204,482,149,147,580,216
10165,16,11,5,0,11,0,0,5,0
10167,0,0,0,0,0,0,0,0,0
10169,0,0,0,0,0,0,0,0,0
10170,0,0,0,0,0,0,0,0,0
10171,0,0,0,0,0,0,0,0,0
10172,0,0,0,0,0,0,0,0,0
10173,0,0,0,0,0,0,0,0,0
10177,0,0,0,0,0,0,0,0,0
10271,0,0,0,0,0,0,0,0,0
10278,0,0,0,0,0,0,0,0,0
10279,0,0,0,0,0,0,0,0,0
10280,6756,3364,3392,506,2605,253,562,2531,299
10282,1420,706,714,133,573,0,113,582,19
10301,38762,18796,19966,5926,10543,2327,5719,10394,3853
10302,16234,8242,7992,3068,4134,1040,2356,4194,1442
10303,23521,11195,12326,4744,5531,920,4456,6376,1494
10304,39079,18631,20448,6878,9313,2440,6279,10661,3508
10305,38505,18676,19829,5494,10504,2678,5275,10653,3901
10306,55567,26319,29248,7568,14432,4319,7460,15521,6267
10307,11846,5878,5968,1963,3324,591,1890,3289,789
10308,26743,13011,13732,3962,7141,1908,3506,7834,2392
10309,26933,13654,13279,4216,8058,1380,4064,7460,1755
10310,22524,10664,11860,3894,5525,1245,3695,6042,2123
10312,58682,28445,30237,8978,16068,3399,8576,17337,4324
10314,85332,41344,43988,12773,22487,6084,11460,24063,8465
10451,41021,18411,22610,8145,8260,2006,7850,10958,3802
10452,71802,33485,38317,15181,16281,2023,14713,20204,3400
10453,76928,35402,41526,16711,16583,2108,16536,21358,3632
10454,35012,16485,18527,7587,7328,1570,7236,9020,2271
10455,37482,17393,20089,7681,8283,1429,7532,10086,2471
10456,76868,35129,41739,16130,16136,2863,16047,20539,5153
10457,69259,32285,36974,14583,15220,2482,13964,19132,3878
10458,77699,36460,41239,16272,17440,2748,16829,20123,4287
10459,39174,18105,21069,8428,8047,1630,8071,10243,2755
10460,53505,24685,28820,11261,11489,1935,10732,14537,3551
10461,49916,23820,26096,6069,13506,4245,5481,14149,6466
10462,72159,33683,38476,11462,17860,4361,11012,20934,6530
10463,65103,29131,35972,8568,15128,5435,8329,18490,9153
10464,4625,2245,2380,527,1271,447,477,1346,557
10465,42466,19673,22793,5799,10481,3393,5645,11570,5578
10466,68638,30677,37961,11682,15315,3680,11667,20142,6152
10467,94473,43602,50871,16452,22250,4900,15888,26834,8149
10468,78717,37324,41393,15264,18740,3320,14367,21717,5309
10469,63700,28241,35459,9203,14143,4895,10163,17332,7964
10470,15867,7380,8487,2094,4076,1210,1959,4689,1839
10471,23415,10899,12516,3031,5497,2371,2518,5975,4023
10472,64296,29228,35068,11871,14650,2707,12401,17942,4725
10473,56139,24829,31310,10414,11512,2903,10069,16030,5211
10474,11361,5511,5850,2619,2576,316,2563,2755,532
10475,38065,15988,22077,4740,7832,3416,4847,11162,6068
10501,778,371,407,133,189,49,143,222,42
10502,4893,2447,2446,788,1247,412,719,1233,494
10503,121,56,65,0,17,39,13,19,33
10504,7173,3524,3649,1228,1683,613,1186,1885,578
10506,5616,2751,2865,923,1379,449,968,1507,390
10507,7467,3224,4243,1100,1691,433,881,2853,509
10509,18846,9603,9243,3177,5383,1043,2575,5358,1310
10510,9924,4632,5292,1557,2331,744,1799,2515,978
10511,2189,1102,1087,316,605,181,279,592,216
10512,23913,11831,12082,3664,6674,1493,3365,6816,1901
10514,11920,5931,5989,2289,2921,721,1885,3332,772
10516,5199,2559,2640,699,1452,408,624,1462,554
10518,1684,812,872,311,442,59,291,497,84
10519,126,70,56,21,44,5,11,38,7
10520,12634,6001,6633,1739,3215,1047,1582,3370,1681
10522,10622,5052,5570,1766,2505,781,1500,2877,1193
10523,7259,3635,3624,1099,2068,468,909,2068,647
10524,4223,2045,2178,570,1121,354,625,1202,351
10526,1679,832,847,285,445,102,292,499,56
10527,1033,487,546,135,276,76,147,323,76
10528,12309,5978,6331,1757,3155,1066,1621,3351,1359
10530,12694,5912,6782,1294,3427,1191,1320,3715,1747
10532,6615,3271,3344,899,1696,676,678,1443,1223
10533,7479,3604,3875,1183,1886,535,1050,2140,685
10535,387,220,167,78,114,28,49,109,9
10536,10625,5204,5421,1831,2662,711,1648,2862,911
10537,1932,955,977,299,533,123,223,598,156
10538,16944,8037,8907,2647,4080,1310,2404,4961,1542
10541,26833,13195,13638,4338,7299,1558,4318,7431,1889
10543,19269,9173,10096,2459,5073,1641,2561,5185,2350
10546,1201,595,606,179,367,49,197,344,65
10547,8544,4352,4192,1548,2373,431,1216,2365,611
10548,4073,2099,1974,531,1207,361,541,1016,417
10549,15591,7758,7833,2603,4103,1052,2124,4312,1397
10550,38185,17168,21017,6248,8851,2069,6253,11159,3605
10552,19988,9045,10943,2082,5271,1692,2052,5987,2904
10553,10182,4666,5516,1808,2258,600,1726,2803,987
10560,4930,2341,2589,669,1241,431,705,1316,568
10562,31136,16116,15020,3879,10076,2161,3731,8297,2992
10566,22441,10751,11690,3188,6316,1247,3204,6485,2001
10567,17672,8649,9023,2958,4609,1082,2789,4845,1389
10570,12320,6016,6304,2075,3146,795,2011,3230,1063
10573,36294,18141,18153,5392,10323,2426,4611,9875,3667
10576,4626,2270,2356,661,1183,426,654,1287,415
10577,3489,1523,1966,716,575,232,1033,705,228
10578,632,304,328,84,181,39,76,172,80
10579,8046,3957,4089,1224,2263,470,1234,2331,524
10580,16707,7915,8792,2643,3963,1309,2516,4498,1778
10583,38705,18326,20379,6077,8888,3361,5928,10262,4189
10588,2127,1042,1085,349,558,135,322,637,126
10589,7329,3270,4059,700,1400,1170,666,1717,1676
10590,7201,3534,3667,1161,1895,478,1215,2048,404
10591,21671,10369,11302,2884,6086,1399,2908,6307,2087
10594,5427,2685,2742,950,1272,463,901,1356,485
10595,6521,3385,3136,1017,1913,455,845,1728,563
10597,325,127,198,37,73,17,61,117,20
10598,29418,14062,15356,4424,7372,2266,4421,7907,3028
10601,8961,4075,4886,1085,2478,512,1024,2783,1079
10603,16386,7600,8786,2125,4281,1194,1932,4749,2105
10604,10424,4986,5438,1400,2766,820,1391,2925,1122
10605,17451,8141,9310,2114,4413,1614,2188,4947,2175
10606,15792,7674,8118,2204,4485,985,2047,4430,1641
10607,7576,3620,3956,869,2097,654,897,2229,830
10701,63310,29552,33758,10794,14956,3802,10591,17395,5772
10703,20465,9396,11069,2969,4747,1680,3042,5311,2716
10704,29189,13969,15220,3346,7708,2915,3104,8135,3981
10705,38483,18373,20110,6949,9222,2202,6606,10386,3118
10706,9215,4345,4870,1223,2329,793,1193,2551,1126
10707,9349,4500,4849,1251,2412,837,1166,2654,1029
10708,22442,10045,12397,2548,5489,2008,2755,6498,3144
10709,8994,4246,4748,1210,2171,865,1041,2460,1247
10710,25341,11874,13467,3049,6079,2746,2928,6708,3831
10801,36284,17436,18848,5818,9314,2304,5243,9513,4092
10803,12097,5842,6255,2059,2979,804,1756,3347,1152
10804,14192,6853,7339,2121,3258,1474,2061,3639,1639
10805,17992,8064,9928,1873,4728,1463,2266,5140,2522
10901,21545,10237,11308,3028,5570,1639,3111,5871,2326
10913,5040,2491,2549,842,1252,397,845,1170,534
10916,4015,1936,2079,636,1026,274,656,1088,335
10917,1653,842,811,243,484,115,271,442,98
10918,11609,6093,5516,1758,3781,554,1714,3108,694
10919,527,214,313,78,121,15,107,165,41
10920,8994,4433,4561,1410,2447,576,1183,2603,775
10921,3982,1907,2075,610,1071,226,674,1079,322
10923,9137,4361,4776,1403,2413,545,1450,2696,630
10924,12341,6044,6297,1990,3068,986,1660,2994,1643
10925,4853,2452,2401,717,1402,333,708,1336,357
10926,3358,1674,1684,619,913,142,555,954,175
10927,10027,4890,5137,1853,2495,542,1649,2607,881
10928,5353,2616,2737,802,1422,392,683,1512,542
10930,7524,3691,3833,1372,1990,329,1236,2139,458
10931,784,372,412,147,180,45,139,196,77
10940,43033,20873,22160,7177,11112,2584,7102,11249,3809
10941,13133,6514,6619,2145,3600,769,1880,3762,977
10950,38766,19947,18819,9832,8565,1550,8075,8930,1814
10952,32449,16270,16179,8086,6372,1812,7498,6522,2159
10954,22897,11001,11896,3545,5923,1533,2987,6706,2203
10956,31140,15365,15775,4718,8238,2409,4240,8661,2874
10958,3081,1664,1417,495,1029,140,485,743,189
10960,14538,6939,7599,2040,3860,1039,1762,4363,1474
10962,5793,2908,2885,704,1544,660,682,1458,745
10963,4622,3275,1347,481,2603,191,419,733,195
10964,1288,655,633,203,303,149,105,356,172
10965,14470,6995,7475,1972,3722,1301,1975,3828,1672
10968,2413,1197,1216,296,732,169,286,742,188
10969,987,486,501,153,249,84,163,249,89
10970,9424,4463,4961,1398,2523,542,1198,3031,732
10973,1685,840,845,245,460,135,229,453,163
10974,3146,1558,1588,509,873,176,423,881,284
10975,251,129,122,22,102,5,23,85,14
10976,1737,704,1033,319,282,103,280,348,405
10977,49001,24234,24767,10059,11548,2627,9071,12236,3460
10980,12624,6310,6314,1979,3292,1039,1750,3461,1103
10983,5788,2740,3048,769,1434,537,916,1378,754
10984,2381,1223,1158,331,773,119,297,749,112
10985,62,33,29,22,11,0,12,17,0
10986,1771,800,971,211,483,106,306,513,152
10987,3204,1613,1591,427,912,274,360,931,300
10989,9419,4470,4949,1204,2489,777,1142,2706,1101
10990,19212,9651,9561,3177,5289,1185,2749,5065,1747
10992,9033,4467,4566,1663,2369,435,1453,2482,631
10993,4210,2020,2190,651,1060,309,555,1000,635
10994,6737,3262,3475,936,1743,583,964,1864,647
10996,7115,4765,2350,3040,1716,9,1300,1038,12
10998,3580,1750,1830,597,981,172,600,998,232
11001,25545,12205,13340,3586,6504,2115,3441,7015,2884
11003,40610,19295,21315,6444,10235,2616,6200,11232,3883
11004,14760,6956,7804,1848,3838,1270,1698,4115,1991
11005,2234,787,1447,9,152,626,33,197,1217
11010,24856,11840,13016,3343,6168,2329,3068,6497,3451
11020,3961,1906,2055,574,826,506,542,965,548
11021,19816,9116,10700,2387,4813,1916,2248,5521,2931
11023,8355,4164,4191,1359,1730,1075,1032,2054,1105
11024,7683,4099,3584,1569,1899,631,1152,1814,618
11030,16963,8174,8789,2467,3800,1907,2224,4255,2310
11040,39024,18635,20389,5337,9241,4057,5123,9871,5395
11042,514,134,380,0,9,125,0,19,361
11050,28551,13756,14795,3947,7379,2430,3870,7814,3111
11096,7801,3606,4195,1263,1833,510,1255,2034,906
11101,25619,12920,12699,3973,7796,1151,3576,7237,1886
11102,36194,17926,18268,4984,11210,1732,4669,10601,2998
11103,43724,22110,21614,5104,14601,2405,4711,13165,3738
11104,29479,14706,14773,3406,9546,1754,2946,8964,2863
11105,41999,20777,21222,4822,12437,3518,4438,12161,4623
11106,43280,21497,21783,5496,13254,2747,5026,12355,4402
11201,47482,23957,23525,4536,16411,3010,4034,15444,4047
11203,84008,37072,46936,13216,19031,4825,13387,25457,8092
11204,74793,36487,38306,12416,17895,6176,10761,19003,8542
11205,35226,15929,19297,6399,8143,1387,6063,10705,2529
11206,69385,32046,37339,13915,14990,3141,13357,18463,5519
11207,86194,38483,47711,17383,17634,3466,17506,24450,5755
11208,87613,41280,46333,17875,19916,3489,17101,24002,5230
11209,70346,33731,36615,7915,20059,5757,7571,20414,8630
11210,62008,28629,33379,11289,14220,3120,11207,17449,4723
11211,84913,41621,43292,17705,20143,3773,16523,20807,5962
11212,85232,37373,47859,17716,16181,3476,17078,24601,6180
11213,65320,28933,36387,12524,13336,3073,11806,18921,5660
11214,83188,39825,43363,10996,21244,7585,9587,22312,11464
11215,62828,29954,32874,7321,19914,2719,6713,21976,4185
11216,56635,25489,31146,9214,13376,2899,9647,16511,4988
11217,35466,16770,18696,3518,11677,1575,3907,12469,2320
11218,74773,36727,38046,12841,19585,4301,11671,19655,6720
11219,86812,43242,43570,17649,19630,5963,16455,18663,8452
11220,92891,45962,46929,16184,24935,4843,14988,25228,6713
11221,75309,34815,40494,14958,16554,3303,14534,20464,5496
11222,39381,19879,19502,4715,12645,2519,4332,11416,3754
11223,78053,37612,40441,11993,19097,6522,10912,19860,9669
11224,51308,22996,28312,7688,10185,5123,7638,12543,8131
11225,63828,27909,35919,10567,14149,3193,10781,19748,5390
11226,106415,47721,58694,19089,24720,3912,18769,32786,7139
11228,40443,19065,21378,4850,10418,3797,4653,10837,5888
11229,79796,37374,42422,11040,19182,7152,10167,21373,10882
11230,89041,43460,45581,15146,21283,7031,13908,20831,10842
11231,32927,15101,17826,4099,9354,1648,4064,11144,2618
11232,27573,14733,12840,4820,8744,1169,4154,7198,1488
11233,62568,26794,35774,11934,12170,2690,12548,18148,5078
11234,87386,40486,46900,12635,21461,6390,12771,25204,8925
11235,77445,36991,40454,8984,19729,8278,7765,19703,12986
11236,96359,42628,53731,16329,21301,4998,16542,29350,7839
11237,48642,23847,24795,10184,12157,1506,9571,13075,2149
11238,49118,22323,26795,6044,13941,2338,6417,16256,4122
11239,14621,6083,8538,2197,2459,1427,2108,3938,2492
11354,54524,25598,28926,6747,14499,4352,5888,15561,7477
11355,83341,40386,42955,10572,24123,5691,10287,24409,8259
11356,20269,9823,10446,2932,5603,1288,2910,5726,1810
11357,39571,18802,20769,4376,9935,4491,4260,10505,6004
11358,38161,18356,19805,5095,10353,2908,4633,11155,4017
11360,19248,8961,10287,1764,4777,2420,1566,5493,3228
11361,29383,14155,15228,3843,7976,2336,3202,8585,3441
11362,17505,8131,9374,1987,4334,1810,1894,4834,2646
11363,6867,3294,3573,849,1802,643,772,2014,787
11364,34575,16324,18251,4188,8940,3196,3954,9763,4534
11365,41879,19612,22267,5630,10412,3570,5685,11717,4865
11366,13473,6420,7053,1794,3424,1202,1768,3713,1572
11367,38225,18120,20105,5560,9575,2985,5390,10678,4037
11368,98609,50406,48203,17526,28769,4111,16029,26393,5781
11369,36067,17051,19016,6103,8777,2171,5576,10026,3414
11370,42443,25822,16621,6331,17401,2090,4021,9776,2824
11371,0,0,0,0,0,0,0,0,0
11372,71332,35968,35364,9891,21878,4199,8844,19691,6829
11373,106107,54238,51869,15249,33120,5869,13728,29983,8158
11374,43420,20245,23175,4514,11725,4006,4443,12501,6231
11375,70673,32632,38041,6870,19400,6362,6051,21492,10498
11377,88512,44182,44330,11593,27322,5267,10890,25758,7682
11378,33909,16102,17807,4181,9260,2661,4364,9457,3986
11379,28982,13336,15646,3138,7391,2807,3247,7964,4435
11385,97682,47002,50680,15175,26253,5574,14800,27223,8657
11411,21404,9579,11825,3038,4883,1658,3153,6228,2444
11412,37759,16888,20871,5897,8243,2748,5931,10555,4385
11413,40553,18739,21814,6598,9385,2756,5912,12018,3884
11414,28098,13154,14944,3175,6786,3193,2872,7688,4384
11415,21106,10444,10662,2688,6415,1341,2336,6448,1878
11416,23956,11486,12470,4111,6221,1154,3942,6875,1653
11417,28222,13806,14416,4470,7596,1740,4035,8072,2309
11418,36826,18187,18639,6066,10315,1806,5653,10283,2703
11419,48876,24108,24768,8365,13561,2182,7951,14022,2795
11420,45790,21872,23918,7536,11832,2504,7677,13013,3228
11421,37615,18310,19305,6138,10048,2124,5596,10596,3113
11422,30300,13567,16733,4759,7377,1431,5169,9420,2144
11423,31153,14647,16506,4914,7646,2087,4572,8784,3150
11426,18731,9113,9618,2480,5232,1401,2517,5105,1996
11427,23186,10821,12365,3316,5770,1735,3286,6558,2521
11428,21064,10126,10938,3308,5785,1033,3491,5945,1502
11429,27253,12030,15223,4235,6132,1663,4597,8205,2421
11430,254,71,183,50,21,0,92,91,0
11432,56551,27226,29325,8370,15535,3321,8094,16131,5100
11433,28628,12772,15856,5182,5956,1634,5318,7672,2866
11434,59350,25930,33420,9791,12741,3398,9816,17619,5985
11435,54164,26122,28042,8391,14921,2810,8104,15627,4311
11436,17856,8044,9812,3135,3899,1010,3046,4943,1823
11501,19164,9046,10118,2220,5200,1626,2333,5520,2265
11507,7858,3777,4081,1094,1897,786,1138,1962,981
11509,2802,1359,1443,356,662,341,306,713,424
11510,32305,15415,16890,5000,8175,2240,4531,9235,3124
11514,5126,2442,2684,691,1362,389,661,1490,533
11516,7017,3362,3655,1016,1753,593,956,1875,824
11518,11005,5255,5750,1536,2832,887,1416,3184,1150
11520,44067,20798,23269,6963,11495,2340,7055,12605,3609
11530,26425,12644,13781,4166,6012,2466,3863,6711,3207
11542,27715,13366,14349,3858,7081,2427,3235,7329,3785
11545,12061,5823,6238,1879,2884,1060,1759,3150,1329
11547,692,293,399,32,197,64,139,186,74
11548,2495,1103,1392,583,427,93,752,509,131
11550,59048,28103,30945,11056,14435,2612,10669,16047,4229
11552,23269,11276,11993,3694,5612,1970,3312,6112,2569
11553,23496,11095,12401,3873,5805,1417,3609,6512,2280
11554,37501,18703,18798,5610,10071,3022,4861,9560,4377
11557,7746,3659,4087,1040,1830,789,1078,2056,953
11558,8553,4127,4426,1069,2333,725,1062,2428,936
11559,8290,4018,4272,1533,1819,666,1481,1900,891
11560,6915,3414,3501,952,1903,559,918,1826,757
11561,39594,18931,20663,4524,11122,3285,4118,11450,5095
11563,23371,11074,12297,3081,5908,2085,2909,6206,3182
11565,9321,4543,4778,1382,2371,790,1179,2595,1004
11566,35573,17244,18329,5521,8915,2808,5174,9616,3539
11568,3921,1779,2142,695,749,335,841,927,374
11569,1610,885,725,168,511,206,111,388,226
11570,27714,13028,14686,4187,6841,2000,3851,7557,3278
11572,31260,15017,16243,4575,7624,2818,4272,8327,3644
11575,15930,7509,8421,2866,3770,873,2876,4487,1058
11576,11950,5840,6110,1677,2897,1266,1597,3112,1401
11577,12050,5710,6340,1713,2901,1096,1723,3127,1490
11579,5138,2521,2617,635,1455,431,691,1372,554
11580,37632,17680,19952,5404,9218,3058,5543,9982,4427
11581,20116,9664,10452,2949,4819,1896,2774,5224,2454
11590,42576,20882,21694,6707,11254,2921,6291,11499,3904
11596,10620,5073,5547,1505,2671,897,1447,2848,1252
11598,13427,6676,6751,2378,3016,1282,2096,3191,1464
11691,56020,25468,30552,10309,11385,3774,10289,14231,6032
11692,15918,7385,8533,3156,3500,729,2816,4361,1356
11693,11369,5284,6085,2040,2564,680,1948,3197,940
11694,19067,9170,9897,2383,4799,1988,2063,4986,2848
11697,4337,2055,2282,582,950,523,459,1130,693
11701,26411,11871,14540,3756,6459,1656,4185,7249,3106
11702,14897,7332,7565,2139,4100,1093,2012,4232,1321
11703,16270,7775,8495,2196,4341,1238,2136,4578,1781
11704,40136,19123,21013,5990,10462,2671,5993,10978,4042
11705,7948,3832,4116,1250,2160,422,1179,2427,510
11706,60237,29658,30579,10178,15785,3695,9170,16402,5007
11709,7110,3478,3632,965,1881,632,969,1973,690
11710,34397,16845,17552,5143,9020,2682,4599,9416,3537
11713,9099,4398,4701,1663,2187,548,1633,2360,708
11714,22962,10939,12023,3061,5733,2145,2843,6098,3082
11715,4407,2197,2210,684,1214,299,632,1174,404
11716,10352,5183,5169,1448,2918,817,1310,2846,1013
11717,51512,26166,25346,9821,13803,2542,8761,13240,3345
11718,3099,1508,1591,467,857,184,503,830,258
11719,2950,1409,1541,317,820,272,341,784,416
11720,28051,13915,14136,4649,7648,1618,4356,7682,2098
11721,6244,3023,3221,871,1691,461,916,1742,563
11722,34551,17126,17425,6546,9024,1556,5960,9299,2166
11724,3034,1448,1586,496,732,220,487,851,248
11725,29417,14210,15207,4478,7262,2470,4246,7772,3189
11726,17703,8735,8968,2813,4815,1107,2412,5005,1551
11727,25446,12533,12913,3802,7313,1418,3549,7444,1920
11729,28174,13499,14675,4095,7044,2360,3981,7604,3090
11730,16029,7878,8151,2729,4069,1080,2494,4198,1459
11731,30886,15117,15769,4443,8125,2549,4244,8524,3001
11732,3737,1786,1951,445,875,466,415,1044,492
11733,20435,10232,10203,3733,5016,1483,3807,5237,1159
11735,32084,16068,16016,4999,8616,2453,4116,8389,3511
11738,16872,8549,8323,2946,4922,681,2707,4762,854
11740,9849,4631,5218,1527,2331,773,1343,2483,1392
11741,27858,13491,14367,4310,7859,1322,4291,8437,1639
11742,11956,5693,6263,1794,3323,576,1917,3674,672
11743,41155,20188,20967,5728,11223,3237,5333,11566,4068
11746,63057,31560,31497,10010,17093,4457,8911,17238,5348
11747,16272,7866,8406,2365,4195,1306,2308,4511,1587
11751,15151,7478,7673,2451,4075,952,2211,4286,1176
11752,9813,4884,4929,1691,2487,706,1506,2676,747
11753,11514,5529,5985,1568,2732,1229,1664,3048,1273
11754,18889,9177,9712,2776,5046,1355,2723,5146,1843
11755,11655,5696,5959,1842,3236,618,1698,3424,837
11756,43988,21446,22542,6813,11683,2950,6341,12312,3889
11757,46445,22695,23750,7062,12680,2953,6823,12838,4089
11758,55318,26850,28468,8077,14307,4466,7602,14840,6026
11762,24355,11702,12653,3617,5855,2230,3307,6446,2900
11763,24784,12264,12520,4288,6716,1260,3944,7006,1570
11764,11215,5576,5639,1997,3104,475,1871,3097,671
11765,661,331,330,90,172,69,80,161,89
11766,9205,4532,4673,1550,2529,453,1512,2538,623
11767,13787,6851,6936,2123,3900,828,2078,3972,886
11768,21917,10805,11112,3032,5761,2012,2899,6160,2053
11769,9754,4674,5080,1332,2539,803,1239,2756,1085
11770,189,102,87,28,58,16,24,61,2
11771,9574,4635,4939,1367,2537,731,1270,2653,1016
11772,42084,20400,21684,6147,11585,2668,5905,11444,4335
11776,22474,11128,11346,3435,6314,1379,3042,6459,1845
11777,8972,4431,4541,1172,2470,789,1003,2527,1011
11778,11550,5715,5835,2013,3110,592,1886,3201,748
11779,39362,19099,20263,5997,10897,2205,5505,11593,3165
11780,14800,7077,7723,2283,3519,1275,1986,3773,1964
11782,15768,7552,8216,2493,4070,989,2334,4335,1547
11783,22071,10592,11479,3141,5735,1716,3257,5920,2302
11784,26430,12772,13658,4513,6989,1270,4340,7503,1815
11786,5877,2897,2980,967,1509,421,888,1659,433
11787,34908,16913,17995,5090,8895,2928,4601,9142,4252
11788,16870,8337,8533,2407,4631,1299,2240,4736,1557
11789,7573,3723,3850,1290,2128,305,1204,2176,470
11790,18558,9146,9412,3719,4306,1121,3758,4349,1305
11791,24528,12036,12492,3897,6076,2063,3422,6439,2631
11792,7149,3567,3582,1169,1973,425,1128,1999,455
11793,32793,15651,17142,4844,8184,2623,4764,8799,3579
11795,27162,13281,13881,4376,7035,1870,4190,7164,2527
11796,3953,1877,2076,640,1037,200,613,1079,384
11797,9002,4194,4808,1285,2084,825,1132,2264,1412
11798,15240,7249,7991,2977,3573,699,2996,4079,916
11801,39448,19522,19926,5472,10648,3402,4959,10454,4513
11803,27890,13589,14301,4141,6859,2589,3700,7169,3432
11804,4972,2323,2649,667,1172,484,723,1269,657
11901,22823,11217,11606,3164,5935,2118,2870,5516,3220
11930,1160,594,566,134,312,148,81,278,207
11932,1406,697,709,145,298,254,122,359,228
11933,5803,2877,2926,868,1412,597,703,1430,793
11934,6521,3185,3336,914,1799,472,938,1784,614
11935,3386,1654,1732,452,812,390,395,854,483
11937,13275,6567,6708,1840,3477,1250,1588,3566,1554
11939,772,374,398,98,136,140,81,159,158
11940,4329,2172,2157,705,1140,327,638,1165,354
11941,2305,1172,1133,369,637,166,314,644,175
11942,3994,1947,2047,554,1121,272,547,1127,373
11944,3687,1683,2004,463,820,400,466,880,658
11946,12733,6371,6362,1691,3477,1203,1475,3392,1495
11947,290,84,206,4,71,9,117,77,12
11948,900,461,439,153,214,94,103,228,108
11949,11472,5688,5784,1815,3026,847,1621,3100,1063
11950,14677,7013,7664,2767,3758,488,2833,4155,676
11951,12834,6422,6412,2326,3564,532,2320,3368,724
11952,4706,2247,2459,636,1126,485,662,1173,624
11953,12313,5810,6503,1757,3217,836,1701,3630,1172
11954,3851,1983,1868,474,1159,350,429,1044,395
11955,2653,1333,1320,233,753,347,159,733,428
11956,304,136,168,15,74,47,23,78,67
11957,679,337,342,67,118,152,60,145,137
11958,532,261,271,83,101,77,91,116,64
11959,997,509,488,125,227,157,83,275,130
11960,780,387,393,89,202,96,95,210,88
11961,12536,5738,6798,1849,2457,1432,1645,2617,2536
11962,386,182,204,30,81,71,41,103,60
11963,6711,3291,3420,805,1728,758,766,1674,980
11964,1151,576,575,98,287,191,112,268,195
11965,1077,493,584,111,216,166,116,262,206
11967,24879,12367,12512,4746,6675,946,4424,6860,1228
11968,12048,5888,6160,1670,3037,1181,1671,2980,1509
11970,270,132,138,49,67,16,11,107,20
11971,5585,2651,2934,665,1139,847,640,1352,942
11972,745,361,384,90,219,52,107,214,63
11975,412,218,194,47,110,61,39,93,62
11976,1872,956,916,172,544,240,215,502,199
11977,2075,992,1083,265,557,170,275,582,226
11978,3814,1845,1969,534,940,371,454,957,558
11980,4331,2307,2024,583,1429,295,477,1162,385
12008,554,283,271,116,148,19,83,155,33
12009,7634,3670,3964,1100,1996,574,1041,2122,801
12010,28487,13391,15096,4062,6649,2680,3734,7031,4331
12015,2832,1370,1462,383,734,253,392,742,328
12017,296,138,158,41,72,25,35,88,35
12018,7896,3907,3989,1285,2166,456,1234,2283,472
12019,13295,6759,6536,2040,3671,1048,1768,3703,1065
12020,28097,13740,14357,4320,7808,1612,4283,8018,2056
12022,763,381,382,134,173,74,106,188,88
12023,2146,1037,1109,311,577,149,325,565,219
12025,5628,2780,2848,881,1391,508,830,1381,637
12027,3674,1848,1826,588,943,317,527,930,369
12028,986,497,489,161,253,83,152,274,63
12029,1406,846,560,449,277,120,137,299,124
12031,137,68,69,15,41,12,22,41,6
12032,805,396,409,74,206,116,98,217,94
12033,8057,3899,4158,1244,2120,535,1188,2147,823
12035,1260,602,658,202,317,83,188,377,93
12036,222,120,102,36,59,25,17,58,27
12037,4118,1981,2137,592,1053,336,576,1098,463
12041,30,20,10,0,20,0,3,7,0
12042,730,356,374,95,206,55,118,172,84
12043,8277,4012,4265,1751,1683,578,1579,1815,871
12045,797,374,423,152,169,53,129,232,62
12046,855,451,404,139,245,67,135,207,62
12047,18261,8592,9669,2603,4606,1383,2461,4830,2378
12051,7019,4881,2138,2230,2385,266,604,1065,469
12052,988,473,515,141,270,62,163,292,60
12053,4566,2279,2287,690,1257,332,730,1291,266
12054,16336,7734,8602,2457,3977,1300,2179,4516,1907
12056,2285,1179,1106,346,684,149,289,652,165
12057,1822,916,906,308,466,142,303,419,184
12058,1414,708,706,191,372,145,196,393,117
12059,1772,900,872,281,484,135,293,460,119
12060,1312,659,653,186,356,117,149,360,144
12061,7794,3661,4133,1003,2112,546,1088,2210,835
12062,1713,842,871,263,464,115,270,485,116
12063,178,79,99,30,30,19,38,38,23
12064,430,214,216,36,115,63,46,115,55
12065,39002,19171,19831,5836,10993,2342,5293,11581,2957
12066,1895,926,969,280,499,147,299,478,192
12067,1910,990,920,347,502,141,249,506,165
12068,3942,1928,2014,609,1016,303,588,1002,424
12070,1444,727,717,215,432,80,209,377,131
12071,288,129,159,30,62,37,45,83,31
12072,2495,1266,1229,366,730,170,372,630,227
12074,3078,1502,1576,402,893,207,452,868,256
12075,3017,1518,1499,425,793,300,330,761,408
12076,1251,624,627,165,292,167,165,312,150
12077,5707,2747,2960,1006,1399,342,1020,1487,453
12078,23810,11562,12248,3613,5669,2280,3113,6028,3107
12083,3136,1429,1707,420,708,301,520,835,352
12084,4265,2029,2236,396,1240,393,394,1275,567
12086,1614,832,782,285,408,139,193,419,170
12087,652,371,281,141,174,56,99,143,39
12090,6268,3030,3238,873,1599,558,1005,1545,688
12092,924,441,483,84,212,145,165,217,101
12093,1386,686,700,176,352,158,181,366,153
12094,2234,1126,1108,395,627,104,379,606,123
12095,13004,6606,6398,2096,3564,946,1781,2970,1647
12106,2297,1069,1228,266,621,182,324,623,281
12108,424,223,201,46,117,60,41,96,64
12110,20736,9948,10788,3345,5092,1511,3417,5212,2159
12115,223,121,102,45,63,13,21,67,14
12116,1762,851,911,197,471,183,209,524,178
12117,3224,1611,1613,497,794,320,443,821,349
12118,11796,5744,6052,1768,3089,887,1597,3153,1302
12120,571,287,284,98,140,49,76,147,61
12121,1932,940,992,312,480,148,276,550,166
12122,4399,2154,2245,624,1123,407,625,1124,496
12123,5278,2678,2600,845,1398,435,708,1413,479
12125,1572,762,810,250,366,146,254,415,141
12130,874,454,420,117,254,83,94,259,67
12131,221,103,118,20,55,28,23,68,27
12134,2707,1344,1363,404,687,253,389,713,261
12136,903,458,445,130,227,101,98,242,105
12137,1323,679,644,204,386,89,184,348,112
12138,3775,1969,1806,628,1053,288,567,933,306
12139,312,156,156,54,76,26,38,91,27
12140,1307,566,741,140,310,116,237,341,163
12143,5550,2712,2838,956,1410,346,746,1570,522
12144,18538,8970,9568,2771,4827,1372,2502,5216,1850
12147,493,253,240,78,123,52,43,131,66
12148,2787,1354,1433,393,666,295,355,723,355
12149,1902,1007,895,320,533,154,205,489,201
12150,971,506,465,206,249,51,109,278,78
12151,719,334,385,120,187,27,132,188,65
12153,833,437,396,100,290,47,107,256,33
12154,2623,1300,1323,418,695,187,393,730,200
12155,1725,876,849,257,453,166,247,450,152
12156,870,428,442,128,214,86,134,201,107
12157,3923,1932,1991,599,1023,310,560,1023,408
12158,5604,2842,2762,1025,1407,410,808,1525,429
12159,7827,3679,4148,1179,1938,562,1130,2243,775
12160,1106,582,524,180,327,75,138,306,80
12164,453,238,215,56,113,69,48,106,61
12165,229,109,120,26,53,30,32,58,30
12166,1505,771,734,227,414,130,219,390,125
12167,2540,1212,1328,339,548,325,356,580,392
12168,2113,1050,1063,307,579,164,308,588,167
12169,154,67,87,18,45,4,18,57,12
12170,5126,2520,2606,811,1409,300,798,1481,327
12173,2340,1172,1168,360,648,164,330,638,200
12175,1018,614,404,140,406,68,123,211,70
12176,145,59,86,15,34,10,21,38,27
12180,53009,26275,26734,9471,13147,3657,8006,13150,5578
12182,13898,6657,7241,2033,3434,1190,1833,3665,1743
12183,2278,1097,1181,320,597,180,268,657,256
12184,7261,3492,3769,1055,1797,640,1007,1954,808
12185,2072,1024,1048,329,552,143,353,532,163
12186,6573,3156,3417,970,1675,511,957,1892,568
12187,675,313,362,110,135,68,115,176,71
12188,10603,5092,5511,1469,2868,755,1494,3009,1008
12189,16338,7623,8715,2239,4213,1171,2135,4578,2002
12190,734,373,361,100,180,93,65,192,104
12192,2088,1016,1072,228,577,211,232,633,207
12193,2128,1092,1036,283,581,228,258,554,224
12194,226,115,111,29,54,32,37,56,18
12196,2783,1348,1435,438,704,206,390,797,248
12197,2429,1184,1245,370,598,216,347,600,298
12198,7035,3320,3715,910,1856,554,1012,1887,816
12202,10063,4628,5435,1649,2471,508,1754,3025,656
12203,33101,15669,17432,6119,7516,2034,6318,7558,3556
12204,6929,3268,3661,834,1823,611,764,1868,1029
12205,26296,12727,13569,3469,6756,2502,3149,6883,3537
12206,15966,7399,8567,2796,3737,866,2783,4387,1397
12207,2082,1050,1032,244,643,163,368,391,273
12208,21098,10010,11088,2601,5998,1411,2535,5945,2608
12209,9846,4560,5286,1453,2433,674,1344,2751,1191
12210,9476,4820,4656,1361,3022,437,1262,2907,487
12211,10819,5283,5536,1495,2464,1324,1431,2679,1426
12302,26785,12686,14099,3648,6382,2656,3438,6740,3921
12303,27872,13296,14576,4193,6822,2281,3928,7393,3255
12304,20943,9986,10957,3229,5062,1695,3041,5384,2532
12305,5956,3386,2570,1207,1823,356,985,1148,437
12306,24549,11908,12641,3319,6272,2317,3276,6304,3061
12307,6795,3097,3698,1367,1437,293,1489,1754,455
12308,13519,6317,7202,2088,3308,921,2115,3639,1448
12309,29955,14538,15417,4297,7454,2787,3702,7675,4040
12401,35679,17126,18553,5147,8916,3063,4687,9464,4402
12404,4136,2214,1922,837,1113,264,535,1081,306
12405,545,260,285,101,123,36,108,141,36
12406,959,446,513,132,167,147,111,268,134
12407,457,238,219,71,121,46,56,102,61
12409,560,266,294,50,148,68,36,178,80
12410,926,462,464,120,229,113,120,240,104
12411,316,132,184,25,63,44,47,94,43
12412,982,498,484,206,238,54,131,279,74
12413,2620,1287,1333,410,539,338,378,634,321
12414,11588,5639,5949,1729,2746,1164,1493,2940,1516
12416,63,21,42,10,6,5,15,19,8
12418,532,282,250,79,136,67,43,130,77
12419,237,114,123,22,83,9,17,93,13
12420,414,229,185,62,104,63,37,99,49
12421,780,400,380,86,176,138,63,175,142
12422,315,151,164,41,75,35,53,77,34
12423,1052,507,545,141,236,130,114,286,145
12424,333,169,164,44,81,44,37,74,53
12427,416,214,202,73,113,28,49,113,40
12428,8308,4691,3617,1075,3023,593,1074,1864,679
12429,15,7,8,0,7,0,0,8,0
12430,1135,559,576,131,288,140,142,253,181
12431,1441,719,722,253,386,80,206,412,104
12433,352,202,150,36,112,54,14,81,55
12434,677,304,373,85,163,56,104,185,84
12435,262,99,163,27,59,13,55,68,40
12439,115,62,53,23,31,8,15,30,8
12440,1672,822,850,173,465,184,154,475,221
12442,552,277,275,76,122,79,101,108,66
12443,3896,1888,2008,560,977,351,460,1056,492
12444,418,204,214,47,117,40,55,106,53
12446,5069,2579,2490,820,1402,357,804,1235,451
12448,206,103,103,11,63,29,18,63,22
12449,3574,1662,1912,441,963,258,514,909,489
12450,435,219,216,67,110,42,60,121,35
12451,1470,686,784,148,363,175,236,397,151
12454,625,303,322,81,155,67,101,174,47
12455,2227,1081,1146,240,572,269,243,477,426
12456,666,313,353,86,152,75,121,139,93
12457,1160,556,604,142,341,73,137,383,84
12458,2222,1091,1131,308,599,184,256,605,270
12459,162,97,65,15,40,42,6,38,21
12460,423,235,188,78,121,36,52,101,35
12461,1840,861,979,159,533,169,275,507,197
12463,1423,671,752,221,365,85,178,475,99
12464,1201,580,621,143,330,107,195,282,144
12466,3078,1434,1644,442,795,197,508,906,230
12468,1348,630,718,163,316,151,182,349,187
12469,782,388,394,96,188,104,107,206,81
12470,867,431,436,105,237,89,139,206,91
12471,125,46,79,0,19,27,9,29,41
12472,1579,776,803,211,490,75,170,501,132
12473,620,277,343,66,142,69,71,187,85
12474,1010,503,507,129,258,116,148,240,119
12477,20063,10280,9783,2935,5856,1489,2723,5164,1896
12480,761,394,367,50,234,110,85,182,100
12481,1192,654,538,215,309,130,120,316,102
12482,403,183,220,68,76,39,37,73,110
12484,2706,1273,1433,328,741,204,413,736,284
12485,1478,742,736,223,352,167,194,384,158
12486,1647,767,880,238,377,152,237,518,125
12487,3989,1992,1997,690,1083,219,578,1086,333
12489,258,128,130,44,61,23,28,77,25
12491,1587,788,799,192,379,217,219,395,185
12492,291,145,146,26,85,34,32,72,42
12493,528,303,225,75,170,58,51,113,61
12494,723,391,332,117,200,74,79,179,74
12495,146,85,61,10,51,24,0,38,23
12496,1036,486,550,131,205,150,124,243,183
12498,5199,2524,2675,537,1315,672,468,1444,763
12501,2444,1226,1218,336,639,251,292,671,255
12502,1183,620,563,164,311,145,136,294,133
12503,766,375,391,103,192,80,84,206,101
12507,207,109,98,29,80,0,8,90,0
12508,19480,10446,9034,2606,6696,1144,2645,4862,1527
12513,881,406,475,78,231,97,94,217,164
12514,2758,1428,1330,441,759,228,358,763,209
12515,1114,541,573,159,331,51,159,299,115
12516,1838,890,948,192,454,244,181,502,265
12517,275,146,129,47,94,5,36,68,25
12518,6256,2902,3354,869,1554,479,938,1651,765
12520,2928,1433,1495,444,781,208,449,775,271
12521,1514,721,793,224,356,141,226,389,178
12522,5774,2907,2867,996,1479,432,852,1429,586
12523,1976,1046,930,304,531,211,198,513,219
12524,14210,7583,6627,1987,4515,1081,1474,3475,1678
12525,2916,1502,1414,449,844,209,444,758,212
12526,3641,1789,1852,528,888,373,543,903,406
12528,12728,6233,6495,1959,3375,899,1715,3452,1328
12529,2376,1187,1189,298,597,292,326,593,270
12531,3036,1521,1515,525,787,209,443,770,302
12533,21604,10780,10824,3832,5808,1140,3240,6198,1386
12534,18846,9473,9373,2855,4769,1849,2355,4621,2397
12538,12698,6081,6617,1955,3147,979,1885,3331,1401
12540,6959,3391,3568,1206,1796,389,1120,1874,574
12542,6063,3094,2969,1083,1649,362,832,1616,521
12543,3146,1561,1585,578,867,116,562,826,197
12545,4896,2410,2486,632,1307,471,616,1275,595
12546,3017,1469,1548,436,753,280,428,805,315
12547,2196,1027,1169,306,539,182,381,615,173
12548,1639,888,751,384,407,97,197,442,112
12549,8736,4228,4508,1475,2178,575,1383,2448,677
12550,52024,24787,27237,9064,12495,3228,9500,13391,4346
12553,22672,11210,11462,3633,6005,1572,3356,6051,2055
12561,17253,7870,9383,2633,4220,1017,3632,4451,1300
12563,7293,3868,3425,960,2501,407,917,2092,416
12564,6654,3237,3417,986,1699,552,890,1806,721
12565,2069,998,1071,375,465,158,324,468,279
12566,11028,5896,5132,2046,3201,649,1493,2823,816
12567,3000,1495,1505,434,768,293,474,726,305
12569,8692,4342,4350,1388,2336,618,1219,2451,680
12570,6079,3020,3059,1060,1635,325,1053,1713,293
12571,11777,6899,4878,1824,4339,736,1813,2274,791
12572,9860,4694,5166,1363,2400,931,1146,2496,1524
12575,2102,1089,1013,410,605,74,317,610,86
12577,1751,817,934,268,451,98,401,429,104
12578,2160,1060,1100,309,639,112,334,630,136
12580,3955,1975,1980,582,1111,282,544,1131,305
12581,2263,1116,1147,285,620,211,312,595,240
12582,4575,2270,2305,805,1285,180,808,1333,164
12583,2421,1211,1210,419,648,144,395,585,230
12585,741,351,390,102,191,58,133,183,74
12586,11497,5676,5821,1979,2965,732,1857,2972,992
12589,13346,7255,6091,2186,4283,786,1944,3362,785
12590,33771,16820,16951,5141,9381,2298,4765,9330,2856
12592,1118,530,588,159,286,85,182,277,129
12594,3693,1922,1771,747,989,186,564,944,263
12601,42879,21142,21737,7943,10698,2501,7551,10528,3658
12603,41657,19968,21689,6815,9959,3194,6811,10565,4313
12701,11621,5688,5933,1875,2755,1058,1772,3008,1153
12719,1018,531,487,150,264,117,128,260,99
12720,187,109,78,26,69,14,10,57,11
12721,5404,2729,2675,910,1453,366,841,1461,373
12723,2235,1121,1114,404,498,219,408,461,245
12724,272,135,137,15,63,57,32,65,40
12725,241,129,112,31,71,27,32,62,18
12726,1168,611,557,184,288,139,156,257,144
12727,12,4,8,0,2,2,2,4,2
12729,1285,682,603,231,380,71,183,355,65
12732,877,450,427,137,185,128,78,226,123
12733,1837,1441,396,341,1017,83,188,172,36
12734,586,327,259,54,193,80,49,145,65
12736,150,72,78,18,43,11,30,40,8
12737,1539,720,819,210,344,166,260,350,209
12738,321,179,142,53,105,21,45,83,14
12739,594,333,261,128,144,61,44,159,58
12740,2147,1120,1027,361,530,229,274,559,194
12741,292,150,142,54,67,29,30,76,36
12742,130,40,90,0,21,19,42,33,15
12743,323,150,173,42,79,29,54,77,42
12746,1560,685,875,241,342,102,387,366,122
12747,1819,912,907,291,472,149,185,505,217
12748,2003,980,1023,325,476,179,312,463,248
12749,286,131,155,36,86,9,81,47,27
12751,380,198,182,75,78,45,52,81,49
12752,137,61,76,12,33,16,21,33,22
12754,7404,3471,3933,1103,1763,605,1131,1841,961
12758,4080,2097,1983,637,1020,440,477,1065,441
12759,1660,830,830,350,363,117,293,413,124
12760,685,348,337,78,176,94,68,162,107
12762,290,155,135,52,84,19,25,91,19
12763,829,511,318,161,264,86,44,206,68
12764,1729,879,850,219,405,255,222,404,224
12765,805,398,407,128,224,46,112,214,81
12766,474,234,240,71,119,44,57,133,50
12768,1000,538,462,131,311,96,163,221,78
12770,240,121,119,42,58,21,22,71,26
12771,13475,6589,6886,2179,3421,989,2071,3389,1426
12775,1604,806,798,239,375,192,200,377,221
12776,2483,1220,1263,301,587,332,322,526,415
12777,761,367,394,80,211,76,107,219,68
12778,752,336,416,66,199,71,173,189,54
12779,1518,756,762,302,308,146,193,485,84
12780,2137,1140,997,359,578,203,275,520,202
12783,2097,1097,1000,289,567,241,188,542,270
12784,28,6,22,0,6,0,7,15,0
12785,202,102,100,12,85,5,24,69,7
12786,680,303,377,58,166,79,104,154,119
12787,319,181,138,80,73,28,46,65,27
12788,2856,1787,1069,282,1329,176,383,516,170
12789,1649,754,895,245,387,122,293,442,160
12790,5632,2952,2680,901,1540,511,733,1408,539
12791,482,203,279,46,123,34,92,153,34
12792,283,148,135,39,77,32,23,91,21
12801,14500,6970,7530,2135,3933,902,2071,3821,1638
12803,7407,3485,3922,1030,1803,652,1127,1906,889
12804,23952,11496,12456,3631,6056,1809,3505,6253,2698
12808,268,144,124,11,77,56,12,66,46
12809,3650,1807,1843,549,972,286,525,920,398
12810,675,365,310,114,180,71,78,174,58
12812,150,62,88,12,38,12,33,35,20
12814,1555,769,786,197,390,182,168,415,203
12815,970,476,494,128,216,132,150,226,118
12816,4629,2274,2355,712,1137,425,632,1159,564
12817,2174,1106,1068,286,524,296,238,526,304
12819,366,179,187,64,87,28,54,92,41
12821,3211,2969,242,726,2179,64,90,117,35
12822,5703,2773,2930,863,1400,510,853,1453,624
12823,172,88,84,28,33,27,24,47,13
12824,781,367,414,81,186,100,86,218,110
12827,3857,1989,1868,680,1036,273,545,1028,295
12828,8363,4062,4301,1355,2088,619,1224,2119,958
12831,14252,7535,6717,2324,4526,685,2154,3868,695
12832,7227,3484,3743,1126,1708,650,1089,1779,875
12833,4531,2343,2188,765,1263,315,615,1303,270
12834,6815,3302,3513,1016,1729,557,1022,1776,715
12835,2885,1456,1429,452,715,289,396,714,319
12836,703,344,359,94,159,91,69,173,117
12837,827,411,416,113,236,62,140,217,59
12838,604,311,293,103,164,44,85,159,49
12839,11887,5678,6209,1833,2918,927,1726,3255,1228
12841,68,38,30,0,16,22,0,10,20
12842,1321,656,665,154,311,191,151,313,201
12843,685,346,339,100,177,69,105,172,62
12844,317,154,163,22,89,43,40,91,32
12845,4721,2363,2358,561,1319,483,531,1302,525
12846,3187,1587,1600,512,795,280,460,820,320
12847,724,358,366,68,184,106,80,182,104
12849,463,264,199,116,126,22,50,96,53
12850,2173,1109,1064,357,592,160,297,609,158
12851,332,166,166,31,84,51,37,83,46
12852,486,228,258,45,86,97,55,117,86
12853,2066,993,1073,244,524,225,240,530,303
12855,268,153,115,56,70,27,23,69,23
12856,233,119,114,35,68,16,14,81,19
12857,527,281,246,102,133,46,73,124,49
12858,57,31,26,7,14,10,3,19,4
12859,1971,1002,969,366,568,68,349,507,113
12860,1163,534,629,290,175,69,356,199,74
12861,652,324,328,80,178,66,88,162,78
12863,543,286,257,99,165,22,43,176,38
12865,3148,1594,1554,530,809,255,430,815,309
12866,34660,16532,18128,5250,8912,2370,5274,9367,3487
12870,1670,768,902,205,399,164,246,417,239
12871,3916,1919,1997,554,1027,338,523,1043,431
12873,838,414,424,113,211,90,104,189,131
12874,150,80,70,10,30,40,5,22,43
12878,690,338,352,100,166,72,99,162,91
12883,5167,2490,2677,793,1275,422,759,1284,634
12885,4606,2173,2433,644,1237,292,705,1226,502
12886,65,30,35,10,20,0,10,18,7
12887,4688,2292,2396,704,1186,402,724,1128,544
12901,32156,15454,16702,5301,8018,2135,5369,8006,3327
12903,34,21,13,0,10,11,0,0,13
12910,2307,1525,782,280,1109,136,244,421,117
12911,90,57,33,36,11,10,11,22,0
12912,2178,1055,1123,317,535,203,342,568,213
12913,1240,637,603,226,318,93,164,328,111
12914,1231,597,634,179,312,106,197,319,118
12916,1833,909,924,300,451,158,276,443,205
12917,1306,658,648,223,332,103,204,317,127
12918,2774,1380,1394,461,723,196,402,717,275
12919,2912,1426,1486,426,741,259,432,757,297
12920,2538,1371,1167,316,859,196,349,585,233
12921,2364,1155,1209,359,634,162,355,607,247
12922,65,30,35,2,10,18,4,21,10
12923,667,363,304,107,189,67,85,162,57
12926,2068,1045,1023,337,552,156,317,524,182
12927,217,120,97,21,54,45,12,47,38
12928,2119,1069,1050,361,535,173,331,517,202
12930,576,299,277,96,165,38,78,154,45
12932,1410,688,722,214,327,147,157,320,245
12934,1178,586,592,195,311,80,166,315,111
12935,5380,4172,1208,540,3440,192,383,626,199
12936,460,228,232,46,117,65,45,109,78
12937,1533,772,761,253,386,133,235,358,168
12941,1459,738,721,206,403,129,226,370,125
12942,678,351,327,112,173,66,99,174,54
12943,390,162,228,42,69,51,32,91,105
12944,4454,2160,2294,677,1152,331,675,1159,460
12945,685,404,281,89,274,41,42,183,56
12946,8070,4896,3174,825,3527,544,782,1591,801
12950,713,376,337,119,197,60,97,185,55
12952,605,279,326,81,128,70,55,152,119
12953,16234,10295,5939,1835,7408,1052,1595,2831,1513
12955,400,180,220,40,89,51,62,102,56
12956,2020,1106,914,274,680,152,230,463,221
12957,1823,910,913,290,517,103,279,501,133
12958,1794,914,880,305,453,156,294,461,125
12959,1473,751,722,241,427,83,171,422,129
12960,1033,625,408,189,313,123,101,224,83
12961,170,78,92,33,44,1,32,46,14
12962,6007,2956,3051,1055,1535,366,972,1620,459
12964,159,67,92,15,35,17,30,51,11
12965,454,226,228,80,109,37,71,117,40
12966,2869,1446,1423,505,736,205,466,723,234
12967,1107,569,538,197,296,76,164,283,91
12969,563,310,253,105,148,57,60,141,52
12970,1412,977,435,578,356,43,243,149,43
12972,5573,2684,2889,852,1368,464,893,1519,477
12974,1540,724,816,207,365,152,206,366,244
12979,2481,1198,1283,379,625,194,332,660,291
12980,1349,679,670,211,361,107,188,337,145
12981,2737,1365,1372,433,739,193,414,737,221
12983,7274,3570,3704,1173,1869,528,1035,1922,747
12985,1238,712,526,302,344,66,200,279,47
12986,6471,3249,3222,1010,1703,536,849,1576,797
12987,264,118,146,27,61,30,33,63,50
12989,834,434,400,135,228,71,108,214,78
12992,4469,2216,2253,691,1237,288,749,1199,305
12993,1694,830,864,230,390,210,209,409,246
12996,2168,1098,1070,301,518,279,258,520,292
13021,41719,20737,20982,6052,11235,3450,5795,9814,5373
13026,1901,776,1125,249,366,161,504,454,167
13027,29226,14210,15016,4545,7679,1986,4202,8168,2646
13028,1278,661,617,224,365,72,189,329,99
13029,5732,2813,2919,990,1491,332,993,1577,349
13030,4213,2199,2014,720,1166,313,540,1170,304
13031,15106,7321,7785,2274,3565,1482,2018,3889,1878
13032,12620,6195,6425,1892,3319,984,1943,3266,1216
13033,4447,2236,2211,782,1173,281,738,1158,315
13034,1928,968,960,301,478,189,269,462,229
13035,7987,3872,4115,1322,1939,611,1366,2002,747
13036,8659,4320,4339,1343,2389,588,1319,2264,756
13037,8670,4156,4514,1281,2297,578,1420,2402,692
13039,14443,7092,7351,2370,3874,848,2250,4081,1020
13040,2868,1445,1423,477,740,228,448,754,221
13041,9774,4844,4930,1617,2728,499,1616,2791,523
13042,2295,1159,1136,349,596,214,345,570,221
13044,2932,1524,1408,531,805,188,415,806,187
13045,29367,14001,15366,5082,6902,2017,5523,7107,2736
13052,1572,807,765,267,388,152,226,366,173
13053,4437,2209,2228,772,1187,250,683,1239,306
13054,2122,1076,1046,348,540,188,299,518,229
13057,14754,6886,7868,1897,3519,1470,1844,3967,2057
13060,2775,1324,1451,371,708,245,437,691,323
13061,898,469,429,161,252,56,122,223,84
13062,139,71,68,15,43,13,15,47,6
13063,2075,990,1085,345,537,108,385,573,127
13066,12229,5781,6448,1694,2838,1249,1704,3139,1605
13068,4901,2598,2303,918,1382,298,744,1298,261
13069,26474,12847,13627,4458,6567,1822,4285,6787,2555
13071,999,527,472,181,278,68,136,251,85
13072,1148,704,444,176,456,72,166,222,56
13073,5974,2970,3004,1098,1472,400,892,1549,563
13074,4414,2177,2237,720,1217,240,759,1176,302
13076,2283,1165,1118,414,628,123,349,653,116
13077,6771,3331,3440,1092,1752,487,983,1783,674
13078,8364,4153,4211,1205,2157,791,1077,1983,1151
13080,3513,1746,1767,581,906,259,522,929,316
13081,1203,607,596,200,303,104,166,305,125
13082,4987,2493,2494,803,1322,368,631,1351,512
13083,1865,927,938,331,470,126,308,474,156
13084,4235,2075,2160,710,1049,316,700,1101,359
13088,22081,10407,11674,2636,5857,1914,2643,6531,2500
13090,30898,14853,16045,5056,8295,1502,5092,9197,1756
13092,2476,1264,1212,399,670,195,411,629,172
13101,2279,1173,1106,403,567,203,319,554,233
13104,14580,7110,7470,2450,3658,1002,2236,3849,1385
13108,6088,2934,3154,1019,1469,446,949,1639,566
13110,2341,1186,1155,346,655,185,338,645,172
13111,1777,906,871,352,451,103,311,432,128
13112,1998,916,1082,329,500,87,384,527,171
13114,6549,3342,3207,1231,1779,332,1074,1706,427
13116,3451,1665,1786,549,893,223,514,944,328
13118,6741,4050,2691,983,2654,413,838,1359,494
13120,3037,1568,1469,690,740,138,618,682,169
13122,1319,637,682,215,316,106,194,386,102
13124,174,98,76,40,51,7,26,48,2
13126,36452,17554,18898,6456,8750,2348,6665,8755,3478
13131,3986,2001,1985,687,1086,228,675,1045,265
13132,4244,2145,2099,717,1172,256,615,1275,209
13135,5566,2805,2761,933,1455,417,834,1420,507
13136,591,302,289,91,158,53,99,146,44
13140,4882,2408,2474,801,1261,346,782,1258,434
13141,781,399,382,109,221,69,112,198,72
13142,6739,3361,3378,1108,1752,501,1045,1741,592
13143,3445,2051,1394,516,1342,193,454,737,203
13144,1610,872,738,289,447,136,264,381,93
13145,1699,841,858,246,455,140,238,429,191
13146,2537,1248,1289,447,636,165,439,635,215
13147,1175,616,559,213,308,95,160,277,122
13148,10880,5258,5622,1432,2879,947,1549,2913,1160
13152,8483,4173,4310,1344,2030,799,1217,2152,941
13155,676,356,320,123,174,59,100,168,52
13156,2207,1139,1068,319,583,237,259,536,273
13158,2064,1006,1058,340,535,131,378,522,158
13159,5361,2687,2674,952,1400,335,812,1496,366
13160,1885,927,958,302,457,168,308,464,186
13164,1671,838,833,217,400,221,228,439,166
13165,10949,5256,5693,1620,2664,972,1622,2776,1295
13166,6125,2997,3128,1016,1529,452,1008,1596,524
13167,3408,1753,1655,656,899,198,567,909,179
13202,5466,2909,2557,942,1703,264,822,1448,287
13203,15322,7325,7997,2028,4075,1222,2036,4115,1846
13204,20963,9899,11064,3881,4978,1040,4011,5246,1807
13205,20581,9013,11568,3592,3862,1559,3550,5004,3014
13206,16684,7848,8836,2040,4522,1286,2186,4606,2044
13207,15018,7115,7903,2827,3524,764,2717,4041,1145
13208,21426,9999,11427,3338,5117,1544,3208,5660,2559
13209,13837,6425,7412,1890,3331,1204,2013,3678,1721
13210,27145,13160,13985,6243,6044,873,6808,5907,1270
13211,6428,3158,3270,1047,1615,496,846,1667,757
13212,21107,9911,11196,2899,5132,1880,2937,5537,2722
13214,8763,3961,4802,1366,1723,872,1741,1936,1125
13215,14373,6988,7385,2407,3373,1208,2024,3440,1921
13219,15584,7251,8333,2026,3537,1688,1937,3947,2449
13224,9066,4245,4821,1443,2077,725,1311,2495,1015
13290,0,0,0,0,0,0,0,0,0
13301,137,90,47,7,60,23,11,23,13
13302,1567,766,801,271,375,120,283,408,110
13303,1169,632,537,199,336,97,143,304,90
13304,1727,856,871,236,482,138,280,445,146
13308,5218,2627,2591,839,1398,390,840,1421,330
13309,5911,2924,2987,972,1475,477,830,1454,703
13310,404,182,222,38,91,53,43,100,79
13312,633,307,326,58,170,79,77,141,108
13313,569,300,269,132,132,36,99,124,46
13314,914,442,472,144,232,66,158,246,68
13315,1460,741,719,231,373,137,211,359,149
13316,6580,3331,3249,1181,1628,522,969,1653,627
13317,3812,1875,1937,617,889,369,570,915,452
13318,1467,751,716,261,409,81,248,399,69
13319,968,507,461,190,284,33,182,244,35
13320,2212,1106,1106,371,554,181,314,609,183
13322,1106,546,560,192,288,66,189,291,80
13323,11912,5690,6222,2163,2523,1004,2144,2615,1463
13324,2059,1062,997,339,556,167,324,540,133
13325,978,483,495,159,229,95,172,232,91
13326,5623,2611,3012,621,1358,632,680,1385,947
13327,2151,1082,1069,391,531,160,356,511,202
13328,1309,646,663,216,337,93,228,328,107
13329,3988,1990,1998,620,1017,353,559,1007,432
13331,278,146,132,46,57,43,31,64,37
13332,2356,1163,1193,374,589,200,334,675,184
13333,142,66,76,16,27,23,22,29,25
13334,1561,733,828,273,384,76,311,411,106
13335,1552,745,807,245,382,118,238,425,144
13337,893,441,452,175,214,52,141,237,74
13338,1606,803,803,199,406,198,193,415,195
13339,6872,3392,3480,1120,1651,621,1088,1651,741
13340,7852,3834,4018,1210,1947,677,1060,2061,897
13341,70,39,31,12,27,0,6,18,7
13342,212,108,104,38,59,11,33,47,24
13343,1801,936,865,297,456,183,288,435,142
13346,5738,2709,3029,1412,896,401,1567,989,473
13348,1380,712,668,256,338,118,194,342,132
13350,9793,4491,5302,1296,2203,992,1338,2283,1681
13353,128,73,55,15,29,29,2,36,17
13354,3103,1493,1610,470,781,242,509,836,265
13355,728,384,344,125,198,61,112,175,57
13357,11641,5513,6128,1893,2688,932,1831,2974,1323
13360,403,213,190,62,110,41,33,101,56
13361,717,375,342,131,177,67,101,175,66
13363,2384,1172,1212,367,639,166,390,584,238
13365,8930,4265,4665,1236,2161,868,1219,2183,1263
13367,8316,3983,4333,1275,1955,753,1317,1962,1054
13368,1119,601,518,209,303,89,148,250,120
13402,1694,836,858,275,419,142,280,438,140
13403,7912,5900,2012,902,4559,439,482,1097,433
13406,677,338,339,99,156,83,95,163,81
13407,5726,2834,2892,840,1494,500,838,1425,629
13408,3897,2041,1856,1122,667,252,876,638,342
13409,2244,1127,1117,408,576,143,386,565,166
13411,3270,1594,1676,495,796,303,448,845,383
13413,16042,7343,8699,2224,3467,1652,1929,4021,2749
13416,2277,1104,1173,374,569,161,356,587,230
13417,3197,1506,1691,368,748,390,334,823,534
13418,303,175,128,78,74,23,35,67,26
13420,1632,796,836,178,450,168,185,438,213
13421,13137,6291,6846,1989,3378,924,1934,3447,1465
13424,2712,1381,1331,424,763,194,313,701,317
13425,2006,995,1011,340,485,170,285,506,220
13428,1684,791,893,228,398,165,228,385,280
13431,1765,878,887,259,464,155,281,435,171
13433,1770,871,899,304,428,139,307,432,160
13436,131,61,70,6,34,21,19,23,28
13437,462,231,231,70,118,43,57,130,44
13438,4392,2216,2176,686,1162,368,690,1155,331
13439,3822,1889,1933,553,869,467,490,919,524
13440,44803,22914,21889,6420,12676,3818,5819,10604,5466
13450,242,118,124,44,47,27,45,52,27
13452,4425,2145,2280,679,1081,385,664,1060,556
13454,682,354,328,123,159,72,99,163,66
13456,4221,1994,2227,615,1024,355,727,1095,405
13459,2018,1005,1013,350,448,207,292,482,239
13460,4395,2111,2284,697,1057,357,697,1099,488
13461,3197,1488,1709,480,744,264,498,787,424
13464,1365,696,669,245,351,100,233,343,93
13468,472,268,204,96,131,41,50,103,51
13469,903,433,470,151,230,52,165,223,82
13470,682,366,316,116,198,52,81,164,71
13471,3405,1821,1584,715,904,202,509,857,218
13473,803,387,416,138,192,57,139,202,75
13475,9,4,5,2,2,0,2,3,0
13476,3238,1580,1658,530,778,272,466,871,321
13477,1390,696,694,244,351,101,222,347,125
13478,3247,1665,1582,523,933,209,479,838,265
13480,3415,1652,1763,618,782,252,548,845,370
13483,208,103,105,42,50,11,37,58,10
13485,1035,545,490,207,266,72,187,251,52
13486,803,420,383,123,209,88,98,199,86
13489,818,413,405,154,213,46,160,203,42
13490,1508,797,711,225,426,146,176,396,139
13491,3854,1879,1975,575,991,313,601,984,390
13492,11428,5385,6043,1574,2657,1154,1596,2962,1485
13493,2124,1039,1085,356,550,133,399,562,124
13495,2336,1153,1183,363,548,242,269,520,394
13501,36160,16850,19310,5471,8103,3276,5471,8328,5511
13502,33280,16012,17268,5007,8096,2909,4723,8331,4214
13601,37068,18133,18935,5838,9801,2494,5607,9278,4050
13602,4651,4185,466,1965,2220,0,284,182,0
13603,7492,3748,3744,1733,2015,0,1736,1998,10
13605,4675,2282,2393,745,1191,346,688,1220,485
13606,2642,1361,1281,500,666,195,397,723,161
13607,2081,958,1123,274,495,189,287,517,319
13608,1637,828,809,329,398,101,293,388,128
13612,2733,1341,1392,469,709,163,472,733,187
13613,2516,1244,1272,399,638,207,355,659,258
13614,266,137,129,35,69,33,35,55,39
13615,1030,481,549,139,264,78,145,264,140
13616,2252,1151,1101,458,594,99,389,627,85
13617,10738,5540,5198,2474,2413,653,2096,2189,913
13618,1767,853,914,209,430,214,249,432,233
13619,11174,5406,5768,1808,2879,719,1879,2840,1049
13620,2514,1241,1273,427,642,172,444,655,174
13621,725,377,348,143,178,56,88,188,72
13622,2088,1084,1004,368,512,204,288,506,210
13624,5906,3564,2342,783,2324,457,653,1154,535
13625,1881,964,917,323,475,166,252,461,204
13626,2197,1104,1093,402,582,120,420,550,123
13630,1427,705,722,244,337,124,250,341,131
13633,304,161,143,66,67,28,64,61,18
13634,3723,1811,1912,581,986,244,562,1001,349
13635,1073,525,548,183,257,85,176,267,105
13637,3940,1912,2028,789,1004,119,840,1011,177
13638,387,211,176,68,112,31,61,93,22
13639,216,102,114,27,56,19,41,59,14
13640,255,145,110,24,69,52,4,67,39
13642,10404,5633,4771,1724,3228,681,1416,2470,885
13646,2246,1138,1108,340,566,232,291,548,269
13648,2415,1175,1240,342,639,194,356,633,251
13650,1337,661,676,184,329,148,183,316,177
13652,2037,1037,1000,357,551,129,352,508,140
13654,2498,1265,1233,496,617,152,429,619,185
13655,2506,1244,1262,541,573,130,456,641,165
13656,2633,1308,1325,383,764,161,459,679,187
13658,2268,1127,1141,357,582,188,333,585,223
13659,567,278,289,95,147,36,110,154,25
13660,2031,1026,1005,329,533,164,320,490,195
13661,2017,1015,1002,348,492,175,330,482,190
13662,16696,7821,8875,2250,4107,1464,2354,4366,2155
13664,335,154,181,45,73,36,69,75,37
13665,796,435,361,135,234,66,113,210,38
13667,3556,1856,1700,666,906,284,460,887,353
13668,3243,1628,1615,524,859,245,463,881,271
13669,17834,9494,8340,2442,5756,1296,2362,4024,1954
13670,601,317,284,74,169,74,67,135,82
13672,387,199,188,51,97,51,34,110,44
13673,2363,1145,1218,455,593,97,474,585,159
13675,99,53,46,28,15,10,8,30,8
13676,17144,8728,8416,4160,3670,898,3574,3511,1331
13679,1713,821,892,247,420,154,291,444,157
13680,1227,607,620,219,321,67,229,314,77
13681,726,386,340,132,189,65,96,177,67
13682,907,436,471,134,254,48,167,243,61
13684,1029,488,541,161,249,78,190,258,93
13685,2211,1153,1058,289,710,154,276,602,180
13687,328,158,170,43,82,33,48,87,35
13690,1149,572,577,182,278,112,162,271,144
13691,2607,1431,1176,500,775,156,360,691,125
13693,495,247,248,55,113,79,49,123,76
13694,1364,665,699,157,361,147,173,373,153
13697,2027,1012,1015,331,516,165,291,533,191
13730,2882,1461,1421,449,764,248,379,735,307
13731,1267,653,614,152,298,203,133,303,178
13732,8357,4179,4178,1381,2218,580,1286,2210,682
13733,4887,2458,2429,838,1208,412,658,1327,444
13734,2592,1278,1314,547,579,152,451,669,194
13736,2441,1238,1203,458,643,137,343,689,171
13739,934,488,446,157,222,109,135,191,120
13740,555,277,278,80,135,62,96,112,70
13743,3834,1842,1992,667,931,244,683,957,352
13744,1227,661,566,218,319,124,164,303,99
13746,2267,1141,1126,365,579,197,331,527,268
13748,4136,2044,2092,669,1018,357,597,1102,393
13750,1357,685,672,217,328,140,186,317,169
13752,710,375,335,99,170,106,75,164,96
13753,5500,2756,2744,1152,1152,452,916,1146,682
13754,3490,1717,1773,573,791,353,530,836,407
13755,1116,536,580,143,267,126,144,266,170
13756,561,267,294,92,115,60,64,137,93
13757,1043,512,531,138,278,96,139,286,106
13760,43863,21198,22665,6100,11026,4072,5655,11490,5520
13774,234,128,106,43,76,9,37,52,17
13775,1685,828,857,231,448,149,212,415,230
13776,792,358,434,87,194,77,115,189,130
13777,1061,529,532,193,287,49,184,295,53
13778,6274,3138,3136,1009,1675,454,972,1564,600
13780,915,462,453,128,246,88,148,211,94
13782,761,356,405,92,166,98,106,191,108
13783,2518,1243,1275,364,596,283,366,595,314
13786,415,205,210,52,103,50,45,114,51
13787,3642,1801,1841,619,932,250,611,924,306
13788,971,453,518,101,244,108,130,258,130
13790,19729,9315,10414,2636,4976,1703,2569,4873,2972
13795,3782,1846,1936,539,933,374,511,1069,356
13796,1111,567,544,147,322,98,132,299,113
13797,2524,1279,1245,490,630,159,425,642,178
13801,1278,655,623,188,337,130,170,338,115
13802,711,357,354,123,191,43,111,188,55
13803,4193,2079,2114,750,1032,297,696,1079,339
13804,395,224,171,91,101,32,52,89,30
13807,1316,633,683,217,292,124,203,370,110
13808,1900,908,992,289,471,148,296,505,191
13809,1343,700,643,245,367,88,167,363,113
13810,1337,663,674,207,306,150,177,364,133
13811,4272,2268,2004,811,1114,343,579,1075,350
13812,2416,1227,1189,433,612,182,355,606,228
13813,1025,531,494,198,252,81,163,236,95
13815,14027,6449,7578,1964,3257,1228,2120,3548,1910
13820,21057,9871,11186,4056,4462,1353,4655,4525,2006
13825,3496,1665,1831,529,879,257,538,917,376
13827,11854,5908,5946,1706,3128,1074,1499,3064,1383
13830,5184,2599,2585,736,1181,682,655,1257,673
13832,655,327,328,137,158,32,131,160,37
13833,4447,2204,2243,731,1142,331,712,1193,338
13834,151,60,91,23,28,9,29,47,15
13835,1475,722,753,216,395,111,244,385,124
13838,4953,2312,2641,750,1077,485,709,1222,710
13839,1655,868,787,286,416,166,245,373,169
13841,438,246,192,101,120,25,65,98,29
13842,540,312,228,159,81,72,58,117,53
13843,1719,833,886,245,450,138,288,461,137
13844,1036,654,382,118,469,67,127,196,59
13846,298,140,158,27,79,34,44,66,48
13849,5242,2703,2539,880,1342,481,721,1281,537
13850,26708,12735,13973,5271,5217,2247,5246,5649,3078
13856,6609,3204,3405,881,1674,649,888,1696,821
13859,223,103,120,24,70,9,25,78,17
13861,674,344,330,102,146,96,73,196,61
13862,3926,1916,2010,680,966,270,700,993,317
13863,576,294,282,96,151,47,87,141,54
13864,985,484,501,114,293,77,167,243,91
13865,6445,3233,3212,1124,1642,467,992,1660,560
13901,20150,9611,10539,2862,5007,1742,2817,4996,2726
13903,19096,9214,9882,3071,4518,1625,2835,4963,2084
13904,9586,4564,5022,1314,2387,863,1304,2453,1265
13905,27713,13205,14508,3913,6856,2436,3979,6698,3831
14001,9345,4608,4737,1423,2384,801,1289,2360,1088
14004,12289,6706,5583,1753,3879,1074,1338,2848,1397
14005,1732,885,847,302,461,122,271,424,152
14006,10963,5337,5626,1744,2767,826,1658,2896,1072
14008,1428,688,740,219,353,116,230,376,134
14009,5530,2767,2763,900,1412,455,829,1358,576
14011,8185,5126,3059,1021,3672,433,923,1584,552
14012,2651,1346,1305,444,709,193,436,659,210
14013,1669,794,875,250,424,120,277,390,208
14020,23040,11167,11873,3267,5878,2022,3306,5661,2906
14024,1826,913,913,335,458,120,333,451,129
14025,3178,1581,1597,505,818,258,462,857,278
14026,781,367,414,108,158,101,168,158,88
14028,1814,1005,809,367,475,163,194,443,172
14030,1636,834,802,268,454,112,203,466,133
14031,8756,4063,4693,1247,1880,936,1117,2134,1442
14032,5519,2764,2755,1007,1429,328,928,1460,367
14033,1979,939,1040,295,524,120,312,522,206
14034,6080,4951,1129,454,4292,205,304,578,247
14036,5364,2644,2720,872,1369,403,873,1409,438
14037,1062,585,477,187,312,86,115,279,83
14039,110,53,57,18,33,2,18,31,8
14040,2190,1150,1040,364,614,172,277,567,196
14042,4578,2269,2309,765,1147,357,711,1115,483
14043,26324,12623,13701,3542,6759,2322,3340,7177,3184
14047,6820,3310,3510,1090,1796,424,1030,1903,577
14048,16011,7533,8478,2363,3734,1436,2205,3903,2370
14051,17953,8736,9217,3027,4726,983,3060,5164,993
14052,18272,9001,9271,2687,4632,1682,2439,4658,2174
14054,1409,711,698,220,369,122,219,372,107
14055,1401,683,718,216,345,122,215,378,125
14057,8040,3982,4058,1250,2009,723,1135,2014,909
14058,2279,1183,1096,441,587,155,307,622,167
14059,8729,4251,4478,1219,2133,899,1134,2270,1074
14060,470,212,258,44,135,33,94,127,37
14062,3424,1708,1716,499,892,317,516,880,320
14063,14657,6889,7768,2772,3208,909,3382,3142,1244
14065,2081,1052,1029,401,545,106,385,525,119
14066,1518,798,720,284,408,106,249,376,95
14067,5258,2559,2699,780,1368,411,793,1474,432
14068,10096,4822,5274,2614,1758,450,2366,1919,989
14069,709,379,330,87,223,69,69,209,52
14070,5833,2873,2960,911,1427,535,810,1384,766
14072,18622,9124,9498,2887,4926,1311,2785,5174,1539
14075,42269,20059,22210,6214,10569,3276,5838,11261,5111
14080,4756,2368,2388,795,1260,313,758,1321,309
14081,3472,1613,1859,547,815,251,491,894,474
14082,431,215,216,82,98,35,68,109,39
14083,67,43,24,8,32,3,6,14,4
14085,5599,2817,2782,969,1483,365,903,1497,382
14086,28665,13987,14678,4513,7479,1995,4057,7751,2870
14091,1070,500,570,152,268,80,182,310,78
14092,11100,5211,5889,1470,2547,1194,1423,2830,1636
14094,51478,25280,26198,8265,13474,3541,7535,13589,5074
14098,2846,1409,1437,479,712,218,460,726,251
14101,1944,962,982,323,457,182,276,439,267
14102,1103,515,588,186,285,44,202,338,48
14103,11551,5555,5996,1810,2835,910,1824,2816,1356
14105,4458,2223,2235,744,1149,330,671,1111,453
14108,6087,2903,3184,937,1540,426,1004,1632,548
14111,3233,1607,1626,550,798,259,472,855,299
14113,713,355,358,93,183,79,92,181,85
14120,43085,20791,22294,6366,11025,3400,6128,11450,4716
14125,3931,1964,1967,717,973,274,649,1004,314
14127,27751,13423,14328,4169,6796,2458,3887,7210,3231
14129,1791,907,884,296,462,149,216,514,154
14131,5397,2713,2684,839,1392,482,711,1381,592
14132,5403,2696,2707,900,1342,454,772,1363,572
14134,0,0,0,0,0,0,0,0,0
14136,5431,2612,2819,816,1347,449,886,1344,589
14138,2158,1074,1084,430,480,164,373,530,181
14139,2061,1023,1038,265,572,186,282,573,183
14141,7878,3824,4054,1226,1970,628,1113,2017,924
14143,1379,673,706,208,358,107,237,340,129
14145,1716,861,855,284,470,107,317,411,127
14150,44773,21685,23088,6203,10899,4583,5692,11274,6122
14167,1771,870,901,307,445,118,318,474,109
14170,2631,1259,1372,333,731,195,443,683,246
14171,2190,1073,1117,312,589,172,375,589,153
14172,3209,1585,1624,474,806,305,456,790,378
14174,5747,2841,2906,954,1474,413,835,1543,528
14201,13568,6410,7158,2141,3539,730,2361,3591,1206
14202,4183,2587,1596,585,1619,383,249,900,447
14203,874,441,433,106,245,90,148,172,113
14204,10148,4594,5554,1741,2074,779,1706,2611,1237
14206,22767,10813,11954,2996,5632,2185,2891,5675,3388
14207,22913,10919,11994,3854,5532,1533,3657,5904,2433
14208,13292,5706,7586,2360,2202,1144,2452,3048,2086
14209,8691,3843,4848,1166,1943,734,1130,2432,1286
14210,16666,7956,8710,2722,4142,1092,2814,4249,1647
14211,29585,13571,16014,5635,6055,1881,5420,7819,2775
14212,15629,7352,8277,2681,3417,1254,2783,3735,1759
14213,25811,12391,13420,5004,6087,1300,4697,6794,1929
14214,22067,10416,11651,3832,5441,1143,3966,5725,1960
14215,44311,20015,24296,7997,9512,2506,8069,12304,3923
14216,23520,11058,12462,3098,6251,1709,2720,6829,2913
14217,24580,11255,13325,3109,6066,2080,2937,6533,3855
14218,20179,9744,10435,3024,4766,1954,2680,4958,2797
14219,12999,6244,6755,1889,3375,980,1761,3577,1417
14220,26531,12625,13906,4022,6502,2101,3786,6762,3358
14221,51624,23842,27782,6611,11456,5775,6620,12668,8494
14222,14525,7165,7360,1468,4741,956,1860,4254,1246
14223,24035,11148,12887,3292,5518,2338,3322,6027,3538
14224,40465,19231,21234,5257,9864,4110,5327,10315,5592
14225,35861,16715,19146,4559,8351,3805,4264,9010,5872
14226,29393,13592,15801,3727,7159,2706,3847,7769,4185
14227,24669,11568,13101,2963,6349,2256,2723,6626,3752
14228,19518,9513,10005,3264,5138,1111,3000,5414,1591
14301,14321,6588,7733,2094,3313,1181,2018,3612,2103
14303,7019,3299,3720,1009,1578,712,1043,1579,1098
14304,30869,14958,15911,4286,7717,2955,3953,7991,3967
14305,20318,9182,11136,3533,3982,1667,4013,4802,2321
14411,14658,8036,6622,2479,4556,1001,1968,3262,1392
14414,6680,3280,3400,1083,1696,501,966,1772,662
14415,37,22,15,4,15,3,0,3,12
14416,3999,2018,1981,643,1095,280,616,1021,344
14418,1529,787,742,231,393,163,206,366,170
14420,19360,9435,9925,3693,4840,902,3955,4738,1232
14422,2531,1237,1294,411,695,131,432,711,151
14423,4922,2422,2500,783,1272,367,803,1237,460
14424,25068,12137,12931,3559,6462,2116,3571,6581,2779
14425,9591,4697,4894,1656,2631,410,1592,2850,452
14427,2247,1138,1109,384,574,180,336,554,219
14428,7371,3751,3620,1290,2128,333,1081,2105,434
14432,6019,3015,3004,991,1507,517,789,1530,685
14433,4849,2407,2442,884,1137,386,805,1175,462
14435,2664,1321,1343,389,750,182,406,748,189
14437,12349,7303,5046,1603,4871,829,1438,2589,1019
14441,359,196,163,46,111,39,40,81,42
14445,8300,3822,4478,1152,2073,597,1197,2357,924
14450,40973,19653,21320,6299,10618,2736,6112,11739,3469
14454,9957,4161,5796,2063,1688,410,3353,1823,620
14456,20074,9503,10571,3358,4519,1626,3477,4796,2298
14462,592,271,321,97,136,38,100,173,48
14464,7760,3846,3914,1480,2109,257,1367,2198,349
14466,1484,815,669,266,455,94,140,456,73
14467,8676,4130,4546,1359,2298,473,1387,2523,636
14468,16471,8098,8373,2638,4438,1022,2816,4349,1208
14469,5806,2895,2911,867,1550,478,864,1550,497
14470,8928,3688,5240,1215,1931,542,1340,3243,657
14471,2788,1426,1362,412,777,237,361,704,297
14472,8292,4024,4268,1292,2163,569,1133,2399,736
14475,233,116,117,33,67,16,45,57,15
14476,2587,1234,1353,434,580,220,493,667,193
14477,1659,881,778,316,454,111,227,434,117
14478,1326,490,836,215,193,82,462,247,127
14480,658,308,350,112,149,47,110,189,51
14481,3656,2727,929,341,2181,205,291,475,163
14482,9296,4616,4680,1513,2440,663,1235,2522,923
14485,4711,2309,2402,784,1233,292,730,1305,367
14487,5776,2795,2981,994,1497,304,955,1602,424
14489,7487,3666,3821,1062,1866,738,1044,1855,922
14502,9355,4600,4755,1564,2501,535,1489,2662,604
14504,1318,669,649,211,317,141,150,303,196
14505,6058,2942,3116,987,1580,375,1053,1640,423
14506,1260,581,679,180,303,98,261,358,60
14507,1382,715,667,245,370,100,204,358,105
14510,5193,2620,2573,896,1348,376,704,1271,598
14512,4630,2325,2305,710,1242,373,605,1268,432
14513,14879,7072,7807,2337,3634,1101,2297,3749,1761
14514,4820,2217,2603,799,1064,354,976,1067,560
14516,2515,1234,1281,357,625,252,402,612,267
14517,2788,1388,1400,473,687,228,413,691,296
14519,11198,5682,5516,1946,3080,656,1690,3117,709
14521,3616,2108,1508,584,1272,252,457,736,315
14522,8718,4304,4414,1299,2363,642,1221,2351,842
14525,2819,1409,1410,479,740,190,455,714,241
14526,19713,9462,10251,3120,4919,1423,2900,5395,1956
14527,12919,6353,6566,2120,3012,1221,1855,3063,1648
14530,5737,2819,2918,883,1475,461,807,1548,563
14532,4496,2207,2289,782,1120,305,619,1241,429
14533,2175,1125,1050,341,609,175,269,589,192
14534,30060,14562,15498,4611,7132,2819,4261,7763,3474
14536,643,311,332,95,154,62,101,181,50
14541,1984,958,1026,334,477,147,341,502,183
14543,3256,1785,1471,677,829,279,362,830,279
14544,2045,1026,1019,365,490,171,316,531,172
14545,243,126,117,46,68,12,25,66,26
14546,5625,2785,2840,916,1486,383,839,1511,490
14548,4161,2041,2120,592,1101,348,650,1078,392
14550,1757,880,877,297,455,128,242,455,180
14551,5464,2612,2852,904,1352,356,893,1416,543
14555,1322,657,665,166,360,131,145,369,151
14559,15933,7906,8027,2702,4111,1093,2421,4409,1197
14560,2279,1169,1110,340,672,157,331,632,147
14561,2861,1397,1464,437,673,287,514,690,260
14564,9813,4800,5013,1486,2640,674,1442,2796,775
14568,5509,2796,2713,1084,1537,175,889,1595,229
14569,6403,3081,3322,978,1524,579,841,1643,838
14571,1205,680,525,226,349,105,142,300,83
14572,5307,2611,2696,851,1307,453,792,1386,518
14580,43868,21306,22562,6641,11310,3355,6093,11959,4510
14585,306,149,157,37,86,26,42,80,35
14586,6246,3087,3159,1020,1797,270,901,1916,342
14589,7698,3843,3855,1215,1946,682,1099,2081,675
14590,5413,2649,2764,841,1355,453,793,1388,583
14591,1572,802,770,255,416,131,248,388,134
14604,1705,867,838,110,636,121,134,501,203
14605,14314,6624,7690,3484,2635,505,3347,3660,683
14606,29788,14219,15569,4933,7320,1966,4664,8180,2725
14607,16223,8372,7851,936,6636,800,969,5548,1334
14608,12774,6342,6432,2540,3212,590,2305,3424,703
14609,43701,20017,23684,6846,10443,2728,6868,11789,5027
14610,13798,6347,7451,1530,3529,1288,1381,4005,2065
14611,18973,8845,10128,3879,4024,942,3884,4867,1377
14612,35456,17293,18163,5409,9618,2266,4808,9984,3371
14613,14766,7042,7724,3001,3569,472,3030,3917,777
14614,963,956,7,197,728,31,0,7,0
14615,15264,7524,7740,2350,4169,1005,2006,4340,1394
14616,27692,12916,14776,4143,6394,2379,3867,7408,3501
14617,22941,10828,12113,3169,5351,2308,3046,5867,3200
14618,22870,10488,12382,3323,5039,2126,3416,5820,3146
14619,15020,6827,8193,2774,3377,676,2672,4496,1025
14620,27935,13617,14318,4301,7750,1566,3942,7243,3133
14621,36399,16675,19724,7049,7440,2186,7093,9168,3463
14622,12026,5764,6262,1435,3010,1319,1403,3072,1787
14623,27259,15039,12220,6356,7261,1422,4029,6322,1869
14624,38100,18459,19641,5592,9923,2944,5346,10452,3843
14625,11027,5424,5603,1568,2632,1224,1330,2848,1425
14626,29429,14167,15262,4404,7095,2668,3818,7662,3782
14701,43011,20604,22407,6440,10540,3624,6302,10872,5233
14706,7485,3609,3876,1564,1539,506,1511,1620,745
14708,159,90,69,29,31,30,18,30,21
14709,1479,708,771,227,338,143,243,354,174
14710,3956,1934,2022,600,976,358,656,982,384
14711,1938,969,969,348,455,166,310,453,206
14712,3525,1674,1851,483,810,381,507,868,476
14714,328,151,177,52,69,30,70,82,25
14715,3298,1616,1682,558,791,267,579,796,307
14716,3758,2285,1473,757,1345,183,423,802,248
14717,691,349,342,117,167,65,103,163,76
14718,2281,1162,1119,378,581,203,301,566,252
14719,3568,1760,1808,572,916,272,587,914,307
14721,90,51,39,18,27,6,11,24,4
14723,1266,642,624,257,307,78,210,312,102
14724,2601,1338,1263,452,648,238,423,611,229
14726,2096,1049,1047,533,391,125,491,419,137
14727,5381,2619,2762,802,1356,461,762,1369,631
14728,1049,556,493,176,256,124,114,230,149
14729,1039,536,503,183,275,78,191,238,74
14731,1789,869,920,222,449,198,214,491,215
14733,4015,1989,2026,708,906,375,572,973,481
14735,2630,1322,1308,437,663,222,416,624,268
14736,314,149,165,50,82,17,61,78,26
14737,4423,2208,2215,723,1106,379,671,1125,419
14738,3731,1812,1919,562,895,355,562,886,471
14739,3012,1516,1496,552,729,235,505,745,246
14740,1160,609,551,209,303,97,185,273,93
14741,2014,1040,974,321,519,200,240,496,238
14743,2020,975,1045,311,489,175,338,493,214
14744,2289,996,1293,534,325,137,795,329,169
14747,2493,1271,1222,400,672,199,349,649,224
14748,676,343,333,98,153,92,61,182,90
14750,4583,2226,2357,641,1174,411,531,1184,642
14753,1196,605,591,218,300,87,158,303,130
14754,548,272,276,93,158,21,89,151,36
14755,2983,1562,1421,510,796,256,407,737,277
14757,3813,1939,1874,498,974,467,481,875,518
14760,20625,9638,10987,2912,5011,1715,3176,5261,2550
14767,1859,910,949,329,440,141,329,433,187
14769,953,466,487,160,210,96,154,227,106
14770,3225,1595,1630,559,792,244,520,777,333
14772,4314,2155,2159,793,1003,359,681,1034,444
14775,2744,1404,1340,442,732,230,402,641,297
14777,684,349,335,114,164,71,109,166,60
14779,7316,3512,3804,1163,1707,642,1158,1734,912
14781,2159,1073,1086,403,540,130,406,512,168
14782,2854,1342,1512,376,673,293,376,675,461
14783,396,183,213,64,82,37,69,115,29
14784,996,487,509,193,214,80,183,244,82
14787,5480,2673,2807,847,1302,524,766,1354,687
14801,5455,2679,2776,886,1399,394,910,1410,456
14802,3926,2318,1608,1740,508,70,1105,389,114
14803,1241,638,603,206,324,108,207,291,105
14804,1501,786,715,267,406,113,216,381,118
14805,1218,598,620,206,317,75,211,331,78
14806,2331,1174,1157,404,591,179,371,575,211
14807,3102,1507,1595,472,758,277,507,759,329
14808,650,324,326,112,165,47,94,162,70
14809,2660,1361,1299,459,656,246,456,630,213
14810,12467,6256,6211,1852,3007,1397,1666,3023,1522
14812,3856,2014,1842,775,966,273,633,938,271
14813,2559,1315,1244,419,653,243,291,635,318
14814,1746,890,856,278,431,181,219,465,172
14815,983,538,445,199,245,94,83,233,129
14816,582,309,273,86,185,38,117,133,23
14817,2134,1124,1010,400,560,164,269,597,144
14818,1783,880,903,264,486,130,232,488,183
14819,764,426,338,140,245,41,97,186,55
14820,774,400,374,156,209,35,125,195,54
14821,3443,1718,1725,576,862,280,522,913,290
14822,1185,613,572,215,285,113,177,289,106
14823,4055,1963,2092,626,980,357,658,955,479
14824,918,454,464,130,265,59,180,217,67
14825,944,492,452,175,263,54,154,241,57
14826,2115,1068,1047,374,528,166,340,530,177
14830,19506,9428,10078,2837,5059,1532,2762,5094,2222
14836,1061,525,536,166,295,64,163,280,93
14837,5482,2674,2808,972,1201,501,992,1269,547
14838,2079,1070,1009,361,577,132,306,577,126
14839,723,349,374,101,185,63,143,172,59
14840,3427,1682,1745,437,839,406,450,858,437
14841,772,404,368,118,213,73,69,220,79
14842,828,414,414,131,176,107,149,154,111
14843,13281,6327,6954,2105,3129,1093,1986,3258,1710
14845,19849,9392,10457,2835,4694,1863,2554,5151,2752
14846,793,410,383,132,215,63,125,208,50
14847,2486,1196,1290,375,597,224,349,647,294
14850,63584,31251,32333,13164,15187,2900,13114,14856,4363
14855,854,426,428,175,180,71,173,180,75
14857,0,0,0,0,0,0,0,0,0
14858,1820,891,929,297,464,130,322,492,115
14859,1030,555,475,209,276,70,132,277,66
14860,1142,591,551,198,293,100,171,286,94
14861,1415,692,723,194,351,147,206,368,149
14864,1292,672,620,208,345,119,157,352,111
14865,2762,1316,1446,390,644,282,336,653,457
14867,5364,2599,2765,889,1434,276,737,1650,378
14869,1379,677,702,214,362,101,217,347,138
14870,9284,4451,4833,1368,2300,783,1276,2315,1242
14871,4853,2370,2483,678,1199,493,662,1312,509
14872,546,270,276,111,123,36,113,115,48
14873,2429,1212,1217,386,605,221,377,623,217
14874,207,99,108,30,58,11,29,59,20
14877,650,340,310,101,172,67,88,146,76
14878,729,386,343,113,187,86,82,197,64
14879,2058,1005,1053,322,512,171,305,556,192
14880,1652,819,833,266,386,167,250,397,186
14881,180,64,116,21,43,0,22,71,23
14882,3879,1846,2033,671,946,229,665,1030,338
14883,3900,1929,1971,602,1061,266,595,1086,290
14884,323,159,164,42,77,40,45,71,48
14885,746,367,379,134,172,61,137,184,58
14886,6504,3272,3232,1105,1689,478,937,1711,584
14889,1434,704,730,215,385,104,238,356,136
14891,4460,2122,2338,678,1043,401,690,1124,524
14892,8304,3939,4365,1216,2010,713,1160,2112,1093
14894,2514,1730,784,305,1273,152,247,384,153
14895,10269,4927,5342,1469,2405,1053,1355,2511,1476
14897,899,430,469,144,212,74,163,202,104
14898,1531,757,774,283,356,118,284,395,95
14901,17948,9597,8351,2920,5450,1227,2860,3744,1747
14903,7616,3692,3924,1133,1886,673,985,1936,1003
14904,16923,7969,8954,2848,3776,1345,2649,4292,2013
14905,9380,4324,5056,1347,2160,817,1314,2445,1297
15001,34499,16266,18233,4589,7999,3678,4391,8916,4926
15003,12893,6246,6647,1651,3115,1480,1438,3084,2125
15004,284,129,155,32,62,35,46,49,60
15005,9301,4453,4848,1135,2312,1006,1037,2389,1422
15006,387,186,201,28,90,68,58,67,76
15007,414,209,205,85,98,26,76,92,37
15009,15190,6996,8194,1856,3545,1595,1819,3726,2649
15010,29507,13800,15707,4221,6903,2676,4161,7500,4046
15012,16883,7937,8946,2127,3885,1925,2129,4285,2532
15014,3543,1537,2006,363,840,334,496,932,578
15015,1240,615,625,145,346,124,128,373,124
15017,14398,6707,7691,1634,3811,1262,1522,3944,2225
15018,521,207,314,20,84,103,66,115,133
15019,1985,1008,977,287,508,213,261,493,223
15020,371,153,218,10,103,40,92,105,21
15021,7863,3891,3972,1054,2097,740,987,2046,939
15022,11649,5466,6183,1462,2744,1260,1261,2910,2012
15024,8430,4054,4376,1047,2043,964,934,2180,1262
15025,17445,8100,9345,2396,4024,1680,2226,4546,2573
15026,3980,2035,1945,630,1090,315,583,1093,269
15027,2290,1088,1202,280,537,271,244,546,412
15028,160,79,81,18,41,20,25,33,23
15030,1042,469,573,114,262,93,110,260,203
15031,575,246,329,85,118,43,96,161,72
15033,5741,2609,3132,723,1306,580,701,1354,1077
15034,2015,937,1078,211,539,187,230,534,314
15035,2363,1156,1207,323,578,255,232,613,362
15037,12002,5768,6234,1535,2917,1316,1441,3042,1751
15038,260,148,112,61,45,42,13,33,66
15042,7980,3878,4102,1258,2147,473,1223,2266,613
15043,2555,1248,1307,406,684,158,437,688,182
15044,22823,11178,11645,3671,5916,1591,3466,6174,2005
15045,4993,2366,2627,627,1201,538,603,1266,758
15046,2208,1019,1189,284,521,214,352,572,265
15049,973,454,519,85,267,102,62,275,182
15050,2486,1247,1239,393,699,155,370,656,213
15051,573,236,337,68,98,70,79,126,132
15052,3952,1965,1987,608,1022,335,538,986,463
15053,109,48,61,19,13,16,5,36,20
15054,451,236,215,68,133,35,33,131,51
15055,1275,563,712,120,322,121,162,419,131
15056,1212,536,676,152,258,126,155,303,218
15057,11030,5441,5589,1562,2935,944,1446,2891,1252
15059,4711,2231,2480,631,1057,543,603,1151,726
15060,982,466,516,124,245,97,125,260,131
15061,13844,6717,7127,2115,3368,1234,1824,3575,1728
15062,8674,3965,4709,996,1742,1227,976,1931,1802
15063,12233,5870,6363,1584,2909,1377,1358,2923,2082
15064,261,102,159,23,58,21,22,78,59
15065,12029,5620,6409,1588,2749,1283,1442,3078,1889
15066,14153,6783,7370,2207,3348,1228,1994,3740,1636
15067,2274,1089,1185,306,555,228,263,578,344
15068,41676,19788,21888,5537,10134,4117,5295,10611,5982
15071,9304,4518,4786,1183,2663,672,1237,2801,748
15072,123,65,58,18,42,5,16,31,11
15074,9952,4800,5152,1429,2525,846,1269,2494,1389
15075,172,80,92,18,42,20,19,47,26
15076,845,424,421,134,206,84,111,196,114
15078,487,229,258,46,151,32,69,122,67
15081,543,269,274,74,143,52,49,163,62
15082,451,200,251,60,122,18,127,109,15
15083,821,401,420,130,182,89,88,198,134
15084,10694,5135,5559,1468,2763,904,1369,2916,1274
15085,8040,3807,4233,1065,1964,778,1001,2106,1126
15086,353,202,151,63,119,20,40,79,32
15087,164,86,78,4,58,24,14,48,16
15088,581,266,315,75,146,45,87,161,67
15089,7789,3750,4039,1081,2022,647,1005,2073,961
15090,17956,8711,9245,3002,4849,860,3031,5021,1193
15101,24451,11807,12644,3751,5942,2114,3720,6371,2553
15102,30796,14785,16011,4289,7385,3111,4015,8018,3978
15104,11529,5181,6348,1875,2319,987,1957,2791,1600
15106,19093,8913,10180,2316,4498,2099,2170,4992,3018
15108,37657,18220,19437,5272,10042,2906,5113,10114,4210
15110,7332,3312,4020,1268,1382,662,1265,1750,1005
15112,3550,1627,1923,468,886,273,479,950,494
15116,14983,7193,7790,2124,3665,1404,1924,3937,1929
15120,20352,9353,10999,2582,4633,2138,2457,5199,3343
15122,21864,10239,11625,2927,4935,2377,2786,5314,3525
15126,6865,3347,3518,1156,1849,342,1002,2030,486
15129,11557,5671,5886,1880,3159,632,1714,3407,765
15131,9031,4284,4747,1088,2090,1106,946,2239,1562
15132,26205,12024,14181,4099,5417,2508,3642,6490,4049
15133,6735,3205,3530,830,1582,793,781,1663,1086
15135,5676,2758,2918,795,1444,519,680,1478,760
15136,22637,10804,11833,3106,5536,2162,2873,5791,3169
15137,10998,5150,5848,1370,2649,1131,1292,2897,1659
15139,6911,3044,3867,761,1544,739,744,1817,1306
15140,3689,1765,1924,540,950,275,504,966,454
15142,677,317,360,101,168,48,123,188,49
15143,16563,7816,8747,2200,4010,1606,2206,4382,2159
15144,4668,2287,2381,641,1178,468,524,1151,706
15145,7974,3589,4385,970,1859,760,1029,2091,1265
15146,29450,13796,15654,3646,7195,2955,3416,7861,4377
15147,18543,8762,9781,2558,4212,1992,2271,4628,2882
15148,2921,1338,1583,366,740,232,351,768,464
15201,14098,6531,7567,1829,3348,1354,1563,3755,2249
15202,21168,9866,11302,2605,5682,1579,2425,6075,2802
15203,9634,4742,4892,731,3070,941,850,2496,1546
15204,9530,4538,4992,1420,2301,817,1356,2469,1167
15205,22522,10446,12076,3009,5762,1675,2935,6530,2611
15206,32778,15133,17645,4366,8075,2692,4476,9243,3926
15207,13299,6161,7138,1788,3129,1244,1701,3375,2062
15208,13086,5843,7243,2226,2557,1060,2070,3537,1636
15209,12987,6196,6791,1677,3332,1187,1597,3509,1685
15210,31173,14492,16681,4941,7123,2428,4874,8126,3681
15211,12464,6103,6361,1394,3728,981,1415,3436,1510
15212,31951,15189,16762,4600,7939,2650,4480,8061,4221
15213,28296,14033,14263,6791,5826,1416,7165,4690,2408
15214,17379,7879,9500,2835,3835,1209,2969,4561,1970
15215,13182,6233,6949,1723,3160,1350,1728,3438,1783
15216,24731,11662,13069,3310,6477,1875,2873,7166,3030
15217,26410,12677,13733,2957,7353,2367,2792,7548,3393
15218,14937,6871,8066,1836,3857,1178,1672,4411,1983
15219,19154,9493,9661,3527,4742,1224,3845,3823,1993
15220,19807,9667,10140,2166,5483,2018,2008,5262,2870
15221,36335,16377,19958,4880,8191,3306,4604,10276,5078
15222,1969,945,1024,171,620,154,169,510,345
15223,7927,3719,4208,1087,1844,788,1032,2010,1166
15224,12276,5493,6783,1492,2980,1021,1757,3405,1621
15225,1229,596,633,148,319,129,121,332,180
15226,14603,6721,7882,1713,3729,1279,1800,4035,2047
15227,29843,14338,15505,4035,7536,2767,3338,8066,4101
15228,17629,8187,9442,2619,4271,1297,2614,4990,1838
15229,13614,6202,7412,1717,3255,1230,1798,3614,2000
15232,11861,5941,5920,983,4344,614,962,3779,1179
15233,4849,3174,1675,518,2385,271,425,858,392
15234,14985,7097,7888,1889,3693,1515,1526,4111,2251
15235,39111,18282,20829,4779,9263,4240,4723,10142,5964
15236,30396,14441,15955,3790,7357,3294,3454,7701,4800
15237,42744,20502,22242,5852,10622,4028,5008,11338,5896
15238,13495,6387,7108,1843,3198,1346,1845,3560,1703
15239,21220,10546,10674,3262,5668,1616,2900,5867,1907
15241,20675,9910,10765,3153,4772,1985,3076,5172,2517
15243,13589,6193,7396,1670,2952,1571,1581,3273,2542
15301,49679,23513,26166,7020,12043,4450,6376,12880,6910
15310,405,214,191,60,107,47,62,83,46
15311,1365,703,662,193,425,85,195,372,95
15312,3763,1958,1805,611,1031,316,464,962,379
15313,368,191,177,65,96,30,42,87,48
15314,3840,1871,1969,585,910,376,428,1015,526
15315,733,350,383,103,164,83,89,178,116
15316,421,217,204,46,139,32,52,121,31
15317,31942,15297,16645,4314,8117,2866,4309,8359,3977
15320,5155,2561,2594,770,1344,447,671,1297,626
15321,1915,965,950,323,538,104,289,548,113
15322,2282,996,1286,278,516,202,308,598,380
15323,4826,2397,2429,733,1253,411,655,1251,523
15324,714,324,390,94,164,66,96,168,126
15325,676,249,427,33,149,67,98,210,119
15327,1496,730,766,207,385,138,206,390,170
15329,2098,1030,1068,299,544,187,318,549,201
15330,5010,2456,2554,696,1341,419,633,1467,454
15331,1083,522,561,147,266,109,133,263,165
15332,7440,3577,3863,880,1946,751,923,1974,966
15333,2248,1084,1164,314,494,276,279,557,328
15334,198,88,110,18,44,26,28,53,29
15337,882,422,460,109,241,72,141,233,86
15338,1720,859,861,255,432,172,240,397,224
15340,1509,752,757,211,397,144,212,331,214
15341,1020,501,519,149,269,83,161,264,94
15342,5094,2381,2713,631,1216,534,608,1291,814
15344,1328,688,640,205,322,161,149,313,178
15345,1892,883,1009,287,455,141,304,492,213
15346,768,366,402,87,198,81,86,189,127
15347,18,9,9,0,9,0,0,0,9
15348,326,137,189,43,69,25,75,59,55
15349,2025,1033,992,293,591,149,249,524,219
15350,674,296,378,77,135,84,73,190,115
15351,970,442,528,156,253,33,174,271,83
15352,895,440,455,159,213,68,139,239,77
15353,129,68,61,24,35,9,18,39,4
15357,1563,757,806,192,388,177,193,402,211
15358,850,432,418,149,175,108,89,196,133
15359,177,88,89,26,41,21,24,43,22
15360,1976,968,1008,288,541,139,293,534,181
15361,191,87,104,35,35,17,27,49,28
15362,709,356,353,123,178,55,110,182,61
15363,751,334,417,90,167,77,108,185,124
15364,799,463,336,136,261,66,99,172,65
15367,5390,2591,2799,1011,1341,239,1028,1483,288
15368,557,278,279,90,145,43,69,148,62
15370,15484,8566,6918,2230,5303,1033,2099,3298,1521
15376,1800,887,913,277,476,134,278,450,185
15377,891,469,422,164,232,73,130,205,87
15378,214,109,105,26,64,19,33,50,22
15379,145,71,74,22,37,12,11,34,29
15380,922,478,444,164,241,73,131,242,71
15401,36521,16955,19566,5225,8408,3322,4643,9331,5592
15410,1081,528,553,131,267,130,112,268,173
15411,676,352,324,68,171,113,63,141,120
15412,291,148,143,30,85,33,29,78,36
15413,396,163,233,41,91,31,43,138,52
15417,9298,4322,4976,1313,2188,821,1190,2466,1320
15419,4238,2019,2219,936,834,249,1015,732,472
15420,110,51,59,7,35,9,0,35,24
15422,344,203,141,40,112,51,44,59,38
15423,2152,1103,1049,329,582,192,290,507,252
15424,2448,1193,1255,299,621,273,314,589,352
15425,22546,10844,11702,3374,5513,1957,2931,5862,2909
15427,1152,582,570,165,298,119,112,295,163
15428,1942,995,947,290,513,192,235,482,230
15429,88,52,36,21,10,21,9,10,17
15430,358,187,171,70,95,22,57,82,32
15431,5394,2684,2710,834,1373,477,688,1384,638
15432,391,181,210,37,91,53,52,98,60
15433,1129,491,638,97,256,138,175,262,201
15434,392,185,207,55,81,49,45,78,84
15436,3200,1502,1698,456,830,216,436,874,388
15437,3116,1618,1498,583,777,258,508,737,253
15438,2454,1202,1252,317,667,218,277,617,358
15440,290,119,171,39,61,19,50,88,33
15442,2689,1315,1374,301,700,314,308,692,374
15443,417,258,159,126,101,31,44,106,9
15444,553,214,339,48,150,16,93,132,114
15445,3178,1580,1598,419,841,320,289,827,482
15446,129,66,63,0,47,19,6,27,30
15447,77,50,27,22,12,16,0,11,16
15448,138,90,48,19,40,31,0,22,26
15450,377,176,201,66,80,30,73,98,30
15451,908,432,476,110,238,84,160,217,99
15454,160,51,109,21,22,8,50,36,23
15455,179,82,97,6,53,23,0,26,71
15456,2741,1288,1453,361,728,199,420,734,299
15458,2582,1265,1317,323,691,251,349,657,311
15459,1851,903,948,274,469,160,254,465,229
15460,114,49,65,5,27,17,9,31,25
15461,4468,2095,2373,607,1050,438,601,1085,687
15462,390,204,186,64,111,29,29,97,60
15464,1561,787,774,219,437,131,234,408,132
15466,549,248,301,73,118,57,65,138,98
15468,3064,1485,1579,422,777,286,414,781,384
15469,2698,1387,1311,472,720,195,396,661,254
15470,1167,548,619,155,283,110,134,350,135
15472,360,157,203,20,80,57,18,85,100
15473,3767,1820,1947,490,931,399,428,934,585
15474,2562,1290,1272,416,660,214,328,639,305
15475,1568,721,847,241,304,176,200,365,282
15476,263,116,147,14,78,24,43,66,38
15477,917,404,513,98,201,105,126,222,165
15478,6464,3122,3342,921,1648,553,1038,1638,666
15479,2053,1017,1036,292,517,208,294,520,222
15480,2456,1131,1325,310,640,181,392,683,250
15482,761,337,424,81,182,74,90,203,131
15483,648,311,337,54,181,76,60,171,106
15484,78,24,54,0,13,11,18,28,8
15485,136,60,76,17,37,6,8,49,19
15486,2841,1393,1448,381,793,219,371,784,293
15489,337,142,195,24,90,28,65,104,26
15490,1157,575,582,179,335,61,175,360,47
15492,45,22,23,3,14,5,0,11,12
15501,17214,8402,8812,2376,4372,1654,2315,4244,2253
15520,223,127,96,37,69,21,8,56,32
15521,1893,931,962,307,451,173,318,464,180
15522,12163,5931,6232,1680,2980,1271,1487,3011,1734
15530,7007,4245,2762,931,2858,456,796,1334,632
15531,4106,1978,2128,563,1041,374,599,1068,461
15532,57,28,29,4,16,8,5,9,15
15533,1300,625,675,171,321,133,181,328,166
15534,994,527,467,150,256,121,111,229,127
15535,2270,1154,1116,319,616,219,320,560,236
15536,421,210,211,49,123,38,59,106,46
15537,8369,4044,4325,1111,2041,892,1039,2173,1113
15538,755,391,364,97,195,99,92,171,101
15539,521,258,263,106,107,45,78,128,57
15540,293,144,149,41,70,33,38,83,28
15541,3924,1950,1974,617,973,360,536,1024,414
15542,1469,783,686,287,400,96,181,364,141
15544,261,136,125,42,75,19,21,73,31
15545,2889,1435,1454,421,728,286,348,707,399
15546,395,197,198,36,111,50,42,66,90
15547,283,134,149,27,73,34,34,75,40
15550,1755,892,863,222,486,184,235,408,220
15551,861,445,416,134,208,103,121,193,102
15552,6306,3052,3254,914,1554,584,897,1547,810
15553,192,93,99,17,52,24,31,45,23
15554,2695,1342,1353,415,709,218,381,713,259
15557,3757,1864,1893,527,984,353,514,948,431
15558,2476,1193,1283,375,570,248,387,569,327
15559,1723,852,871,209,448,195,187,470,214
15560,243,97,146,26,39,32,37,63,46
15562,189,80,109,30,36,14,38,52,19
15563,3597,1839,1758,531,932,376,456,912,390
15601,56967,26991,29976,7443,14534,5014,7369,14990,7617
15610,2682,1248,1434,321,708,219,472,731,231
15611,252,127,125,38,59,30,42,73,10
15612,549,281,268,64,171,46,78,150,40
15613,15187,7399,7788,2102,3903,1394,1965,3936,1887
15615,242,121,121,41,53,27,34,68,19
15617,407,214,193,59,116,39,47,97,49
15618,1634,796,838,227,377,192,190,394,254
15620,641,273,368,54,152,67,92,154,122
15622,1313,684,629,166,365,153,181,286,162
15623,918,482,436,148,220,114,119,197,120
15624,490,211,279,14,132,65,70,112,97
15625,58,23,35,7,16,0,18,17,0
15626,4833,2239,2594,606,1118,515,583,1248,763
15627,7314,3591,3723,1131,1877,583,1017,1796,910
15628,804,418,386,117,201,100,94,190,102
15629,757,338,419,92,177,69,113,207,99
15631,1039,554,485,148,292,114,78,236,171
15632,8172,3999,4173,1113,2234,652,1220,2139,814
15633,368,167,201,31,104,32,40,76,85
15634,556,251,305,79,137,35,87,166,52
15635,199,89,110,20,51,18,33,44,33
15636,2937,1422,1515,535,735,152,540,741,234
15637,2347,1079,1268,240,573,266,279,655,334
15639,2287,1110,1177,291,601,218,357,596,224
15640,282,116,166,26,76,14,63,64,39
15641,511,260,251,94,104,62,76,107,68
15642,44890,21503,23387,5944,11453,4106,5872,12150,5365
15644,19997,9613,10384,2668,5015,1930,2490,5068,2826
15646,395,215,180,68,117,30,51,90,39
15647,130,43,87,8,35,0,24,50,13
15650,28054,13612,14442,3749,6875,2988,3395,6969,4078
15655,535,260,275,81,134,45,59,136,80
15656,9977,4839,5138,1290,2570,979,1219,2501,1418
15658,9150,4490,4660,1149,2240,1101,1033,2299,1328
15660,265,146,119,33,57,56,15,55,49
15661,649,346,303,101,167,78,86,139,78
15662,218,107,111,39,45,23,40,55,16
15663,549,267,282,59,155,53,70,154,58
15665,1378,696,682,255,317,124,185,357,140
15666,16258,7886,8372,1997,4252,1637,1907,4141,2324
15668,12829,6351,6478,1894,3169,1288,1632,3279,1567
15670,4175,2153,2022,630,1126,397,553,1070,399
15671,998,565,433,187,243,135,100,248,85
15672,3178,1584,1594,377,1000,207,276,953,365
15673,1426,688,738,214,328,146,196,342,200
15674,483,231,252,67,132,32,48,126,78
15675,1509,746,763,230,392,124,252,383,128
15676,646,279,367,28,206,45,69,227,71
15677,578,287,291,77,146,64,65,160,66
15678,334,140,194,25,75,40,30,102,62
15679,3020,1476,1544,350,851,275,407,766,371
15680,294,151,143,55,63,33,36,73,34
15681,4590,2237,2353,633,1112,492,585,1148,620
15683,8359,3917,4442,1107,1990,820,1084,2163,1195
15684,872,451,421,168,233,50,121,226,74
15685,557,283,274,92,159,32,80,122,72
15686,1307,641,666,172,351,118,207,333,126
15687,1428,753,675,180,397,176,148,359,168
15688,659,307,352,40,177,90,43,173,136
15689,278,124,154,36,66,22,32,92,30
15690,9499,4533,4966,1265,2285,983,1192,2400,1374
15692,762,372,390,142,167,63,108,172,110
15693,510,232,278,62,120,50,92,142,44
15695,320,117,203,0,78,39,35,94,74
15696,472,193,279,41,108,44,71,125,83
15697,4328,2498,1830,447,1674,377,400,887,543
15698,734,341,393,95,168,78,83,212,98
15701,34019,15805,18214,5745,7620,2440,6835,7776,3603
15710,329,146,183,49,77,20,49,83,51
15711,424,199,225,36,113,50,41,106,78
15712,109,45,64,15,22,8,29,26,9
15713,452,259,193,102,127,30,41,115,37
15714,6120,2977,3143,910,1499,568,895,1445,803
15715,708,361,347,109,180,72,102,170,75
15716,290,156,134,48,74,34,12,66,56
15717,11083,5381,5702,1552,2797,1032,1393,2811,1498
15721,294,143,151,40,72,31,50,66,35
15722,3101,1508,1593,446,786,276,420,771,402
15723,64,35,29,7,20,8,7,18,4
15724,2913,1442,1471,440,767,235,402,781,288
15725,1739,885,854,248,527,110,240,444,170
15728,3948,1887,2061,613,969,305,577,1022,462
15729,1567,779,788,276,363,140,235,354,199
15730,144,63,81,11,42,10,28,30,23
15731,261,132,129,32,92,8,24,75,30
15732,1737,911,826,273,512,126,239,461,126
15733,126,53,73,6,17,30,7,37,29
15734,326,190,136,70,79,41,30,60,46
15736,357,179,178,54,84,41,41,88,49
15739,500,237,263,89,113,35,82,107,74
15741,224,102,122,24,62,16,38,64,20
15742,1072,556,516,162,306,88,124,236,156
15744,120,69,51,18,34,17,11,26,14
15745,300,158,142,35,88,35,31,76,35
15747,2482,1248,1234,407,653,188,412,597,225
15748,7053,3490,3563,954,1818,718,903,1802,858
15752,95,38,57,5,24,9,18,23,16
15753,521,252,269,80,126,46,82,135,52
15754,540,229,311,82,104,43,103,133,75
15756,159,79,80,28,42,9,22,37,21
15757,1809,920,889,290,445,185,250,415,224
15759,2979,1480,1499,538,761,181,459,742,298
15760,122,50,72,13,26,11,25,38,9
15761,134,61,73,17,31,13,28,20,25
15762,704,369,335,123,194,52,97,174,64
15763,17,7,10,0,7,0,2,5,3
15764,157,66,91,12,32,22,17,42,32
15765,1713,881,832,264,449,168,214,484,134
15767,14534,6959,7575,2251,3468,1240,2017,3638,1920
15770,332,170,162,46,90,34,45,73,44
15771,971,486,485,162,216,108,136,211,138
15772,1747,882,865,228,451,203,210,417,238
15773,440,233,207,52,122,59,40,112,55
15774,3259,1625,1634,479,882,264,464,866,304
15775,1361,661,700,169,339,153,198,308,194
15776,59,34,25,9,20,5,11,14,0
15777,109,47,62,17,24,6,13,32,17
15778,162,90,72,20,49,21,16,28,28
15779,472,352,120,117,235,0,22,88,10
15780,124,66,58,12,28,26,14,26,18
15781,201,96,105,24,50,22,27,49,29
15783,117,57,60,21,29,7,25,29,6
15784,95,47,48,13,26,8,14,26,8
15801,20588,9960,10628,2952,5013,1995,2600,5064,2964
15821,181,81,100,14,41,26,28,49,23
15823,1572,817,755,246,426,145,179,391,185
15824,5408,2681,2727,876,1264,541,745,1247,735
15825,9863,4724,5139,1347,2431,946,1302,2457,1380
15827,630,299,331,75,170,54,89,148,94
15828,299,155,144,40,82,33,34,74,36
15829,1248,617,631,187,310,120,227,275,129
15832,438,238,200,74,119,45,57,99,44
15834,5297,2555,2742,730,1294,531,755,1223,764
15840,1951,991,960,265,523,203,253,484,223
15841,212,95,117,24,40,31,33,50,34
15845,3727,1814,1913,511,932,371,527,864,522
15846,3987,2011,1976,639,1045,327,592,1009,375
15847,270,134,136,39,60,35,42,58,36
15848,963,478,485,146,251,81,153,238,94
15849,1493,741,752,220,384,137,175,384,193
15851,6604,3249,3355,1011,1597,641,1024,1595,736
15853,7377,3617,3760,1070,1882,665,1017,1796,947
15856,895,450,445,144,238,68,126,241,78
15857,14552,7141,7411,2084,3705,1352,1893,3578,1940
15860,1101,585,516,129,310,146,112,265,139
15861,179,90,89,21,37,32,25,40,24
15863,354,198,156,59,101,38,49,74,33
15864,1903,991,912,307,509,175,262,485,165
15865,1340,654,686,190,308,156,187,303,196
15866,212,99,113,35,40,24,31,67,15
15868,980,502,478,135,243,124,96,237,145
15870,1462,770,692,207,415,148,191,342,159
15901,5568,2465,3103,674,1171,620,656,1265,1182
15902,13377,6201,7176,1795,3210,1196,1853,3358,1965
15904,16831,7790,9041,2406,3553,1831,2610,3678,2753
15905,22763,10660,12103,2692,5386,2582,2529,5657,3917
15906,11879,5518,6361,1452,2785,1281,1556,2886,1919
15909,6565,3135,3430,774,1680,681,844,1623,963
15920,919,454,465,134,234,86,138,245,82
15923,1882,966,916,309,465,192,269,416,231
15924,1256,606,650,201,293,112,193,286,171
15925,110,54,56,13,24,17,14,18,24
15926,2772,1340,1432,328,707,305,378,657,397
15927,1128,503,625,129,231,143,159,233,233
15928,1997,927,1070,256,424,247,285,479,306
15929,73,23,50,6,13,4,20,30,0
15930,145,86,59,27,42,17,0,31,28
15931,9758,4982,4776,1329,2859,794,1111,2467,1198
15934,264,133,131,58,47,28,24,85,22
15935,3154,1639,1515,469,874,296,395,704,416
15936,1613,791,822,225,415,151,207,388,227
15937,714,297,417,90,111,96,108,179,130
15938,3873,2493,1380,416,1780,297,363,652,365
15940,3410,2087,1323,531,1384,172,728,450,145
15942,2170,1092,1078,325,558,209,239,588,251
15943,5148,2509,2639,825,1224,460,667,1183,789
15944,3635,1822,1813,536,929,357,453,897,463
15946,7251,3554,3697,1033,1858,663,888,1782,1027
15948,602,251,351,64,116,71,135,109,107
15949,485,236,249,65,119,52,52,129,68
15952,1590,778,812,204,381,193,204,474,134
15954,2657,1307,1350,338,667,302,309,668,373
15955,3476,1769,1707,552,932,285,474,796,437
15956,3356,1602,1754,467,906,229,448,838,468
15957,351,171,180,49,72,50,46,74,60
15958,2423,1192,1231,408,574,210,388,577,266
15961,654,338,316,106,178,54,107,158,51
15963,11703,5556,6147,1571,2731,1254,1415,2841,1891
16001,41897,20092,21805,5669,10657,3766,5328,11092,5385
16002,16064,8164,7900,2760,4146,1258,2260,4121,1519
16020,952,510,442,134,278,98,103,246,93
16022,535,259,276,86,123,50,90,125,61
16023,4389,2068,2321,605,953,510,445,954,922
16024,440,213,227,67,106,40,73,113,41
16025,5586,2777,2809,835,1444,498,795,1374,640
16027,568,295,273,111,149,35,80,146,47
16028,2146,1074,1072,294,533,247,258,497,317
16029,679,357,322,92,199,66,66,161,95
16030,360,189,171,66,101,22,53,100,18
16033,5770,2866,2904,884,1561,421,801,1561,542
16034,2022,995,1027,287,519,189,302,519,206
16035,92,46,46,11,30,5,8,25,13
16036,369,196,173,65,91,40,50,92,31
16037,4624,2341,2283,681,1308,352,568,1303,412
16038,3351,1674,1677,490,869,315,450,866,361
16040,1050,513,537,169,253,91,172,250,115
16041,2147,1037,1110,324,541,172,315,571,224
16045,1268,632,636,173,370,89,169,296,171
16046,9872,4661,5211,1524,2582,555,1509,2773,929
16049,3336,1646,1690,516,828,302,516,798,376
16050,1613,791,822,240,414,137,259,434,129
16051,3307,1642,1665,492,818,332,441,892,332
16052,2223,1136,1087,319,665,152,333,587,167
16053,3398,1675,1723,520,892,263,551,863,309
16054,460,251,209,84,122,45,49,109,51
16055,7982,3881,4101,1090,2119,672,1187,2127,787
16056,4958,2336,2622,731,1168,437,672,1276,674
16057,13029,6222,6807,2524,2988,710,3144,2767,896
16059,7007,3475,3532,1142,1732,601,1080,1766,686
16061,2338,1194,1144,349,683,162,334,658,152
16063,6735,3233,3502,939,1626,668,795,1683,1024
16066,23631,11717,11914,4106,6530,1081,3803,6602,1509
16101,36560,17314,19246,5416,8303,3595,4945,8852,5449
16102,6386,3131,3255,1027,1511,593,859,1631,765
16105,15029,6937,8092,1727,3469,1741,1806,3708,2578
16110,296,152,144,39,72,41,30,75,39
16111,1137,563,574,244,260,59,223,292,59
16112,1651,807,844,194,427,186,197,393,254
16113,513,245,268,65,134,46,82,145,41
16114,652,323,329,108,167,48,117,168,44
16115,3504,1688,1816,444,878,366,468,934,414
16116,3686,1803,1883,460,1000,343,522,927,434
16117,17921,8540,9381,2532,4213,1795,2554,4454,2373
16120,2467,1219,1248,403,638,178,398,593,257
16121,6114,2739,3375,957,1144,638,908,1451,1016
16123,2202,1114,1088,337,605,172,269,589,230
16124,2223,1105,1118,382,505,218,344,572,202
16125,19220,9218,10002,2793,4562,1863,2740,4551,2711
16127,15344,7726,7618,3164,3353,1209,2503,3384,1731
16130,2035,1015,1020,286,530,199,257,534,229
16131,920,474,446,172,216,86,149,217,80
16132,363,151,212,37,82,32,89,67,56
16133,1640,799,841,244,416,139,252,436,153
16134,3895,1892,2003,504,943,445,491,1001,511
16136,885,435,450,113,221,101,79,212,159
16137,13202,6983,6219,1887,4056,1040,1723,3182,1314
16140,208,90,118,25,46,19,28,55,35
16141,1837,924,913,231,529,164,261,472,180
16142,6214,2791,3423,1206,1143,442,1480,1279,664
16143,3114,1526,1588,430,837,259,472,807,309
16145,2774,1319,1455,370,700,249,410,744,301
16146,16373,7739,8634,2440,3794,1505,2340,4090,2204
16148,13417,6043,7374,1603,2868,1572,1696,3207,2471
16150,9157,4499,4658,1307,2202,990,1054,2338,1266
16151,158,86,72,32,35,19,14,34,24
16153,2441,1247,1194,370,643,234,294,627,273
16154,2998,1507,1491,514,757,236,396,852,243
16155,122,23,99,0,5,18,0,6,93
16156,3218,1582,1636,482,794,306,542,787,307
16157,3408,1613,1795,424,871,318,458,912,425
16159,6579,3274,3305,1039,1580,655,808,1696,801
16160,993,493,500,126,256,111,98,247,155
16161,740,348,392,84,174,90,88,174,130
16201,18730,9014,9716,2573,4691,1750,2518,4631,2567
16210,1125,560,565,190,243,127,157,271,137
16212,391,196,195,41,101,54,21,78,96
16213,211,88,123,25,44,19,38,58,27
16214,10492,4757,5735,1948,2180,629,2536,2302,897
16217,164,82,82,16,44,22,25,36,21
16218,1185,595,590,151,331,113,181,305,104
16222,2270,1109,1161,368,527,214,329,568,264
16223,104,48,56,12,26,10,14,28,14
16224,1191,615,576,212,294,109,154,302,120
16226,8786,4168,4618,1079,2085,1004,1098,2189,1331
16228,416,190,226,46,107,37,66,99,61
16229,5156,2475,2681,666,1364,445,746,1336,599
16230,591,291,300,100,136,55,96,137,67
16232,4539,2230,2309,709,1114,407,628,1186,495
16233,1284,655,629,177,371,107,174,335,120
16234,45,19,26,2,9,8,2,12,12
16235,1179,592,587,156,320,116,167,308,112
16236,275,147,128,61,71,15,18,68,42
16238,395,195,200,73,90,32,52,105,43
16239,1687,906,781,338,365,203,184,343,254
16240,1596,816,780,242,406,168,210,407,163
16242,5104,2449,2655,660,1266,523,690,1216,749
16244,390,188,202,73,95,20,64,95,43
16245,231,101,130,28,51,22,39,61,30
16246,275,147,128,57,63,27,44,60,24
16248,3697,1771,1926,558,910,303,561,921,444
16249,2118,1097,1021,384,514,199,248,557,216
16250,391,213,178,91,83,39,50,83,45
16253,94,47,47,13,20,14,13,16,18
16254,3520,1692,1828,446,862,384,460,870,498
16255,2042,966,1076,306,448,212,284,491,301
16256,1768,910,858,462,349,99,411,334,113
16258,1647,830,817,218,469,143,212,407,198
16259,2098,1053,1045,335,553,165,294,536,215
16260,309,173,136,67,74,32,28,79,29
16262,3010,1452,1558,404,730,318,384,776,398
16263,404,198,206,41,114,43,43,99,64
16301,17849,8458,9391,2607,4311,1540,2645,4455,2291
16311,555,274,281,82,145,47,83,150,48
16313,2003,1013,990,317,499,197,252,511,227
16314,5695,2844,2851,892,1498,454,792,1529,530
16316,5553,2740,2813,728,1461,551,684,1493,636
16317,1497,738,759,219,375,144,214,383,162
16319,1045,525,520,138,270,117,133,232,155
16321,146,77,69,24,40,13,21,37,11
16322,85,40,45,8,21,11,4,25,16
16323,17060,8051,9009,2422,4017,1612,2409,4240,2360
16326,557,283,274,86,141,56,84,136,54
16327,3109,1611,1498,560,812,239,438,783,277
16329,317,158,159,43,86,29,37,91,31
16331,324,163,161,42,85,36,38,90,33
16332,163,84,79,27,42,15,21,41,17
16333,405,201,204,60,94,47,45,97,62
16334,537,247,290,67,125,55,100,139,51
16335,28781,13649,15132,4537,6629,2483,4300,7147,3685
16340,2217,1116,1101,326,560,230,288,570,243
16341,2045,1095,950,334,492,269,216,502,232
16342,2762,1509,1253,483,763,263,239,746,268
16343,508,248,260,79,148,21,86,107,67
16344,474,224,250,67,96,61,56,95,99
16345,3729,1889,1840,538,1025,326,492,1009,339
16346,3255,1603,1652,504,857,242,439,855,358
16347,2446,1210,1236,350,601,259,325,614,297
16350,2882,1450,1432,542,690,218,526,668,238
16351,1860,928,932,229,445,254,254,431,247
16352,274,142,132,39,67,36,26,73,33
16353,3202,1640,1562,473,778,389,374,775,413
16354,12146,5722,6424,1846,2731,1145,1904,2905,1615
16360,1439,729,710,222,371,136,217,358,135
16361,68,38,30,15,11,12,9,10,11
16362,997,500,497,171,264,65,170,243,84
16364,1011,497,514,143,258,96,150,269,95
16365,19701,9560,10141,2755,5037,1768,2402,5110,2629
16370,205,102,103,33,48,21,24,50,29
16371,3637,1682,1955,521,776,385,479,903,573
16372,541,262,279,78,123,61,96,126,57
16373,3562,1758,1804,506,903,349,488,880,436
16374,1622,847,775,232,427,188,200,417,158
16401,6194,4008,2186,914,2754,340,670,1113,403
16402,861,445,416,158,215,72,161,185,70
16403,6557,3013,3544,985,1580,448,865,2122,557
16404,3361,1707,1654,583,859,265,569,763,322
16405,673,339,334,115,168,56,96,169,69
16406,3698,1839,1859,611,877,351,513,865,481
16407,11729,5651,6078,1885,2807,959,1801,2918,1359
16410,1793,912,881,297,485,130,290,471,120
16411,1469,752,717,245,387,120,257,370,90
16412,12625,6147,6478,2824,2757,566,2810,2910,758
16415,8029,3863,4166,1193,1917,753,1201,2043,922
16416,295,146,149,60,74,12,45,80,24
16417,8552,4197,4355,1452,2153,592,1310,2333,712
16420,744,413,331,143,200,70,94,167,70
16421,2742,1293,1449,457,640,196,411,720,318
16422,47,19,28,2,13,4,8,14,6
16423,4168,1989,2179,659,1009,321,687,1052,440
16424,5141,2535,2606,707,1230,598,648,1234,724
16426,4006,2025,1981,708,1037,280,627,1043,311
16427,310,165,145,88,56,21,52,76,17
16428,14174,7026,7148,2727,3368,931,2559,3271,1318
16433,5615,2806,2809,829,1518,459,802,1384,623
16434,2909,1509,1400,749,597,163,605,625,170
16435,2225,1133,1092,402,575,156,380,563,149
16436,597,296,301,88,164,44,99,152,50
16438,8427,4219,4208,1463,2147,609,1338,2111,759
16440,926,464,462,159,250,55,158,234,70
16441,8913,4570,4343,1560,2449,561,1341,2356,646
16442,3081,1534,1547,546,836,152,553,809,185
16443,1469,742,727,260,376,106,228,374,125
16501,2981,1249,1732,519,486,244,719,413,600
16502,17034,8088,8946,2631,4496,961,2718,4455,1773
16503,18479,8950,9529,3955,4041,954,3701,4578,1250
16504,18116,8306,9810,3034,3909,1363,2854,4343,2613
16505,18101,8565,9536,2432,4461,1672,2379,4711,2446
16506,22483,10923,11560,3306,5693,1924,3108,5960,2492
16507,10224,5325,4899,1766,2780,779,1572,2457,870
16508,16005,7572,8433,2167,3973,1432,2124,4236,2073
16509,26392,12471,13921,3404,6490,2577,3403,6958,3560
16510,25274,12578,12696,4388,6430,1760,4003,6511,2182
16511,11660,5387,6273,1737,2547,1103,1736,2764,1773
16601,34171,16260,17911,5339,8343,2578,5479,8565,3867
16602,31157,14617,16540,4155,7620,2842,4209,8017,4314
16611,2682,1338,1344,412,725,201,368,718,258
16613,1753,883,870,303,456,124,293,433,144
16616,130,61,69,19,27,15,21,25,23
16617,3196,1456,1740,414,760,282,416,835,489
16619,308,167,141,69,74,24,38,75,28
16620,436,208,228,71,106,31,50,127,51
16621,727,380,347,118,193,69,102,190,55
16622,201,93,108,25,54,14,28,61,19
16623,421,192,229,42,107,43,65,105,59
16624,108,54,54,22,20,12,12,22,20
16625,3830,1824,2006,568,951,305,597,1006,403
16627,1976,946,1030,250,519,177,243,533,254
16630,4974,2362,2612,719,1217,426,719,1271,622
16631,189,93,96,38,49,6,36,44,16
16633,128,76,52,34,35,7,15,27,10
16634,178,91,87,24,54,13,19,42,26
16635,12947,6342,6605,1722,3220,1400,1627,3309,1669
16636,849,451,398,136,228,87,82,208,108
16637,1983,927,1056,263,526,138,350,485,221
16638,97,48,49,17,26,5,10,25,14
16639,1654,838,816,216,446,176,176,414,226
16640,830,399,431,117,199,83,120,221,90
16641,2838,1383,1455,420,760,203,404,712,339
16645,159,78,81,21,40,17,22,38,21
16646,2635,1262,1373,376,592,294,346,606,421
16647,729,364,365,118,180,66,91,206,68
16648,15343,7443,7900,2152,3855,1436,1831,3889,2180
16650,1718,856,862,261,467,128,243,423,196
16651,5299,3494,1805,756,2370,368,458,871,476
16652,17704,10129,7575,2535,6265,1329,2244,3491,1840
16655,1530,762,768,210,435,117,222,402,144
16656,1468,759,709,263,393,103,226,353,130
16657,1314,736,578,199,356,181,121,313,144
16659,347,161,186,64,74,23,57,104,25
16661,1079,518,561,148,254,116,144,272,145
16662,5720,2702,3018,836,1310,556,784,1342,892
16663,166,95,71,20,50,25,14,32,25
16664,1926,979,947,321,513,145,313,487,147
16665,245,127,118,43,72,12,31,63,24
16666,3062,1531,1531,464,730,337,332,770,429
16667,1403,707,696,212,374,121,221,329,146
16668,3924,1904,2020,594,964,346,546,976,498
16669,2206,1080,1126,294,605,181,323,589,214
16670,191,87,104,26,44,17,23,52,29
16671,505,250,255,62,121,67,66,111,78
16672,136,67,69,25,33,9,19,34,16
16673,4972,2474,2498,734,1271,469,601,1313,584
16674,741,383,358,107,199,77,93,175,90
16677,252,106,146,7,55,44,30,45,71
16678,3093,1454,1639,441,756,257,452,789,398
16679,1167,595,572,169,303,123,161,255,156
16680,511,256,255,76,126,54,69,106,80
16681,179,91,88,21,49,21,26,30,32
16682,139,67,72,24,32,11,21,25,26
16683,562,294,268,89,168,37,62,142,64
16685,300,158,142,55,72,31,41,70,31
16686,13149,6315,6834,1877,3274,1164,1781,3315,1738
16689,462,239,223,84,119,36,47,130,46
16691,341,182,159,54,89,39,46,69,44
16692,822,436,386,145,201,90,94,204,88
16693,4342,2173,2169,643,1132,398,625,1078,466
16694,142,65,77,11,38,16,25,32,20
16695,1113,547,566,182,274,91,194,252,120
16701,18525,8869,9656,2811,4445,1613,2740,4492,2424
16720,1391,685,706,194,371,120,205,368,133
16724,210,115,95,38,61,16,32,48,15
16725,231,127,104,26,56,45,10,45,49
16726,499,269,230,94,136,39,65,109,56
16727,273,122,151,40,70,12,65,62,24
16729,985,467,518,143,254,70,157,267,94
16730,296,136,160,45,69,22,53,77,30
16731,2927,1461,1466,461,709,291,403,741,322
16732,423,202,221,68,111,23,56,111,54
16733,370,194,176,56,98,40,33,99,44
16734,306,160,146,45,80,35,49,71,26
16735,6704,3239,3465,922,1663,654,875,1625,965
16738,2546,1977,569,189,1597,191,118,288,163
16740,1267,623,644,207,309,107,181,316,147
16743,4392,2186,2206,718,1077,391,642,1078,486
16744,283,141,142,42,62,37,35,69,38
16745,618,304,314,102,155,47,102,149,63
16746,1335,642,693,201,308,133,221,336,136
16748,3163,1521,1642,496,769,256,477,804,361
16749,4076,1995,2081,574,982,439,531,977,573
16750,522,264,258,85,133,46,88,141,29
16751,83,41,42,8,25,8,12,16,14
16801,39715,20361,19354,7458,10959,1944,8009,8526,2819
16802,9140,4704,4436,4257,447,0,4186,250,0
16803,19958,10224,9734,3132,6095,997,3058,5516,1160
16820,1080,528,552,179,249,100,188,244,120
16822,2053,1029,1024,297,554,178,272,522,230
16823,22881,12056,10825,3004,7418,1634,2938,5668,2219
16825,287,149,138,52,89,8,26,91,21
16826,938,464,474,141,249,74,134,250,90
16827,4120,2002,2118,676,1019,307,670,1086,362
16828,3795,1927,1868,534,1025,368,472,1031,365
16829,688,361,327,101,199,61,81,163,83
16830,14370,6951,7419,1865,3634,1452,1797,3514,2108
16832,411,212,199,61,117,34,56,109,34
16833,5312,2536,2776,717,1400,419,715,1376,685
16834,314,169,145,59,87,23,46,81,18
16836,1455,708,747,210,393,105,232,378,137
16837,199,75,124,9,42,24,22,57,45
16838,1910,955,955,280,505,170,275,465,215
16839,587,254,333,74,147,33,98,174,61
16840,467,244,223,55,126,63,40,80,103
16841,4529,2318,2211,657,1244,417,589,1156,466
16843,391,159,232,34,67,58,48,114,70
16844,2781,1425,1356,441,791,193,371,771,214
16845,969,597,372,179,343,75,91,190,91
16847,446,224,222,82,95,47,56,100,66
16848,423,203,220,57,103,43,54,110,56
16849,616,327,289,103,184,40,69,160,60
16851,847,418,429,154,233,31,137,269,23
16852,264,130,134,50,69,11,52,61,21
16853,1181,558,623,153,316,89,168,337,118
16854,861,402,459,113,204,85,128,228,103
16855,345,163,182,27,95,41,65,81,36
16856,59,19,40,0,11,8,3,24,13
16858,3810,1851,1959,539,982,330,548,1013,398
16859,537,286,251,80,145,61,63,137,51
16860,319,144,175,42,89,13,62,97,16
16861,273,153,120,45,69,39,22,67,31
16863,858,461,397,127,247,87,108,221,68
16864,74,35,39,9,18,8,11,17,11
16865,2045,994,1051,286,583,125,308,574,169
16866,8500,3964,4536,1046,2140,778,1107,2178,1251
16870,5114,2574,2540,866,1421,287,843,1380,317
16871,80,44,36,9,11,24,3,24,9
16872,1316,631,685,222,299,110,259,297,129
16874,1365,704,661,206,380,118,168,331,162
16875,3559,1801,1758,585,966,250,543,931,284
16876,323,148,175,41,82,25,53,92,30
16877,1624,837,787,285,455,97,245,428,114
16878,2561,1282,1279,350,721,211,395,632,252
16879,252,130,122,41,65,24,46,49,27
16881,2235,1052,1183,299,583,170,409,582,192
16882,377,196,181,81,80,35,61,85,35
16901,10220,4897,5323,1433,2463,1001,1407,2552,1364
16911,391,192,199,56,101,35,62,100,37
16912,1656,794,862,252,372,170,238,390,234
16914,2564,1264,1300,414,603,247,410,643,247
16915,6029,3028,3001,998,1437,593,764,1462,775
16917,1355,672,683,200,337,135,212,344,127
16918,129,64,65,13,38,13,11,36,18
16920,1785,850,935,244,410,196,231,433,271
16921,597,288,309,52,139,97,61,144,104
16922,2151,1018,1133,261,530,227,313,490,330
16923,1409,733,676,250,342,141,208,356,112
16925,3508,1737,1771,541,896,300,542,856,373
16926,801,426,375,157,198,71,106,202,67
16927,714,367,347,134,180,53,114,176,57
16928,1394,707,687,236,308,163,181,326,180
16929,2168,1086,1082,326,545,215,320,512,250
16930,1163,598,565,172,294,132,145,300,120
16932,694,341,353,110,179,52,92,190,71
16933,7231,3444,3787,1429,1540,475,1563,1655,569
16935,1266,646,620,215,296,135,184,305,131
16936,2422,1232,1190,363,643,226,346,606,238
16937,136,68,68,19,35,14,18,31,19
16938,808,415,393,103,189,123,101,170,122
16939,285,148,137,37,62,49,37,54,46
16940,604,298,306,94,150,54,81,165,60
16941,91,50,41,19,26,5,13,26,2
16942,881,432,449,138,216,78,134,233,82
16943,568,286,282,89,134,63,74,142,66
16946,2477,1223,1254,386,628,209,401,624,229
16947,5014,2265,2749,664,1157,444,664,1298,787
16948,1900,929,971,342,419,168,305,447,219
16950,2979,1454,1525,417,699,338,443,735,347
17002,776,382,394,141,192,49,154,164,76
17003,10328,4972,5356,1623,2555,794,1815,2557,984
17004,4735,2222,2513,842,958,422,861,982,670
17005,327,159,168,34,82,43,35,76,57
17006,1162,593,569,202,269,122,181,274,114
17007,5261,2630,2631,750,1448,432,721,1442,468
17009,1950,952,998,276,513,163,213,564,221
17010,228,104,124,20,74,10,26,74,24
17011,34547,17957,16590,4415,10135,3407,3522,8162,4906
17013,52236,25350,26886,7632,13309,4409,7415,13410,6061
17016,598,203,395,16,40,147,15,38,342
17017,1604,821,783,217,431,173,197,403,183
17018,4067,1942,2125,545,1095,302,529,1197,399
17019,15443,7622,7821,2346,4266,1010,2235,4419,1167
17020,8763,4364,4399,1296,2393,675,1183,2398,818
17021,1035,526,509,138,264,124,152,241,116
17022,26972,12748,14224,3968,6536,2244,4500,6673,3051
17023,3079,1494,1585,447,768,279,437,797,351
17024,1787,891,896,290,475,126,281,486,129
17025,13850,6662,7188,1981,3686,995,1942,3986,1260
17026,2948,1501,1447,499,799,203,457,763,227
17027,184,88,96,33,30,25,18,47,31
17028,3874,1995,1879,680,1082,233,600,1045,234
17029,111,50,61,10,25,15,13,35,13
17032,7618,3801,3817,1170,2036,595,1096,2043,678
17033,14929,7081,7848,1878,3637,1566,1756,3828,2264
17034,2747,1307,1440,325,789,193,357,775,308
17035,877,475,402,174,229,72,107,224,71
17036,18831,9145,9686,2859,5043,1243,2670,5379,1637
17037,1010,524,486,177,265,82,138,251,97
17038,6495,3266,3229,978,1739,549,944,1751,534
17040,2338,1213,1125,393,635,185,319,619,187
17041,261,130,131,49,60,21,51,64,16
17042,34124,16900,17224,4803,8867,3230,4233,8369,4622
17043,5646,2681,2965,693,1561,427,720,1612,633
17044,21916,10469,11447,2934,5374,2161,2774,5517,3156
17045,3234,1533,1701,456,786,291,462,881,358
17046,28369,13721,14648,4463,7228,2030,4298,7612,2738
17047,2402,1213,1189,490,562,161,395,582,212
17048,4351,2168,2183,657,1081,430,609,999,575
17049,3093,1558,1535,476,811,271,426,772,337
17051,4498,2226,2272,645,1119,462,602,1137,533
17052,1566,763,803,209,401,153,228,390,185
17053,4734,2297,2437,661,1278,358,628,1287,522
17055,58971,28094,30877,8824,14832,4438,8709,15679,6489
17057,21464,10136,11328,2941,5631,1564,2939,6022,2367
17058,1779,828,951,264,433,131,298,468,185
17059,7074,3437,3637,1012,1785,640,999,1757,881
17060,1260,646,614,245,319,82,199,299,116
17061,6907,3318,3589,944,1756,618,912,1688,989
17062,3703,1922,1781,631,1009,282,503,952,326
17063,3501,1752,1749,560,890,302,482,890,377
17064,600,327,273,67,181,79,30,168,75
17065,3723,1869,1854,568,1037,264,548,932,374
17066,5363,2494,2869,737,1270,487,781,1321,767
17067,12082,5859,6223,1830,2853,1176,1725,2832,1666
17068,3817,1881,1936,564,1050,267,573,1002,361
17069,109,55,54,10,35,10,10,37,7
17070,14381,6948,7433,1844,3978,1126,1806,4022,1605
17072,139,74,65,34,40,0,20,45,0
17073,4393,2135,2258,663,1133,339,730,1125,403
17074,7047,3457,3590,1077,1851,529,1040,1883,667
17075,276,131,145,47,61,23,52,63,30
17076,131,78,53,56,12,10,25,21,7
17077,237,119,118,57,40,22,45,44,29
17078,17927,8604,9323,2534,4515,1555,2077,4930,2316
17080,342,186,156,63,89,34,36,80,40
17081,117,48,69,0,39,9,7,47,15
17082,2971,1505,1466,494,770,241,414,752,300
17083,98,43,55,12,21,10,19,24,12
17084,4128,2052,2076,723,918,411,594,1028,454
17086,2426,1231,1195,408,606,217,336,571,288
17087,2641,1312,1329,438,665,209,381,693,255
17088,960,497,463,113,271,113,100,245,118
17090,5386,2703,2683,880,1539,284,791,1619,273
17093,462,253,209,64,148,41,55,117,37
17094,2329,1107,1222,292,604,211,329,597,296
17097,914,459,455,139,233,87,109,245,101
17098,2568,1285,1283,387,653,245,322,625,336
17099,1151,563,588,180,336,47,197,282,109
17101,1928,1096,832,99,719,278,60,381,391
17102,7977,4034,3943,862,2678,494,891,2151,901
17103,11923,5579,6344,2197,2738,644,2049,3311,984
17104,20098,9067,11031,3516,4644,907,3873,5649,1509
17109,23461,11120,12341,2873,6113,2134,2710,6256,3375
17110,22001,10343,11658,3261,5775,1307,3249,6467,1942
17111,27408,13259,14149,4061,7264,1934,3576,7678,2895
17112,30397,14854,15543,4294,8225,2335,4132,8456,2955
17113,11182,5440,5742,1793,2682,965,1532,2806,1404
17201,48443,23250,25193,6830,12091,4329,6843,12064,6286
17211,392,201,191,67,102,32,54,98,39
17212,655,343,312,111,192,40,84,175,53
17213,647,310,337,88,173,49,87,176,74
17214,1003,496,507,90,350,56,166,256,85
17215,299,141,158,39,84,18,43,68,47
17219,270,134,136,44,69,21,55,50,31
17220,668,349,319,97,196,56,74,171,74
17221,536,266,270,110,104,52,91,137,42
17222,8538,4189,4349,1238,1974,977,972,1997,1380
17223,388,194,194,53,98,43,54,96,44
17224,1731,840,891,255,424,161,280,438,173
17225,16260,8139,8121,2528,4429,1182,2224,4433,1464
17228,1052,534,518,157,272,105,153,271,94
17229,1409,705,704,227,337,141,215,354,135
17233,4671,2264,2407,688,1177,399,618,1192,597
17235,654,365,289,130,159,76,46,170,73
17236,7825,3897,3928,1076,2189,632,1147,2063,718
17237,1762,903,859,391,371,141,331,410,118
17238,1749,891,858,269,451,171,253,431,174
17239,239,119,120,48,59,12,45,55,20
17240,3174,1616,1558,578,808,230,540,744,274
17241,11338,5646,5692,1829,3014,803,1630,2934,1128
17243,1665,755,910,211,378,166,205,385,320
17244,2596,1334,1262,435,690,209,390,650,222
17249,417,202,215,55,106,41,67,89,59
17252,3189,1509,1680,369,862,278,497,789,394
17253,322,155,167,47,78,30,47,76,44
17254,97,58,39,0,47,11,0,27,12
17255,1018,535,483,156,278,101,134,256,93
17257,23309,11347,11962,4570,5285,1492,4847,5170,1945
17260,850,417,433,127,213,77,141,193,99
17262,1449,683,766,249,331,103,286,347,133
17264,2347,1155,1192,303,603,249,344,565,283
17265,212,101,111,24,60,17,34,61,16
17266,557,276,281,82,154,40,63,162,56
17267,2611,1321,1290,399,702,220,367,679,244
17268,25760,12214,13546,3419,6400,2395,3773,6481,3292
17270,80,36,44,9,27,0,5,39,0
17271,517,276,241,77,148,51,53,134,54
17301,3398,1717,1681,539,954,224,474,932,275
17302,2620,1364,1256,472,739,153,397,686,173
17304,2550,1270,1280,445,678,147,434,698,148
17306,577,293,284,105,132,56,110,116,58
17307,5417,2783,2634,845,1460,478,718,1395,521
17309,2029,1009,1020,294,588,127,259,603,158
17311,606,313,293,108,155,50,70,162,61
17313,9676,4791,4885,1447,2599,745,1272,2538,1075
17314,5820,2944,2876,1010,1595,339,958,1530,388
17315,22878,11457,11421,3461,6362,1634,3127,6339,1955
17316,6824,3378,3446,1097,1814,467,1055,1903,488
17317,780,427,353,167,209,51,92,187,74
17318,196,112,84,8,80,24,7,50,27
17319,9816,4811,5005,1615,2787,409,1640,2868,497
17320,6842,3417,3425,1020,1843,554,965,1896,564
17321,2047,1024,1023,320,535,169,306,568,149
17322,5455,2775,2680,848,1550,377,791,1529,360
17324,4228,2128,2100,658,1139,331,529,1166,405
17325,25717,12457,13260,4075,6138,2244,4050,6083,3127
17327,7113,3584,3529,1115,1831,638,962,1831,736
17329,2369,1188,1181,398,645,145,362,678,141
17331,43871,21503,22368,6367,11569,3567,5920,11576,4872
17339,5626,2804,2822,848,1556,400,738,1606,478
17340,9795,4774,5021,1576,2421,777,1603,2557,861
17343,84,46,38,7,25,14,6,19,13
17344,3266,1456,1810,326,866,264,446,903,461
17345,6852,3382,3470,1011,1950,421,974,2009,487
17347,4342,2213,2129,635,1201,377,533,1158,438
17349,6776,3361,3415,999,1907,455,976,1940,499
17350,11950,5815,6135,1846,3017,952,1754,3059,1322
17352,1188,594,594,190,327,77,172,321,101
17353,3199,1670,1529,545,900,225,424,854,251
17355,300,140,160,39,88,13,70,76,14
17356,18373,8982,9391,2722,4897,1363,2832,4915,1644
17360,4640,2315,2325,748,1243,324,685,1258,382
17361,4809,2324,2485,709,1232,383,632,1276,577
17362,11516,5769,5747,1794,3121,854,1649,3171,927
17363,8468,4234,4234,1451,2351,432,1333,2342,559
17364,3557,1818,1739,585,957,276,492,990,257
17365,2779,1443,1336,426,817,200,395,743,198
17366,4738,2293,2445,737,1332,224,851,1276,318
17368,6905,3414,3491,998,1932,484,957,1962,572
17370,5039,2579,2460,833,1484,262,751,1390,319
17372,3643,1912,1731,586,1055,271,459,977,295
17401,961,578,383,117,398,63,122,226,35
17402,43349,21310,22039,5769,11220,4321,5159,11129,5751
17403,42633,20159,22474,6822,9925,3412,7069,10277,5128
17404,57712,27660,30052,8562,14768,4330,8074,15377,6601
17406,6238,3102,3136,810,1766,526,789,1759,588
17407,1692,797,895,220,454,123,252,454,189
17501,4566,2199,2367,573,1124,502,554,1115,698
17502,2434,1239,1195,385,701,153,369,673,153
17505,1441,651,790,249,284,118,326,319,145
17508,179,75,104,26,41,8,28,58,18
17509,4704,2317,2387,1018,1046,253,949,1034,404
17512,17403,8221,9182,2559,4305,1357,2583,4469,2130
17516,4583,2344,2239,754,1292,298,713,1193,333
17517,13967,6968,6999,2375,3596,997,2275,3569,1155
17518,1159,614,545,233,304,77,198,283,64
17519,5385,2748,2637,1213,1151,384,1027,1161,449
17520,4806,2369,2437,787,1227,355,668,1304,465
17522,29235,14285,14950,4787,7252,2246,4486,7476,2988
17527,5610,2812,2798,1079,1384,349,963,1401,434
17529,4638,2288,2350,1018,948,322,1022,979,349
17532,3280,1648,1632,546,929,173,596,854,182
17535,2181,1086,1095,456,509,121,470,480,145
17536,2529,1281,1248,521,577,183,480,578,190
17538,6399,3288,3111,1163,1725,400,873,1719,519
17540,9281,4710,4571,1826,2222,662,1578,2235,758
17543,36616,17783,18833,5999,9026,2758,5328,9495,4010
17545,19203,9413,9790,2899,4745,1769,2859,4801,2130
17547,6018,3002,3016,1074,1596,332,899,1696,421
17551,9590,4459,5131,1931,1860,668,2347,1828,956
17552,14340,7174,7166,2290,3967,917,2089,3953,1124
17554,5390,2594,2796,775,1461,358,703,1615,478
17555,6860,3454,3406,1383,1588,483,1246,1581,579
17557,12943,6244,6699,2118,2976,1150,2283,2963,1453
17560,4758,2419,2339,817,1217,385,613,1296,430
17562,3921,2037,1884,847,956,234,755,863,266
17563,3642,1802,1840,694,871,237,727,876,237
17565,2366,1282,1084,459,651,172,323,605,156
17566,10681,5158,5523,2011,2399,748,1925,2533,1065
17569,4997,2416,2581,728,1344,344,877,1353,351
17570,327,152,175,50,72,30,79,71,25
17572,3578,1826,1752,707,821,298,577,776,399
17576,74,41,33,0,9,32,0,9,24
17578,7023,3425,3598,1210,1767,448,1200,1804,594
17579,5607,2752,2855,977,1371,404,911,1458,486
17581,991,494,497,177,255,62,138,273,86
17582,2121,1046,1075,396,525,125,305,586,184
17584,8718,4249,4469,1394,1898,957,1253,1963,1253
17601,45610,21924,23686,6239,11377,4308,5937,12075,5674
17602,46515,22822,23693,8016,11604,3202,7206,11577,4910
17603,57572,27570,30002,8926,14337,4307,8621,15257,6124
17701,46537,22714,23823,8048,10916,3750,6797,11131,5895
17702,10837,5314,5523,1591,2698,1025,1460,2711,1352
17721,1482,723,759,213,370,140,219,366,174
17724,5051,2520,2531,837,1181,502,675,1252,604
17728,5492,2754,2738,858,1459,437,832,1409,497
17729,112,61,51,4,23,34,12,21,18
17730,259,106,153,52,54,0,38,94,21
17731,318,159,159,26,70,63,17,84,58
17737,5942,2934,3008,913,1515,506,793,1554,661
17738,140,69,71,15,36,18,10,35,26
17739,19,13,6,2,8,3,2,4,0
17740,13217,6412,6805,2044,3293,1075,2071,3413,1321
17742,73,35,38,4,24,7,12,21,5
17744,3283,1645,1638,484,876,285,450,889,299
17745,18351,8585,9766,2671,4257,1657,3180,4224,2362
17747,2698,1384,1314,488,683,213,436,627,251
17748,141,75,66,28,41,6,23,39,4
17749,313,146,167,45,73,28,49,84,34
17750,113,46,67,17,20,9,24,27,16
17751,6752,3374,3378,1045,1714,615,883,1748,747
17752,5700,3256,2444,781,2069,406,753,1225,466
17754,12116,5747,6369,1682,2817,1248,1671,2926,1772
17756,11941,5385,6556,1626,2786,973,1483,3789,1284
17758,1016,520,496,155,247,118,112,255,129
17760,443,201,242,46,107,48,61,115,66
17762,695,340,355,109,174,57,103,183,69
17763,250,103,147,22,50,31,40,75,32
17764,2730,1315,1415,381,630,304,337,649,429
17765,990,524,466,164,266,94,123,252,91
17767,51,15,36,0,11,4,3,12,21
17768,327,154,173,39,75,40,54,81,38
17771,3515,1810,1705,527,987,296,471,935,299
17772,2274,1102,1172,350,597,155,351,612,209
17774,1163,599,564,194,300,105,156,289,119
17776,501,251,250,41,132,78,48,112,90
17777,6730,3243,3487,914,1708,621,994,1736,757
17778,173,91,82,20,42,29,20,47,15
17801,17326,8182,9144,2242,4465,1475,2527,4466,2151
17810,5810,4781,1029,417,4096,268,331,545,153
17812,1334,627,707,170,337,120,194,343,170
17813,1856,900,956,263,485,152,257,509,190
17814,4390,2207,2183,613,1147,447,538,1100,545
17815,28374,13257,15117,4631,6477,2149,5578,6581,2958
17820,5455,2688,2767,748,1410,530,690,1417,660
17821,18570,8812,9758,2657,4446,1709,2460,4841,2457
17823,1187,604,583,191,295,118,151,313,119
17824,3997,1937,2060,507,1011,419,511,998,551
17825,54,9,45,0,5,4,23,15,7
17827,697,328,369,89,175,64,82,181,106
17829,171,84,87,33,37,14,31,36,20
17830,2058,1012,1046,281,545,186,291,484,271
17832,737,368,369,79,214,75,67,184,118
17833,337,153,184,53,71,29,66,83,35
17834,3484,1668,1816,433,846,389,398,816,602
17835,271,133,138,36,79,18,55,60,23
17836,292,153,139,43,72,38,31,74,34
17837,17622,9227,8395,3155,4722,1350,2903,3304,2188
17840,446,231,215,105,88,38,55,126,34
17841,4757,2385,2372,765,1250,370,728,1225,419
17842,7497,3716,3781,1120,2048,548,1103,2021,657
17844,9502,4748,4754,1641,2427,680,1468,2418,868
17845,2163,1062,1101,326,529,207,357,515,229
17846,3755,1819,1936,557,919,343,521,942,473
17847,11442,5615,5827,1700,2787,1128,1411,2878,1538
17850,649,365,284,139,168,58,69,153,62
17851,8144,3760,4384,970,1861,929,907,1830,1647
17853,2879,1496,1383,578,731,187,437,706,240
17855,939,456,483,137,239,80,133,245,105
17856,3576,1816,1760,542,971,303,443,997,320
17857,7440,3557,3883,942,1836,779,860,1943,1080
17859,2697,1309,1388,335,720,254,319,729,340
17860,1300,679,621,165,378,136,146,318,157
17861,242,95,147,28,56,11,56,52,39
17862,669,322,347,138,147,37,123,172,52
17864,2542,1315,1227,550,621,144,476,579,172
17865,122,64,58,26,27,11,11,29,18
17866,10525,5905,4620,1315,3522,1068,937,1990,1693
17867,136,71,65,28,25,18,17,27,21
17868,1119,543,576,155,280,108,112,317,147
17870,15405,7379,8026,2242,3815,1322,2603,3632,1791
17872,9999,4750,5249,1375,2382,993,1305,2390,1554
17878,1258,604,654,167,309,128,158,285,211
17881,2013,1014,999,290,496,228,223,468,308
17882,135,69,66,23,32,14,12,43,11
17884,287,143,144,51,79,13,52,75,17
17885,143,59,84,16,31,12,27,31,26
17886,651,300,351,84,147,69,79,172,100
17887,252,111,141,23,66,22,14,73,54
17888,419,201,218,34,122,45,49,100,69
17889,2625,1318,1307,391,725,202,400,674,233
17901,26478,13368,13110,3424,7537,2407,3219,6267,3624
17920,237,105,132,18,51,36,21,70,41
17921,6555,3173,3382,823,1665,685,767,1588,1027
17922,4482,2281,2201,742,1157,382,588,1190,423
17923,513,235,278,71,108,56,91,117,70
17925,346,170,176,27,86,57,25,88,63
17927,10,8,2,0,2,6,0,0,2
17929,1575,759,816,204,433,122,228,401,187
17930,379,195,184,57,107,31,30,96,58
17931,8608,5647,2961,1054,3905,688,542,1367,1052
17933,63,33,30,0,26,7,6,11,13
17934,494,253,241,68,129,56,56,125,60
17935,2127,989,1138,256,550,183,269,519,350
17936,781,401,380,130,195,76,121,173,86
17938,2300,1114,1186,321,558,235,282,555,349
17941,701,342,359,108,168,66,95,179,85
17943,197,87,110,15,42,30,14,52,44
17944,160,82,78,18,37,27,22,38,18
17945,162,81,81,31,39,11,28,36,17
17946,188,92,96,13,61,18,18,58,20
17948,5711,2738,2973,730,1311,697,692,1227,1054
17949,373,174,199,43,92,39,68,82,49
17951,359,220,139,92,96,32,22,75,42
17952,276,122,154,20,73,29,27,63,64
17953,454,223,231,71,106,46,62,106,63
17954,4674,2180,2494,657,1043,480,544,1113,837
17957,274,133,141,34,72,27,29,79,33
17959,1625,798,827,215,391,192,158,402,267
17960,3098,1573,1525,420,893,260,411,833,281
17961,6655,3109,3546,842,1678,589,901,1731,914
17963,8939,4421,4518,1293,2309,819,1192,2294,1032
17964,732,385,347,105,200,80,87,165,95
17965,2271,1090,1181,305,534,251,271,566,344
17967,2580,1268,1312,344,682,242,354,645,313
17968,412,233,179,68,109,56,41,92,46
17970,3555,1653,1902,360,854,439,352,875,675
17972,10947,5364,5583,1434,2801,1129,1493,2654,1436
17974,283,128,155,19,84,25,30,59,66
17976,7887,3628,4259,867,1885,876,978,1746,1535
17978,336,165,171,43,93,29,39,88,44
17979,212,93,119,15,43,35,39,51,29
17980,3176,1540,1636,418,827,295,425,778,433
17981,2717,1304,1413,345,668,291,345,625,443
17982,458,228,230,61,113,54,50,103,77
17983,1608,829,779,226,439,164,168,396,215
17985,1055,536,519,147,292,97,128,280,111
18011,4836,2380,2456,715,1401,264,751,1377,328
18012,86,52,34,20,25,7,0,25,9
18013,16710,8331,8379,2571,4342,1418,2253,4183,1943
18014,11399,5673,5726,1456,3109,1108,1363,3086,1277
18015,30943,15542,15401,6526,7128,1888,5424,7464,2513
18017,35223,16617,18606,4781,8149,3687,4445,8948,5213
18018,31144,14619,16525,3984,7825,2810,4127,7929,4469
18020,18723,9005,9718,2820,4746,1439,2786,4814,2118
18030,895,441,454,112,247,82,110,242,102
18031,3396,1575,1821,345,856,374,454,889,478
18032,9336,4515,4821,1417,2439,659,1252,2583,986
18034,6275,3084,3191,1125,1427,532,1176,1460,555
18035,67,27,40,0,27,0,20,20,0
18036,12161,6126,6035,1867,3347,912,1621,3280,1134
18037,7153,3557,3596,1076,1897,584,880,1881,835
18038,3459,1780,1679,606,989,185,536,913,230
18040,9101,4501,4600,1382,2454,665,1375,2408,817
18041,5537,2714,2823,892,1444,378,879,1534,410
18042,39450,19243,20207,6418,10256,2569,6621,9774,3812
18045,21104,10046,11058,2665,5233,2148,2622,5630,2806
18049,17406,8422,8984,2261,4547,1614,2243,4642,2099
18051,3422,1643,1779,429,986,228,504,1015,260
18052,25063,11878,13185,3023,6565,2290,3278,6594,3313
18053,2307,1168,1139,384,594,190,278,650,211
18054,4039,1983,2056,554,1107,322,583,1087,386
18055,10300,4850,5450,1224,2581,1045,1280,2843,1327
18056,808,423,385,109,218,96,76,209,100
18058,7783,3872,3911,1190,2034,648,1114,1954,843
18059,1293,620,673,264,323,33,264,343,66
18062,14004,7037,6967,2138,3677,1222,1789,3751,1427
18063,520,241,279,63,119,59,41,144,94
18064,21445,10350,11095,3169,5304,1877,2690,5493,2912
18066,4835,2492,2343,811,1364,317,704,1304,335
18067,15770,7719,8051,2138,4168,1413,1905,4270,1876
18069,6291,3103,3188,1150,1473,480,1030,1672,486
18070,850,472,378,156,247,69,111,225,42
18071,10078,4920,5158,1471,2623,826,1410,2646,1102
18072,6531,3172,3359,1037,1592,543,933,1684,742
18073,6883,3372,3511,971,1915,486,1019,1828,664
18074,5786,2881,2905,863,1576,442,788,1576,541
18076,2432,1167,1265,384,580,203,337,610,318
18077,2607,1352,1255,395,753,204,269,743,243
18078,6212,2988,3224,832,1630,526,822,1787,615
18079,277,142,135,57,85,0,40,58,37
18080,11812,5856,5956,1822,3215,819,1631,3276,1049
18081,139,54,85,21,27,6,17,54,14
18083,564,260,304,78,140,42,89,154,61
18085,931,438,493,122,248,68,125,268,100
18086,175,98,77,21,55,22,11,51,15
18087,718,355,363,124,175,56,74,216,73
18088,7222,3555,3667,963,1906,686,880,1928,859
18091,5544,2686,2858,800,1462,424,737,1527,594
18092,2828,1410,1418,407,779,224,395,755,268
18101,3853,2339,1514,687,1502,150,499,819,196
18102,42818,20620,22198,7572,10654,2394,7481,10796,3921
18103,59418,28725,30693,8422,15233,5070,7908,16074,6711
18104,39911,17917,21994,5046,8909,3962,5881,9669,6444
18106,6468,2975,3493,860,1545,570,901,1684,908
18201,35544,16604,18940,4757,8314,3533,4461,8470,6009
18210,4399,2264,2135,777,1041,446,626,1062,447
18211,1342,695,647,204,401,90,151,370,126
18214,2088,997,1091,267,566,164,294,605,192
18216,1331,635,696,149,348,138,181,299,216
18218,2329,1054,1275,280,454,320,305,511,459
18219,1647,790,857,260,360,170,203,428,226
18220,386,211,175,54,110,47,47,74,54
18221,411,241,170,71,112,58,34,77,59
18222,7144,3638,3506,1247,1813,578,1001,1756,749
18224,5756,2678,3078,671,1367,640,699,1396,983
18225,112,66,46,36,12,18,14,22,10
18229,7007,3390,3617,973,1815,602,894,1920,803
18230,47,23,24,7,13,3,5,9,10
18231,496,230,266,51,110,69,67,103,96
18232,4230,1946,2284,565,947,434,584,944,756
18234,460,221,239,62,89,70,68,101,70
18235,18282,8915,9367,2396,4738,1781,2254,4697,2416
18237,3190,1537,1653,389,787,361,355,767,531
18239,125,56,69,11,28,17,32,37,0
18240,3801,1879,1922,439,997,443,399,879,644
18241,735,377,358,116,191,70,75,185,98
18242,149,68,81,12,35,21,10,30,41
18244,473,248,225,65,143,40,53,117,55
18245,742,345,397,149,131,65,156,120,121
18246,343,181,162,93,74,14,41,76,45
18248,627,319,308,77,179,63,55,142,111
18249,3591,1773,1818,473,965,335,489,956,373
18250,3060,1507,1553,415,806,286,383,746,424
18251,94,39,55,9,26,4,18,22,15
18252,11324,5412,5912,1377,2767,1268,1352,2730,1830
18254,880,421,459,114,203,104,98,203,158
18255,4375,2085,2290,576,1038,471,610,997,683
18256,396,202,194,49,95,58,26,110,58
18301,35880,17652,18228,6476,8877,2299,6323,9114,2791
18321,1601,809,792,277,436,96,218,418,156
18322,2293,1091,1202,390,501,200,316,589,297
18323,69,45,24,15,18,12,0,18,6
18324,7173,3572,3601,1180,1895,497,1127,1944,530
18325,2060,1042,1018,227,484,331,237,543,238
18326,4153,1954,2199,658,976,320,591,1111,497
18327,745,351,394,97,207,47,75,253,66
18328,6739,3287,3452,1059,1809,419,1245,1719,488
18330,7496,3729,3767,1295,1934,500,1386,1890,491
18331,422,223,199,53,135,35,15,126,58
18332,1941,919,1022,299,509,111,394,495,133
18333,690,304,386,95,161,48,140,177,69
18334,2686,1342,1344,418,760,164,463,731,150
18336,3941,1887,2054,603,891,393,535,1007,512
18337,11573,5705,5868,1959,2824,922,1780,3048,1040
18340,171,78,93,24,44,10,29,38,26
18341,224,99,125,35,40,24,73,24,28
18343,3488,1659,1829,447,907,305,486,907,436
18344,3294,1617,1677,519,852,246,477,856,344
18346,2002,1032,970,302,570,160,221,552,197
18347,2903,1499,1404,421,676,402,301,676,427
18349,143,79,64,23,56,0,21,33,10
18350,1586,749,837,201,325,223,239,486,112
18351,572,271,301,71,148,52,85,139,77
18353,11211,5591,5620,1797,3032,762,1807,2987,826
18354,1167,579,588,184,316,79,175,344,69
18355,1647,823,824,266,419,138,170,473,181
18356,131,62,69,0,42,20,9,48,12
18357,119,53,66,6,47,0,15,51,0
18360,26634,13252,13382,3896,7056,2300,3656,6776,2950
18370,890,455,435,118,222,115,101,249,85
18372,2924,1449,1475,482,703,264,495,748,232
18403,6526,3239,3287,1041,1629,569,809,1663,815
18405,2169,1143,1026,388,520,235,274,509,243
18407,14592,6663,7929,1984,3278,1401,1903,3574,2452
18411,22021,10721,11300,3407,5347,1967,3164,5676,2460
18413,211,98,113,34,48,16,32,59,22
18414,5390,2715,2675,839,1454,422,746,1426,503
18415,1241,631,610,197,281,153,150,290,170
18417,1208,634,574,189,307,138,176,254,144
18419,4552,2180,2372,755,1137,288,829,1142,401
18420,292,146,146,45,82,19,34,83,29
18421,4915,2397,2518,725,1134,538,583,1141,794
18424,4718,2427,2291,728,1233,466,598,1237,456
18425,1184,579,605,182,248,149,158,295,152
18426,3986,2031,1955,534,911,586,440,930,585
18428,9848,4891,4957,1235,2316,1340,1290,2259,1408
18430,52,32,20,10,14,8,2,14,4
18431,13102,6243,6859,1941,3076,1226,1780,3249,1830
18433,6634,3213,3421,911,1689,613,923,1653,845
18434,4107,1918,2189,489,982,447,426,1044,719
18435,426,201,225,45,117,39,78,94,53
18436,12055,5935,6120,1768,2897,1270,1590,3113,1417
18437,215,112,103,26,55,31,24,51,28
18438,986,489,497,111,240,138,118,218,161
18439,598,297,301,73,142,82,55,156,90
18441,216,109,107,38,51,20,41,45,21
18443,442,201,241,64,102,35,103,97,41
18444,12621,6233,6388,1950,3329,954,1774,3320,1294
18445,1937,956,981,296,440,220,295,468,218
18446,3638,1828,1810,575,985,268,515,975,320
18447,9578,4568,5010,1173,2510,885,1056,2449,1505
18451,257,148,109,48,66,34,23,62,24
18452,5511,2476,3035,653,1145,678,667,1203,1165
18453,1129,568,561,189,280,99,150,280,131
18455,79,42,37,13,24,5,8,21,8
18456,461,218,243,65,105,48,57,119,67
18457,78,29,49,0,18,11,19,22,8
18458,2220,1100,1120,282,565,253,297,552,271
18459,111,65,46,23,37,5,17,21,8
18460,297,138,159,35,76,27,29,72,58
18461,482,263,219,72,125,66,46,109,64
18462,449,226,223,56,113,57,51,118,54
18464,946,479,467,111,234,134,101,234,132
18465,1547,771,776,224,361,186,232,364,180
18466,12180,5885,6295,2296,2834,755,2293,3150,852
18469,249,93,156,31,53,9,57,82,17
18470,2185,1095,1090,301,574,220,323,552,215
18471,643,302,341,117,137,48,105,167,69
18472,5051,3020,2031,598,2000,422,528,942,561
18473,628,301,327,94,164,43,89,167,71
18503,1133,646,487,88,402,156,95,166,226
18504,22244,10308,11936,3045,5248,2015,3079,5548,3309
18505,20199,9427,10772,2733,4613,2081,2581,4830,3361
18507,5506,2636,2870,683,1333,620,602,1300,968
18508,11497,5363,6134,1610,2759,994,1613,2931,1590
18509,13783,6280,7503,1894,3256,1130,2100,3200,2203
18510,13733,6256,7477,2270,2969,1017,2867,2753,1857
18512,12827,6059,6768,1721,2949,1389,1569,3127,2072
18517,5310,2542,2768,690,1337,515,515,1352,901
18518,8798,4065,4733,979,2175,911,1052,2161,1520
18519,5462,2544,2918,712,1288,544,654,1422,842
18601,262,112,150,46,52,14,59,80,11
18602,236,109,127,17,62,30,32,62,33
18603,19470,9180,10290,2516,4801,1863,2694,4863,2733
18610,3512,1780,1732,655,945,180,598,898,236
18611,97,50,47,15,32,3,13,27,7
18612,16645,8744,7901,2102,5207,1435,2135,3677,2089
18614,2521,1249,1272,325,579,345,326,608,338
18615,1742,926,816,293,474,159,185,448,183
18616,735,384,351,87,184,113,82,143,126
18617,1912,859,1053,256,457,146,315,465,273
18618,3959,1974,1985,593,1095,286,533,1076,376
18619,280,143,137,26,80,37,31,60,46
18621,6019,3505,2514,989,2122,394,691,1348,475
18622,279,149,130,40,75,34,38,67,25
18623,2757,1345,1412,466,673,206,416,710,286
18624,352,180,172,27,101,52,19,102,51
18625,238,113,125,32,55,26,27,67,31
18626,310,119,191,24,62,33,35,53,103
18628,505,326,179,192,72,62,106,35,38
18629,1659,830,829,254,452,124,234,451,144
18630,3290,1694,1596,597,817,280,481,838,277
18631,1168,574,594,151,300,123,130,312,152
18632,421,202,219,50,97,55,54,104,61
18634,14134,6704,7430,1638,3489,1577,1553,3334,2543
18635,3901,1876,2025,526,1035,315,596,1042,387
18636,1443,702,741,193,404,105,201,380,160
18640,18012,8367,9645,2328,4297,1742,2190,4526,2929
18641,6228,2938,3290,744,1574,620,653,1573,1064
18642,4161,1977,2184,470,1056,451,498,1061,625
18643,13606,6291,7315,1812,3223,1256,1715,3514,2086
18644,7666,3611,4055,993,1828,790,935,1898,1222
18651,9733,4670,5063,1427,2361,882,1349,2324,1390
18653,125,62,63,16,32,14,21,33,9
18655,6628,3263,3365,891,1713,659,832,1744,789
18656,2202,1144,1058,323,658,163,318,579,161
18657,12425,6086,6339,1837,3269,980,1708,3286,1345
18660,3324,1677,1647,495,895,287,453,850,344
18661,5860,3049,2811,800,1652,597,696,1461,654
18701,3612,1739,1873,719,650,370,613,365,895
18702,50795,24620,26175,7058,12672,4890,6497,12059,7619
18704,32706,15117,17589,4212,7695,3210,3891,8283,5415
18705,15433,7300,8133,1843,3754,1703,1692,3877,2564
18706,7652,3641,4011,1036,1880,725,943,2049,1019
18707,14249,7004,7245,2208,3668,1128,2060,3784,1401
18708,8584,4235,4349,1266,2311,658,1089,2337,923
18709,3004,1437,1567,347,757,333,319,730,518
18801,8483,4185,4298,1241,2159,785,1186,2116,996
18810,6253,2964,3289,1027,1451,486,952,1645,692
18812,1760,876,884,279,447,150,276,482,126
18813,153,62,91,17,31,14,25,35,31
18814,179,112,67,39,53,20,21,40,6
18816,179,98,81,34,41,23,24,34,23
18817,328,161,167,48,79,34,45,77,45
18818,1202,612,590,186,333,93,184,319,87
18820,93,53,40,20,27,6,15,22,3
18821,1198,578,620,175,303,100,167,283,170
18822,3458,1703,1755,548,858,297,481,905,369
18823,231,110,121,48,49,13,28,59,34
18824,1173,611,562,197,299,115,160,289,113
18825,213,116,97,37,61,18,23,51,23
18826,1771,901,870,247,444,210,277,408,185
18827,163,78,85,28,40,10,33,44,8
18828,179,84,95,23,47,14,34,46,15
18829,798,400,398,152,189,59,126,200,72
18830,800,416,384,105,246,65,103,216,65
18831,1126,548,578,188,284,76,186,282,110
18832,1726,823,903,274,427,122,314,445,144
18833,1885,984,901,281,492,211,240,445,216
18834,3461,1776,1685,588,893,295,490,886,309
18837,3387,1674,1713,540,847,287,538,836,339
18839,170,86,84,24,54,8,26,38,20
18840,10739,5071,5668,1492,2572,1007,1456,2735,1477
18842,197,108,89,35,56,17,23,51,15
18844,1637,838,799,266,435,137,238,404,157
18845,414,201,213,56,101,44,66,104,43
18846,883,452,431,147,222,83,128,237,66
18847,5627,2731,2896,849,1296,586,818,1404,674
18848,9330,4606,4724,1435,2299,872,1225,2393,1106
18850,2009,1006,1003,279,544,183,283,546,174
18851,731,395,336,128,187,80,84,180,72
18853,4040,1964,2076,567,1042,355,595,1021,460
18854,1494,751,743,256,382,113,203,410,130
18901,47103,22485,24618,7122,11993,3370,6715,12639,5264
18914,17877,8873,9004,2904,4840,1129,2649,5022,1333
18915,795,457,338,135,253,69,62,226,50
18917,2083,1020,1063,315,609,96,333,590,140
18920,530,283,247,85,139,59,47,144,56
18923,354,175,179,53,86,36,40,114,25
18925,3001,1445,1556,420,767,258,450,816,290
18927,193,128,65,47,57,24,16,26,23
18929,7965,3938,4027,1445,2136,357,1497,2198,332
18930,2507,1275,1232,369,726,180,394,667,171
18932,452,214,238,68,101,45,76,113,49
18936,33,27,6,9,12,6,0,0,6
18938,13146,6471,6675,1249,3767,1455,1483,3500,1692
18940,26996,13004,13992,4257,7333,1414,4296,7848,1848
18942,3820,1966,1854,546,1107,313,508,1049,297
18944,21046,10495,10551,3502,5612,1381,3239,5693,1619
18947,6309,3264,3045,1184,1652,428,1071,1598,376
18951,31212,15375,15837,4713,8426,2236,4635,8180,3022
18954,10405,5137,5268,1919,2679,539,1664,2912,692
18955,1202,550,652,153,277,120,144,315,193
18960,11446,5695,5751,1944,2947,804,1650,3007,1094
18962,452,242,210,80,135,27,57,124,29
18964,12457,5980,6477,1726,3121,1133,1620,3126,1731
18966,39649,19089,20560,5842,9984,3263,5637,10677,4246
18969,14911,7316,7595,2463,3895,958,2161,4137,1297
18970,162,79,83,30,41,8,30,41,12
18972,3592,1877,1715,520,1053,304,357,1006,352
18974,37405,18395,19010,5764,9528,3103,5269,9647,4094
18976,15827,7975,7852,2725,4394,856,2466,4267,1119
18977,3823,1907,1916,545,1084,278,556,1076,284
18980,298,161,137,46,80,35,42,78,17
19001,17148,8345,8803,2689,4196,1460,2349,4492,1962
19002,30754,14582,16172,4590,7408,2584,4415,8226,3531
19003,12994,5895,7099,1536,3442,917,1842,3836,1421
19004,9336,4544,4792,1214,2265,1065,1162,2366,1264
19006,20408,9783,10625,2749,4646,2388,2613,4824,3188
19007,22055,10518,11537,3406,5497,1615,3461,5738,2338
19008,20522,9735,10787,2730,4711,2294,2629,4974,3184
19009,70,36,34,5,16,15,11,16,7
19010,21603,9305,12298,2850,4664,1791,4008,5333,2957
19012,6628,3231,3397,1076,1637,518,912,1779,706
19013,38785,18119,20666,7283,8507,2329,7353,9584,3729
19014,20899,10060,10839,3130,5472,1458,3160,5682,1997
19015,16531,7836,8695,2403,4169,1264,2404,4448,1843
19018,23363,11307,12056,3360,6134,1813,3024,6303,2729
19020,53604,26641,26963,7583,15799,3259,7181,15343,4439
19021,10138,5179,4959,1533,2946,700,1431,2783,745
19022,3856,1955,1901,693,1033,229,578,959,364
19023,21400,10060,11340,3925,4799,1336,3734,5548,2058
19025,5360,2565,2795,820,1367,378,896,1474,425
19026,32166,15219,16947,4462,8369,2388,4517,8805,3625
19027,19327,9055,10272,2680,4766,1609,2662,5568,2042
19029,4201,2134,2067,646,1136,352,509,1101,457
19030,13612,6522,7090,1956,3678,888,1996,3740,1354
19031,4721,2113,2608,640,1035,438,549,1201,858
19032,6884,3331,3553,1083,1702,546,1084,1712,757
19033,8429,3921,4508,1225,1913,783,1219,2197,1092
19034,5902,2900,3002,981,1394,525,765,1526,711
19035,4062,1858,2204,499,783,576,534,905,765
19036,13739,6403,7336,1869,3452,1082,2022,3612,1702
19038,31972,15032,16940,4707,7665,2660,4533,8345,4062
19040,20399,9853,10546,2887,5081,1885,2664,5112,2770
19041,6790,3022,3768,1115,1153,754,1161,1519,1088
19043,2976,1421,1555,410,762,249,393,792,370
19044,16824,8230,8594,2499,4898,833,2635,4994,965
19046,18840,8573,10267,2212,4056,2305,2085,4789,3393
19047,32492,15848,16644,5223,8757,1868,5004,8882,2758
19050,28664,13408,15256,4241,7212,1955,3903,8291,3062
19053,24712,12083,12629,3382,6646,2055,3255,6876,2498
19054,17627,8509,9118,2585,4694,1230,2836,4584,1698
19055,14199,6938,7261,2176,3751,1011,2088,3761,1412
19056,15304,7773,7531,2672,3960,1141,1999,3894,1638
19057,17545,8387,9158,2694,4330,1363,2748,4515,1895
19061,27127,13434,13693,4530,7145,1759,3987,7309,2397
19063,37255,17265,19990,4620,8910,3735,4328,9442,6220
19064,24048,11487,12561,3414,5617,2456,3209,6001,3351
19066,6049,2826,3223,922,1415,489,1083,1401,739
19067,53189,25957,27232,7875,14664,3418,7553,15332,4347
19070,7065,3379,3686,965,1821,593,953,1896,837
19072,9693,4524,5169,1294,2324,906,1254,2893,1022
19073,16173,7604,8569,2171,3605,1828,1939,3995,2635
19074,5985,2895,3090,972,1502,421,907,1649,534
19075,7286,3526,3760,1050,1823,653,988,1927,845
19076,6631,3176,3455,994,1758,424,1028,1710,717
19078,11307,5418,5889,1560,2859,999,1555,2909,1425
19079,8937,4170,4767,1560,1988,622,1420,2416,931
19081,10161,4896,5265,1828,2229,839,1831,2139,1295
19082,38336,18299,20037,6166,9973,2160,6195,10429,3413
19083,36268,17362,18906,5507,8789,3066,5141,9542,4223
19085,9060,4272,4788,2379,1247,646,2663,1464,661
19086,11332,5316,6016,1613,2672,1031,1611,2990,1415
19087,30589,14444,16145,4415,7481,2548,4539,8566,3040
19090,19502,9019,10483,2653,4804,1562,2691,5255,2537
19094,4192,2080,2112,642,1008,430,430,1068,614
19095,6348,2729,3619,614,1192,923,652,1373,1594
19096,13037,6096,6941,1687,3079,1330,1609,3253,2079
19102,4172,2000,2172,204,1549,247,207,1595,370
19103,19937,9278,10659,904,6635,1739,1062,6417,3180
19104,50377,24689,25688,12258,10542,1889,11233,11304,3151
19106,8258,4171,4087,226,3113,832,405,2922,760
19107,12122,6499,5623,1036,4849,614,881,4153,589
19108,0,0,0,0,0,0,0,0,0
19111,59151,27339,31812,8110,13983,5246,8049,14693,9070
19112,36,22,14,0,22,0,0,14,0
19113,152,56,96,9,40,7,52,36,8
19114,30992,14535,16457,3549,7701,3285,3521,8351,4585
19115,31951,14630,17321,3287,7144,4199,3133,7959,6229
19116,32578,15766,16812,4449,8452,2865,3724,8969,4119
19118,9561,3934,5627,911,2213,810,1109,3056,1462
19119,29035,12744,16291,3923,6430,2391,3784,8714,3793
19120,68635,32609,36026,14304,15453,2852,12907,18762,4357
19121,34769,15313,19456,6555,6636,2122,6830,9064,3562
19122,19868,9121,10747,4326,3772,1023,4737,4493,1517
19123,9636,4555,5081,1447,2527,581,1439,2611,1031
19124,63219,29883,33336,11969,14358,3556,11693,16147,5496
19125,23586,11712,11874,4253,6037,1422,4205,5727,1942
19126,16332,7378,8954,2480,3737,1161,2426,4679,1849
19127,5129,2601,2528,532,1729,340,425,1577,526
19128,36803,17192,19611,4313,10189,2690,3973,11231,4407
19129,10713,4890,5823,1612,2663,615,1848,3064,911
19130,23123,11122,12001,2310,7369,1443,2083,7691,2227
19131,47360,20636,26724,7584,9501,3551,7079,12813,6832
19132,41822,18440,23382,7484,8267,2689,7474,10965,4943
19133,27797,12773,15024,5955,5492,1326,6322,7009,1693
19134,58195,27500,30695,11725,12872,2903,11786,14260,4649
19135,30954,14894,16060,4799,7769,2326,4552,7732,3776
19136,39935,21439,18496,6295,12265,2879,4810,9078,4608
19137,8118,3913,4205,1345,1910,658,1083,2099,1023
19138,34444,15028,19416,5789,7066,2173,5891,9786,3739
19139,44113,19049,25064,7471,8645,2933,7666,11666,5732
19140,57373,26224,31149,11402,11922,2900,11658,14895,4596
19141,34848,15586,19262,6122,7310,2154,6491,9207,3564
19142,29144,13612,15532,6082,6112,1418,5793,7567,2172
19143,70565,31442,39123,11783,14958,4701,11760,19931,7432
19144,46688,21035,25653,7651,10632,2752,7252,13639,4762
19145,45807,21084,24723,7218,10054,3812,6832,12141,5750
19146,35364,16502,18862,5733,8616,2153,5516,9605,3741
19147,32972,16659,16313,3653,10655,2351,2898,10070,3345
19148,48591,22501,26090,6907,11750,3844,6844,12675,6571
19149,48312,22714,25598,7441,11520,3753,7355,12288,5955
19150,25327,11251,14076,3778,5786,1687,3608,8110,2358
19151,30889,13938,16951,5351,6518,2069,4832,8762,3357
19152,31407,14465,16942,3602,6861,4002,3206,7407,6329
19153,12391,5491,6900,1656,2924,911,1947,3686,1267
19154,35536,17234,18302,5205,9321,2708,4884,9854,3564
19301,6822,3354,3468,987,1725,642,783,1817,868
19310,2897,1473,1424,578,717,178,500,729,195
19311,5599,3081,2518,969,1819,293,848,1333,337
19312,10821,5094,5727,1374,2692,1028,1502,2903,1322
19316,340,198,142,67,106,25,51,85,6
19317,8701,4340,4361,1353,2179,808,1089,2429,843
19319,954,418,536,206,203,9,413,113,10
19320,41493,20515,20978,6886,10777,2852,6503,10705,3770
19330,4540,2254,2286,723,1187,344,706,1216,364
19333,7780,3642,4138,1055,2017,570,986,2164,988
19335,41336,20409,20927,7396,11100,1913,6747,11753,2427
19341,14297,6964,7333,1895,4261,808,1791,4508,1034
19342,13909,7247,6662,2824,3310,1113,1904,3520,1238
19343,7328,3667,3661,1393,1874,400,1295,1999,367
19344,10025,4877,5148,1794,2430,653,1588,2401,1159
19345,573,9,564,0,9,0,262,45,257
19348,18601,9088,9513,2996,4669,1423,2704,4651,2158
19350,9529,4890,4639,1878,2535,477,1597,2558,484
19352,7520,3731,3789,1750,1787,194,1836,1728,225
19355,22395,10995,11400,3328,5900,1767,3142,6142,2116
19358,576,285,291,124,128,33,110,151,30
19362,4680,2448,2232,852,1341,255,779,1190,263
19363,13604,6618,6986,2338,3433,847,2252,3381,1353
19365,6351,3124,3227,1070,1605,449,1020,1640,567
19367,155,78,77,29,43,6,11,51,15
19369,391,177,214,46,106,25,63,105,46
19372,1334,607,727,165,385,57,175,451,101
19373,3699,2435,1264,814,1457,164,424,704,136
19374,1004,592,412,177,376,39,133,240,39
19380,46927,23234,23693,7073,12613,3548,6281,12780,4632
19382,50955,24103,26852,7944,13192,2967,9045,13947,3860
19390,10583,5293,5290,1866,2725,702,1703,2753,834
19401,37854,18201,19653,5322,9989,2890,5281,10233,4139
19403,41394,20699,20695,5453,12061,3185,4983,11575,4137
19405,4955,2478,2477,685,1423,370,620,1284,573
19406,21828,10812,11016,2256,6626,1930,2163,6458,2395
19421,102,60,42,26,23,11,14,24,4
19422,18403,8855,9548,2731,4560,1564,2427,5099,2022
19425,7645,3846,3799,1386,2053,407,1136,2276,387
19426,31045,16908,14137,4698,10694,1516,4750,7675,1712
19428,16573,8210,8363,2180,4740,1290,2010,4625,1728
19435,61,26,35,0,10,16,0,22,13
19436,482,130,352,28,17,85,14,38,300
19437,483,234,249,39,145,50,63,137,49
19438,20835,10223,10612,3419,5529,1275,3296,5828,1488
19440,18170,9196,8974,2933,5063,1200,2586,4849,1539
19444,10226,4783,5443,1476,2450,857,1334,2904,1205
19446,51484,24634,26850,7578,13406,3650,6913,14392,5545
19453,1642,784,858,161,482,141,202,512,144
19454,24538,11797,12741,3581,6688,1528,3366,7131,2244
19457,209,108,101,50,58,0,48,47,6
19460,32835,16080,16755,4737,9007,2336,4341,9290,3124
19462,13710,6768,6942,1708,3454,1606,1482,3437,2023
19464,42377,20424,21953,6546,10932,2946,6289,11094,4570
19465,14208,6976,7232,2029,3767,1180,1858,3777,1597
19468,21303,10156,11147,3203,5822,1131,2997,6191,1959
19472,321,177,144,77,65,35,41,89,14
19473,13153,6465,6688,2203,3767,495,2149,3865,674
19474,643,300,343,49,175,76,52,218,73
19475,9623,4780,4843,1500,2480,800,1443,2516,884
19478,190,117,73,52,57,8,13,41,19
19492,296,147,149,34,64,49,23,71,55
19501,984,493,491,144,281,68,136,272,83
19503,1014,507,507,149,270,88,120,246,141
19504,5555,2819,2736,921,1534,364,836,1480,420
19505,2485,1268,1217,389,672,207,297,669,251
19506,6453,3282,3171,1031,1718,533,938,1709,524
19507,3592,1864,1728,520,1096,248,485,984,259
19508,15265,7697,7568,2466,3997,1234,2038,4172,1358
19510,5139,2477,2662,804,1386,287,793,1538,331
19511,312,173,139,56,90,27,33,79,27
19512,17474,8741,8733,2608,4795,1338,2261,4665,1807
19516,327,148,179,44,76,28,54,93,32
19518,10944,5489,5455,1610,3108,771,1593,2937,925
19519,86,52,34,6,28,18,4,26,4
19520,6015,3052,2963,901,1579,572,779,1582,602
19522,14225,7083,7142,2159,3837,1087,2067,3772,1303
19523,97,45,52,19,14,12,0,37,15
19525,10186,4957,5229,1823,2534,600,1725,2807,697
19526,10721,5323,5398,1481,2947,895,1299,2874,1225
19529,3231,1623,1608,498,946,179,534,875,199
19530,14460,6905,7555,2833,3073,999,3381,2982,1192
19533,7558,3804,3754,1108,1786,910,763,1715,1276
19534,2134,1130,1004,353,599,178,285,564,155
19536,454,210,244,60,109,41,78,122,44
19539,4367,2226,2141,689,1208,329,601,1212,328
19540,11544,5832,5712,1887,3120,825,1720,3130,862
19541,3444,1646,1798,467,982,197,527,1007,264
19543,3675,1824,1851,680,935,209,623,940,288
19544,195,109,86,37,61,11,13,49,24
19545,195,86,109,31,44,11,60,29,20
19547,3728,1879,1849,533,996,350,492,970,387
19549,281,162,119,51,79,32,20,66,33
19550,683,468,215,111,341,16,75,106,34
19551,5023,2601,2422,761,1452,388,570,1383,469
19554,231,103,128,29,63,11,38,65,25
19555,4322,2194,2128,523,1237,434,425,1089,614
19559,303,148,155,36,79,33,31,75,49
19560,6815,3409,3406,879,1715,815,712,1601,1093
19562,2320,1029,1291,252,526,251,246,498,547
19565,7239,3511,3728,1031,1893,587,961,1920,847
19567,4993,2507,2486,865,1269,373,786,1261,439
19601,31616,15161,16455,6145,7284,1732,5869,7861,2725
19602,16912,8423,8489,2957,4415,1051,2826,3993,1670
19604,23810,11652,12158,4634,5518,1500,4361,5657,2140
19605,16766,8074,8692,2089,4190,1795,1940,4103,2649
19606,29901,14505,15396,4327,7649,2529,4120,8205,3071
19607,20522,9528,10994,2278,4983,2267,2495,5147,3352
19608,17211,8313,8898,2519,4249,1545,2507,4434,1957
19609,9175,4444,4731,1096,2248,1100,1009,2352,1370
19610,14716,6779,7937,2064,3005,1710,1870,3452,2615
19611,10023,4661,5362,1549,2250,862,1489,2472,1401
19701,31499,15426,16073,5409,8969,1048,5293,9503,1277
19702,44917,22199,22718,8200,12721,1278,7516,13574,1628
19703,15436,7118,8318,2277,3822,1019,2530,4232,1556
19706,1600,788,812,203,436,149,217,431,164
19707,15085,7426,7659,2423,3874,1129,2285,4045,1329
19709,19587,9790,9797,3668,5252,870,3358,5502,937
19710,26,8,18,0,0,8,0,0,18
19711,55852,27024,28828,10352,13938,2734,11494,13699,3635
19713,31220,15170,16050,4990,8416,1764,4809,8797,2444
19720,55576,26628,28948,8659,14634,3335,8442,15953,4553
19730,366,183,183,40,95,48,27,97,59
19731,86,38,48,7,24,7,0,27,21
19732,46,20,26,0,13,7,0,26,0
19733,48,26,22,5,19,2,0,18,4
19734,5641,2903,2738,919,1591,393,803,1553,382
19736,66,46,20,16,17,13,0,20,0
19801,15232,6788,8444,2659,3311,818,2858,4172,1414
19802,27767,13632,14135,4903,7303,1426,4473,7389,2273
19803,21022,10170,10852,2743,4825,2602,2462,5176,3214
19804,17933,8598,9335,2503,4544,1551,2305,4613,2417
19805,40368,19567,20801,7003,10086,2478,6214,10652,3935
19806,9557,4263,5294,561,2847,855,569,2986,1739
19807,7350,3400,3950,688,1761,951,839,1764,1347
19808,39867,19320,20547,5573,10173,3574,5145,10844,4558
19809,14659,7077,7582,1857,4038,1182,1730,4256,1596
19810,25457,12343,13114,3456,6425,2462,2894,7111,3109
19901,31394,14762,16632,5155,7708,1899,5594,8385,2653
19902,380,321,59,155,166,0,46,13,0
19904,27554,13159,14395,4701,6423,2035,4703,7006,2686
19930,2676,1343,1333,163,580,600,161,558,614
19931,234,115,119,38,59,18,34,44,41
19933,7193,3427,3766,1155,1732,540,1244,1914,608
19934,9725,4695,5030,1558,2518,619,1586,2574,870
19938,5848,2964,2884,1024,1497,443,879,1612,393
19939,4711,2389,2322,679,1112,598,555,1196,571
19940,5018,2429,2589,738,1256,435,770,1265,554
19941,2140,1030,1110,374,522,134,350,578,182
19942,71,44,27,9,27,8,8,19,0
19943,9679,4740,4939,1464,2616,660,1624,2741,574
19944,343,163,180,15,59,89,15,79,86
19945,5577,2662,2915,714,1420,528,827,1378,710
19946,3081,1486,1595,431,760,295,433,807,355
19947,15343,8519,6824,2437,5045,1037,1942,3598,1284
19950,5042,2583,2459,822,1259,502,743,1220,496
19951,998,457,541,147,189,121,110,286,145
19952,8350,3968,4382,1392,1999,577,1439,2239,704
19953,4443,2202,2241,826,1092,284,749,1196,296
19954,1532,713,819,230,383,100,254,423,142
19955,237,108,129,37,58,13,45,61,23
19956,13309,6383,6926,2085,3287,1011,2188,3378,1360
19958,14211,6678,7533,1353,3114,2211,1345,3413,2775
19960,4888,2282,2606,728,1169,385,868,1314,424
19962,5938,2857,3081,1069,1529,259,1159,1626,296
19963,15235,7332,7903,2382,3690,1260,2160,3854,1889
19964,982,468,514,159,228,81,161,269,84
19966,17923,8534,9389,2120,3820,2594,2134,4321,2934
19967,428,211,217,53,112,46,28,145,44
19968,6575,3144,3431,889,1612,643,935,1737,759
19970,4583,2130,2453,354,861,915,417,1088,948
19971,9869,4762,5107,890,2368,1504,909,2433,1765
19973,21289,10167,11122,3525,4979,1663,3164,5429,2529
19975,6321,3128,3193,645,1413,1070,596,1426,1171
19977,13539,7355,6184,2149,4389,817,1731,3059,1394
19979,604,299,305,97,170,32,101,156,48
19980,74,43,31,14,27,2,10,15,6
20001,33711,16086,17625,5554,8766,1766,5949,8775,2901
20002,49391,23452,25939,6390,13882,3180,6542,14261,5136
20003,23122,12293,10829,2581,8356,1356,2175,6984,1670
20004,750,453,297,25,365,63,23,234,40
20005,10736,6262,4474,982,4705,575,699,2963,812
20006,1850,849,1001,549,300,0,696,274,31
20007,28840,13379,15461,3836,8055,1488,4297,9290,1874
20008,26440,11496,14944,1401,8347,1748,1487,10736,2721
20009,46418,23938,22480,3803,18498,1637,4363,15690,2427
20010,29013,14993,14020,4033,9486,1474,3659,8425,1936
20011,57380,26381,30999,7545,14072,4764,7481,15751,7767
20012,13466,6242,7224,1453,3607,1182,1409,3927,1888
20015,15326,7541,7785,1517,3785,2239,1477,4276,2032
20016,31625,13747,17878,3703,7483,2561,4127,9845,3906
20017,19213,8710,10503,2930,4224,1556,3106,4919,2478
20018,17005,7647,9358,2102,3943,1602,2322,3987,3049
20019,52686,23132,29554,9002,10543,3587,9094,14610,5850
20020,50024,21928,28096,9462,9926,2540,9469,14484,4143
20024,11709,5396,6313,961,3411,1024,1147,3874,1292
20032,31676,14259,17417,6326,6576,1357,6261,9216,1940
20036,3994,2165,1829,94,1896,175,97,1530,202
20037,12380,5691,6689,1747,3129,815,2453,3068,1168
20105,1319,712,607,215,390,107,85,421,101
20106,3724,1909,1815,625,979,305,512,1019,284
20109,29244,14533,14711,4726,8947,860,4763,8699,1249
20110,39377,19908,19469,7153,11474,1281,6874,10832,1763
20111,24324,12422,11902,4340,7257,825,3981,6763,1158
20112,18947,9619,9328,3540,5367,712,3226,5484,618
20115,5670,2781,2889,770,1602,409,779,1573,537
20117,2688,1277,1411,353,668,256,365,733,313
20118,200,82,118,23,51,8,29,62,27
20119,3553,1798,1755,535,939,324,575,901,279
20120,34441,16861,17580,6051,9936,874,5954,10550,1076
20121,25895,12769,13126,4181,8165,423,4101,8440,585
20124,15010,7413,7597,2719,4228,466,2652,4444,501
20129,173,97,76,46,29,22,34,30,12
20130,60,25,35,0,12,13,4,6,25
20132,9072,4523,4549,1574,2415,534,1322,2585,642
20135,2694,1365,1329,388,788,189,373,768,188
20136,8924,4459,4465,1692,2627,140,1558,2748,159
20137,1692,795,897,203,493,99,260,531,106
20138,145,66,79,23,28,15,30,35,14
20139,12,12,0,0,12,0,0,0,0
20140,83,27,56,12,5,10,26,24,6
20141,3200,1543,1657,515,851,177,559,913,185
20143,955,433,522,107,261,65,186,289,47
20144,985,489,496,126,311,52,128,300,68
20147,29696,14852,14844,5546,8704,602,5014,9012,818
20148,3978,1921,2057,739,1148,34,825,1213,19
20151,17270,8663,8607,3131,4910,622,2937,5052,618
20152,6546,3136,3410,810,2141,185,1058,2160,192
20155,6488,3170,3318,947,1790,433,947,1881,490
20158,2939,1457,1482,454,772,231,435,840,207
20164,34520,17425,17095,6004,10333,1088,5324,10449,1322
20165,27214,13156,14058,4401,7823,932,4438,8592,1028
20166,3917,1934,1983,553,1297,84,629,1291,63
20169,5547,2903,2644,782,1846,275,783,1604,257
20170,38187,19768,18419,6968,11882,918,6171,11081,1167
20171,33877,16955,16922,6121,10126,708,5855,10263,804
20175,17170,8479,8691,2798,4917,764,2452,5242,997
20176,19503,9528,9975,3223,5600,705,3301,5708,966
20180,4500,2215,2285,708,1252,255,716,1292,277
20181,6357,3257,3100,1103,1761,393,895,1790,415
20184,570,247,323,56,149,42,79,166,78
20186,10588,5055,5533,1406,2747,902,1358,2848,1327
20187,13288,6713,6575,2328,3546,839,2080,3607,888
20190,14241,6975,7266,1706,4455,814,1492,4345,1429
20191,29077,14404,14673,4031,8913,1460,3704,9407,1562
20194,12603,6128,6475,1726,3957,445,1572,4510,393
20197,1042,527,515,142,302,83,149,272,94
20198,2032,926,1106,187,540,199,259,609,238
20319,70,35,35,0,25,10,15,20,0
20332,644,328,316,115,199,14,138,164,14
20336,4590,2424,2166,1141,1277,6,1054,1091,21
20375,0,0,0,0,0,0,0,0,0
20601,22294,10885,11409,3839,6166,880,3682,6684,1043
20602,21532,10251,11281,3971,5535,745,3740,6209,1332
20603,20810,9970,10840,3635,5878,457,3835,6267,738
20606,456,220,236,28,143,49,64,102,70
20607,7234,3457,3777,1079,2025,353,1293,2081,403
20608,1026,500,526,153,259,88,169,253,104
20609,1264,623,641,164,312,147,203,316,122
20611,734,357,377,93,194,70,112,188,77
20612,144,93,51,0,61,32,8,37,6
20613,8353,4225,4128,1468,2111,646,1064,2179,885
20615,399,211,188,48,100,63,34,122,32
20616,4705,2130,2575,684,1219,227,785,1444,346
20617,653,335,318,108,191,36,72,205,41
20618,511,233,278,48,155,30,84,125,69
20619,6446,3147,3299,969,1775,403,1070,1818,411
20620,1481,759,722,228,445,86,167,442,113
20621,1184,579,605,171,220,188,144,292,169
20622,3471,1933,1538,639,840,454,501,837,200
20623,2610,1410,1200,740,575,95,416,701,83
20624,873,435,438,189,214,32,170,224,44
20625,851,406,445,120,215,71,143,204,98
20626,420,198,222,21,78,99,38,92,92
20628,257,150,107,48,73,29,11,76,20
20629,590,230,360,58,110,62,75,122,163
20630,351,194,157,29,110,55,23,87,47
20632,539,293,246,67,185,41,87,145,14
20634,5383,2690,2693,954,1546,190,845,1638,210
20636,7858,3970,3888,1320,2076,574,1137,2164,587
20637,4398,2204,2194,604,1335,265,685,1220,289
20639,11464,5736,5728,2006,3099,631,1836,3125,767
20640,8287,4080,4207,1363,2071,646,1249,2226,732
20645,410,234,176,46,120,68,14,110,52
20646,16420,8105,8315,2517,4442,1146,2390,4431,1494
20650,10842,5373,5469,1791,2752,830,1558,2751,1160
20653,19416,9547,9869,3536,5223,788,3773,5120,976
20657,18189,9133,9056,3530,4782,821,3060,4960,1036
20658,903,450,453,139,252,59,155,248,50
20659,21123,10503,10620,3676,5900,927,3697,5793,1130
20662,2655,1357,1298,445,695,217,363,680,255
20664,2682,1297,1385,381,686,230,410,727,248
20667,167,77,90,18,47,12,16,61,13
20670,2866,1783,1083,802,981,0,569,514,0
20674,768,432,336,135,249,48,100,223,13
20675,1727,844,883,239,428,177,263,446,174
20676,3409,1660,1749,591,865,204,483,1010,256
20677,1770,851,919,207,476,168,246,540,133
20678,9285,4475,4810,1532,2429,514,1519,2499,792
20680,1013,490,523,133,224,133,133,245,145
20684,1181,625,556,172,339,114,178,303,75
20685,5429,2782,2647,1015,1520,247,859,1503,285
20687,260,121,139,17,69,35,13,62,64
20688,1114,467,647,43,203,221,109,235,303
20689,1000,484,516,153,262,69,176,263,77
20690,679,372,307,105,200,67,50,178,79
20692,430,237,193,86,122,29,48,98,47
20693,723,341,382,114,171,56,158,183,41
20695,4780,2322,2458,811,1245,266,747,1430,281
20701,49,39,10,7,32,0,0,5,5
20705,22757,11193,11564,3420,6502,1271,3050,7036,1478
20706,37098,17360,19738,6159,9109,2092,5891,11185,2662
20707,25701,12482,13219,3538,7727,1217,3188,8325,1706
20708,25119,11845,13274,3891,6893,1061,3684,8125,1465
20710,7675,3698,3977,1260,2027,411,1215,2194,568
20711,6062,3070,2992,965,1652,453,825,1564,603
20712,9025,4406,4619,1432,2654,320,1315,2760,544
20714,4085,1925,2160,628,1108,189,700,1246,214
20715,25049,12176,12873,3901,6240,2035,3759,6624,2490
20716,19693,9140,10553,2952,5491,697,2921,6397,1235
20720,14709,6984,7725,2526,3904,554,2516,4572,637
20721,22466,10294,12172,3731,5804,759,3677,7213,1282
20722,5442,2645,2797,916,1395,334,848,1508,441
20723,24053,11945,12108,4071,7096,778,3652,7565,891
20724,13025,6408,6617,1991,3898,519,1953,4076,588
20732,8187,4059,4128,1427,2312,320,1408,2303,417
20733,2736,1344,1392,427,782,135,452,779,161
20735,32890,15471,17419,5143,8561,1767,5089,9960,2370
20736,6450,3206,3244,1108,1728,370,941,1856,447
20737,19968,10187,9781,3913,5569,705,3304,5595,882
20740,31080,16242,14838,7829,6932,1481,7043,5890,1905
20743,41378,19094,22284,7149,9431,2514,7199,11839,3246
20744,48258,22697,25561,7309,12315,3073,7120,14913,3528
20745,27733,12965,14768,4949,6838,1178,4675,8444,1649
20746,28418,12810,15608,4944,6743,1123,4881,9154,1573
20747,40175,17967,22208,7168,9188,1611,7007,12961,2240
20748,39896,18363,21533,6322,9578,2463,5671,12495,3367
20751,2259,1071,1188,269,632,170,376,642,170
20754,6443,3149,3294,1058,1667,424,1005,1847,442
20755,9901,5246,4655,2626,2596,24,2188,2433,34
20758,721,346,375,65,174,107,73,206,96
20759,1670,874,796,280,436,158,251,411,134
20762,7925,4202,3723,1726,2466,10,1652,2064,7
20763,2410,1112,1298,406,622,84,554,588,156
20764,3987,2054,1933,675,1185,194,575,1171,187
20765,366,151,215,19,95,37,51,94,70
20769,5159,2605,2554,861,1481,263,822,1438,294
20770,21172,10187,10985,3020,6354,813,2922,6907,1156
20772,35344,17515,17829,5681,10147,1687,5069,10933,1827
20774,33201,15156,18045,5062,8655,1439,5185,10997,1863
20776,3460,1730,1730,551,893,286,441,969,320
20777,2982,1411,1571,453,766,192,466,853,252
20778,1837,933,904,334,470,129,260,509,135
20779,1272,624,648,192,359,73,225,355,68
20781,11404,5640,5764,2075,3094,471,1881,3218,665
20782,28727,13313,15414,4437,7390,1486,4409,8214,2791
20783,43071,22288,20783,7157,13185,1946,6520,11815,2448
20784,27184,12787,14397,4523,6923,1341,4948,7709,1740
20785,39127,18338,20789,7749,9069,1520,7370,11521,1898
20794,15814,11143,4671,1573,8994,576,1414,2689,568
20812,231,122,109,44,69,9,21,74,14
20814,25209,11877,13332,2434,7500,1943,2383,7940,3009
20815,28121,12569,15552,3302,6322,2945,3110,8131,4311
20816,15136,7006,8130,1993,3503,1510,2082,4038,2010
20817,35183,16703,18480,4899,8239,3565,4581,9675,4224
20818,2019,925,1094,279,520,126,371,587,136
20832,24547,11826,12721,4328,6485,1013,4200,7304,1217
20833,6239,3159,3080,1108,1673,378,1006,1712,362
20837,6017,3016,3001,1173,1620,223,1027,1737,237
20838,190,98,92,25,60,13,25,51,16
20839,109,61,48,28,18,15,5,29,14
20841,1879,935,944,284,483,168,354,466,124
20842,1945,936,1009,193,572,171,234,562,213
20850,33277,15418,17859,4734,8719,1965,4801,9803,3255
20851,13310,6826,6484,2066,3985,775,1651,3808,1025
20852,34849,16224,18625,3675,9549,3000,3501,10724,4400
20853,27487,13248,14239,3888,6723,2637,3695,7514,3030
20854,46326,22710,23616,7193,11174,4343,6775,12827,4014
20855,17175,8610,8565,2934,4699,977,2660,4812,1093
20860,1135,426,709,120,160,146,120,262,327
20861,1766,887,879,356,397,134,229,500,150
20862,314,144,170,17,103,24,42,94,34
20866,11249,5195,6054,1726,2947,522,1638,3790,626
20868,201,95,106,19,51,25,32,58,16
20871,2832,1379,1453,374,816,189,416,846,191
20872,11809,5765,6044,2269,2978,518,1987,3361,696
20874,49238,23823,25415,7849,15055,919,7696,16444,1275
20876,22439,10920,11519,4042,6234,644,3858,6923,738
20877,30329,14653,15676,4580,8618,1455,4582,8300,2794
20878,55186,27193,27993,9366,15865,1962,8600,17224,2169
20879,21754,10456,11298,3743,6112,601,3715,6826,757
20880,457,229,228,57,138,34,53,147,28
20882,12423,6296,6127,2319,3412,565,2011,3506,610
20886,32960,15730,17230,4849,9416,1465,4822,10339,2069
20895,18498,8511,9987,2263,4612,1636,2325,5150,2512
20896,589,288,301,104,125,59,47,161,93
20901,33555,16220,17335,4798,9257,2165,4686,9656,2993
20902,42870,20993,21877,6711,11402,2880,5833,11918,4126
20903,22997,11362,11635,3975,6170,1217,3869,6083,1683
20904,48904,22674,26230,7192,12630,2852,6930,15419,3881
20905,18261,9131,9130,3134,4732,1265,2663,5209,1258
20906,61284,28145,33139,8272,14817,5056,7886,16744,8509
20910,35448,16584,18864,3880,10788,1916,3619,12033,3212
20912,24628,11753,12875,3701,7024,1028,3730,7697,1448
21001,19072,9117,9955,2827,4812,1478,2882,5096,1977
21005,3116,1641,1475,706,935,0,678,780,17
21009,23707,11643,12064,4049,6751,843,3742,7018,1304
21010,961,435,526,209,226,0,290,236,0
21012,21078,10219,10859,3472,5601,1146,3253,6244,1362
21013,3805,1823,1982,512,990,321,630,992,360
21014,32969,15864,17105,5324,8548,1992,5046,9007,3052
21015,23719,11495,12224,3873,6296,1326,3916,6697,1611
21017,6139,2838,3301,811,1798,229,1073,1985,243
21028,2642,1350,1292,401,660,289,237,806,249
21029,7734,3882,3852,1499,2001,382,1291,2183,378
21030,23697,11333,12364,3045,6875,1413,3070,7298,1996
21031,53,53,0,0,0,53,0,0,0
21032,7896,3979,3917,990,2429,560,1021,2377,519
21034,3426,1687,1739,512,926,249,481,883,375
21035,7502,3818,3684,1249,1965,604,1020,2042,622
21036,2126,1154,972,477,533,144,279,565,128
21037,16212,8084,8128,2167,4708,1209,2115,4592,1421
21040,22300,10642,11658,4103,5654,885,4162,6345,1151
21042,35477,17497,17980,5858,9128,2511,5407,9880,2693
21043,31893,15571,16322,5133,9070,1368,4923,9437,1962
21044,40264,19155,21109,5672,11194,2289,5486,12640,2983
21045,37512,17947,19565,5893,10419,1635,5556,12043,1966
21046,15074,7258,7816,2190,4636,432,2319,4955,542
21047,11328,5672,5656,1823,2917,932,1551,3062,1043
21048,10425,5362,5063,1771,2815,776,1408,2765,890
21050,15021,7342,7679,2539,3814,989,2305,4166,1208
21051,88,41,47,16,18,7,19,19,9
21052,391,215,176,69,134,12,68,96,12
21053,2923,1466,1457,498,750,218,473,801,183
21054,6864,3488,3376,1241,1809,438,834,2110,432
21056,306,160,146,36,63,61,10,68,68
21057,4056,2086,1970,733,861,492,413,927,630
21060,27075,13175,13900,4041,7174,1960,3707,7412,2781
21061,50168,24679,25489,7682,13995,3002,7327,14090,4072
21071,467,235,232,98,100,37,90,105,37
21074,12873,6300,6573,2185,3284,831,2019,3510,1044
21075,19360,9409,9951,3147,5562,700,2966,5918,1067
21076,7725,3852,3873,1162,2255,435,1179,2181,513
21077,378,160,218,40,90,30,65,100,53
21078,16002,7798,8204,2438,4167,1193,2301,4316,1587
21082,998,517,481,168,217,132,77,268,136
21084,7358,3744,3614,1254,2032,458,994,2072,548
21085,14695,7413,7282,2179,4029,1205,1896,4061,1325
21087,5262,2517,2745,713,1214,590,744,1349,652
21090,9580,4760,4820,1305,2419,1036,1191,2405,1224
21093,34385,16110,18275,4185,8145,3780,4201,9157,4917
21102,9496,4792,4704,1625,2615,552,1398,2540,766
21104,4297,2284,2013,982,1129,173,651,1127,235
21105,64,24,40,0,18,6,7,26,7
21108,17646,8815,8831,2937,4900,978,2677,4978,1176
21111,4982,2509,2473,812,1377,320,704,1393,376
21113,21335,10276,11059,3297,6200,779,3479,6617,963
21114,24658,12047,12611,4062,7095,890,3732,7692,1187
21117,41495,19809,21686,5999,12097,1713,5751,13745,2190
21120,6671,3316,3355,1037,1825,454,945,1915,495
21122,57396,28505,28891,9229,15953,3323,8500,16284,4107
21128,6772,3219,3553,830,1831,558,936,2017,600
21130,137,70,67,12,35,23,26,25,16
21131,7838,3854,3984,1208,1874,772,1172,2056,756
21132,2621,1305,1316,440,671,194,418,748,150
21133,28636,13153,15483,4587,6732,1834,4364,8731,2388
21136,29869,14305,15564,4643,7791,1871,4468,8733,2363
21140,3320,1648,1672,423,1038,187,445,998,229
21144,28530,13470,15060,5090,7352,1028,4718,9028,1314
21146,25070,12129,12941,3625,6567,1937,3754,6790,2397
21152,4807,2230,2577,556,1289,385,659,1459,459
21154,5566,2800,2766,878,1497,425,762,1507,497
21155,2353,1118,1235,257,617,244,267,628,340
21156,485,222,263,54,120,48,80,142,41
21157,34805,16905,17900,5686,8984,2235,5349,9232,3319
21158,17984,8670,9314,2848,4722,1100,2832,4981,1501
21160,2434,1227,1207,430,608,189,382,615,210
21161,5161,2614,2547,826,1408,380,818,1371,358
21162,2857,1479,1378,413,777,289,331,690,357
21163,3303,1724,1579,759,766,199,481,845,253
21201,15280,7447,7833,1663,4576,1208,1563,4455,1815
21202,23539,14815,8724,3364,10569,882,2401,5079,1244
21204,20197,9281,10916,3131,4452,1698,3988,4098,2830
21205,18346,8307,10039,3602,3722,983,3446,4926,1667
21206,50193,23599,26594,8140,12186,3273,8178,14037,4379
21207,47966,21779,26187,7611,10827,3341,7698,13686,4803
21208,31203,14446,16757,3776,6850,3820,3244,8277,5236
21209,23600,11022,12578,3045,6010,1967,2861,7100,2617
21210,11852,5403,6449,1532,2868,1003,1744,3248,1457
21211,16515,7883,8632,1776,4746,1361,1773,4881,1978
21212,34749,15455,19294,5300,7928,2227,5822,9629,3843
21213,38499,17352,21147,6829,8193,2330,6796,10279,4072
21214,21173,10108,11065,3105,5452,1551,2896,6076,2093
21215,66407,29631,36776,10738,13320,5573,10598,17224,8954
21216,36483,16295,20188,5898,7461,2936,5897,9437,4854
21217,41605,18838,22767,6830,9353,2655,7766,11062,3939
21218,55215,26324,28891,9230,14087,3007,9633,14531,4727
21219,9184,4372,4812,1181,2337,854,1313,2427,1072
21220,36315,17688,18627,5628,9616,2444,5509,10003,3115
21221,42688,20290,22398,6409,10652,3229,6460,11556,4382
21222,54929,26189,28740,7879,13234,5076,7593,14090,7057
21223,30753,14684,16069,5421,7256,2007,5282,7830,2957
21224,48245,22923,25322,7041,12002,3880,7088,12595,5639
21225,31591,14685,16906,5467,7083,2135,5300,8387,3219
21226,6554,3149,3405,911,1862,376,820,2006,579
21227,33681,16103,17578,5258,8580,2265,5068,9019,3491
21228,48408,22689,25719,7038,11477,4174,6560,12192,6967
21229,49867,22118,27749,7590,11258,3270,8202,14191,5356
21230,33372,15864,17508,4332,9396,2136,4470,9956,3082
21231,16136,7912,8224,2057,4998,857,1933,5099,1192
21234,69495,32329,37166,9771,16576,5982,9356,18929,8881
21236,37567,17896,19671,5402,10083,2411,4869,11239,3563
21237,25352,12349,13003,3498,6906,1945,3267,7104,2632
21239,28895,12606,16289,4301,6544,1761,4617,8749,2923
21244,31603,14615,16988,5247,7908,1460,5002,10032,1954
21286,19044,8488,10556,2087,4271,2130,2551,4691,3314
21401,50571,24457,26114,7114,13375,3968,6505,14025,5584
21402,5291,4069,1222,2765,1269,35,626,527,69
21403,29699,14300,15399,3747,8395,2158,3424,9152,2823
21405,528,250,278,52,113,85,52,149,77
21502,43941,22399,21542,5512,12679,4208,5346,10273,5923
21520,2006,923,1083,316,446,161,365,480,238
21521,1416,675,741,186,324,165,214,333,194
21522,24,17,7,6,0,11,0,0,7
21523,293,129,164,30,78,21,54,73,37
21524,769,404,365,71,215,118,46,127,192
21528,132,54,78,11,26,17,18,21,39
21529,684,328,356,126,139,63,77,184,95
21530,1599,873,726,350,375,148,219,350,157
21531,2378,1236,1142,406,553,277,297,582,263
21532,14481,6731,7750,2443,3242,1046,2908,3162,1680
21536,3923,1910,2013,608,975,327,573,991,449
21538,817,395,422,100,190,105,113,203,106
21539,2878,1396,1482,452,675,269,345,690,447
21540,68,35,33,9,8,18,6,8,19
21541,1096,586,510,159,297,130,92,312,106
21542,446,202,244,54,95,53,56,121,67
21543,145,65,80,17,27,21,18,30,32
21545,2396,1158,1238,343,629,186,399,558,281
21550,14560,7071,7489,2272,3489,1310,2099,3720,1670
21555,2010,1077,933,364,516,197,257,511,165
21557,2102,1024,1078,306,490,228,296,520,262
21560,6,6,0,0,0,6,0,0,0
21561,2581,1339,1242,375,711,253,319,695,228
21562,3403,1596,1807,442,758,396,456,745,606
21601,19151,8975,10176,2426,4572,1977,2330,5037,2809
21607,581,287,294,99,147,41,65,168,61
21610,508,243,265,79,115,49,85,129,51
21612,744,359,385,86,157,116,68,203,114
21613,16201,7525,8676,2131,3744,1650,2074,4278,2324
21617,6465,3182,3283,987,1649,546,887,1734,662
21619,5351,2746,2605,776,1499,471,606,1421,578
21620,11899,5471,6428,1654,2580,1237,1812,2922,1694
21622,451,210,241,39,120,51,85,108,48
21623,1732,929,803,232,586,111,212,411,180
21624,189,80,109,38,26,16,35,39,35
21625,2786,1378,1408,478,701,199,467,745,196
21626,173,86,87,35,36,15,6,60,21
21627,27,12,15,0,5,7,0,0,15
21628,468,245,223,55,125,65,50,113,60
21629,7870,3815,4055,1144,1891,780,1049,2026,980
21631,2360,1133,1227,326,588,219,350,610,267
21632,6103,2835,3268,973,1368,494,1032,1605,631
21634,494,244,250,52,107,85,41,91,118
21635,1682,828,854,212,433,183,203,439,212
21636,1352,692,660,229,391,72,202,357,101
21638,3895,1893,2002,522,910,461,489,990,523
21639,3914,1886,2028,638,978,270,697,1042,289
21640,1234,618,616,202,317,99,161,387,68
21641,195,99,96,32,61,6,21,60,15
21643,5229,2477,2752,784,1338,355,872,1413,467
21644,159,61,98,18,43,0,50,43,5
21645,1065,591,474,103,365,123,128,235,111
21647,571,279,292,56,153,70,60,146,86
21648,470,249,221,83,95,71,50,117,54
21649,1675,932,743,424,436,72,239,406,98
21650,328,182,146,80,65,37,48,60,38
21651,2143,1077,1066,315,607,155,345,538,183
21653,116,69,47,7,33,29,0,29,18
21654,1394,692,702,115,296,281,90,372,240
21655,4862,2430,2432,748,1243,439,630,1299,503
21657,716,352,364,117,179,56,141,167,56
21658,3807,1910,1897,567,907,436,423,1073,401
21659,1371,664,707,167,401,96,185,365,157
21660,3499,1677,1822,569,862,246,585,951,286
21661,2814,1339,1475,325,610,404,320,693,462
21662,656,319,337,91,152,76,52,182,103
21663,3460,1585,1875,338,682,565,349,795,731
21664,497,250,247,79,121,50,67,126,54
21665,157,66,91,0,28,38,12,31,48
21666,11461,5785,5676,1932,3179,674,1684,3347,645
21667,279,144,135,55,70,19,29,72,34
21668,1849,971,878,319,451,201,232,468,178
21669,177,108,69,25,45,38,6,41,22
21671,822,418,404,112,154,152,83,185,136
21672,268,128,140,36,69,23,35,28,77
21673,3229,1547,1682,483,794,270,456,849,377
21675,239,125,114,21,56,48,17,56,41
21676,212,89,123,0,55,34,30,42,51
21677,392,198,194,35,97,66,53,83,58
21678,2350,1155,1195,393,565,197,329,625,241
21679,288,149,139,42,75,32,25,93,21
21701,32592,15456,17136,4406,8861,2189,4648,9205,3283
21702,30487,14957,15530,4721,8550,1686,4685,8443,2402
21703,26307,12954,13353,4584,7284,1086,4367,7691,1295
21704,4414,2467,1947,677,1428,362,576,988,383
21710,2925,1431,1494,404,795,232,414,785,295
21711,1114,567,547,158,283,126,125,295,127
21713,12245,7834,4411,1238,5845,751,1092,2249,1070
21716,4899,2340,2559,763,1282,295,868,1242,449
21717,64,43,21,15,19,9,6,15,0
21718,170,70,100,18,42,10,32,48,20
21719,1526,765,761,239,441,85,218,370,173
21722,5326,2717,2609,908,1409,400,772,1478,359
21723,349,181,168,83,98,0,37,111,20
21727,5507,2605,2902,963,1349,293,1139,1147,616
21733,809,389,420,150,204,35,105,252,63
21734,869,424,445,83,284,57,126,226,93
21737,857,448,409,168,249,31,136,265,8
21738,2679,1290,1389,395,752,143,514,752,123
21740,55244,27991,27253,8360,15619,4012,7691,13830,5732
21742,25337,12127,13210,3624,6268,2235,3459,6690,3061
21750,3917,1931,1986,566,1070,295,509,1016,461
21754,5818,2831,2987,1090,1519,222,991,1754,242
21755,5443,2841,2602,980,1494,367,777,1508,317
21756,2574,1269,1305,483,674,112,440,667,198
21757,3101,1538,1563,477,790,271,448,822,293
21758,3978,2027,1951,548,1187,292,553,1087,311
21762,158,84,74,26,46,12,18,49,7
21766,622,308,314,45,178,85,88,144,82
21767,1248,640,608,191,328,121,76,371,161
21769,9609,4753,4856,1650,2453,650,1475,2668,713
21770,5163,2619,2544,879,1499,241,809,1467,268
21771,25526,12679,12847,4547,6993,1139,4274,7173,1400
21773,4767,2321,2446,762,1283,276,820,1300,326
21774,8639,4258,4381,1560,2456,242,1510,2549,322
21776,5394,2675,2719,958,1435,282,857,1456,406
21777,1151,651,500,237,366,48,153,318,29
21778,1089,540,549,143,302,95,150,288,111
21779,775,366,409,93,212,61,136,215,58
21780,1621,927,694,389,410,128,163,407,124
21782,4166,2203,1963,693,1210,300,499,1140,324
21783,8259,4147,4112,1409,2115,623,1249,2169,694
21784,35077,17464,17613,5748,9716,2000,5391,9435,2787
21787,8920,4477,4443,1587,2318,572,1444,2272,727
21788,11261,5490,5771,1697,3042,751,1672,3001,1098
21790,74,21,53,0,14,7,11,7,35
21791,5474,2771,2703,926,1423,422,842,1344,517
21793,9584,4635,4949,1732,2338,565,1620,2656,673
21794,1776,992,784,441,468,83,223,481,80
21795,8128,3880,4248,1054,1996,830,923,2001,1324
21797,7471,3565,3906,1185,1952,428,1316,2067,523
21798,1839,940,899,372,446,122,294,453,152
21801,27361,12870,14491,5076,6070,1724,5318,6621,2552
21804,31163,14648,16515,4648,7719,2281,4467,8695,3353
21810,60,32,28,5,13,14,4,24,0
21811,19384,9304,10080,2213,4417,2674,2130,4761,3189
21813,2326,1184,1142,313,619,252,285,596,261
21814,480,254,226,83,102,69,47,109,70
21817,5516,2450,3066,726,1165,559,780,1390,896
21821,1185,562,623,139,295,128,196,283,144
21822,1949,884,1065,303,439,142,245,619,201
21824,263,128,135,22,73,33,0,78,57
21826,3666,1863,1803,639,934,290,454,1007,342
21829,383,160,223,36,101,23,59,101,63
21830,2924,1478,1446,498,786,194,390,817,239
21835,472,218,254,48,143,27,52,157,45
21837,2486,1213,1273,401,646,166,366,709,198
21838,1843,903,940,251,448,204,254,488,198
21840,418,204,214,15,122,67,34,112,68
21841,838,422,416,133,201,88,76,206,134
21842,10274,5295,4979,1002,2916,1377,854,2604,1521
21849,2873,1500,1373,528,779,193,394,798,181
21850,2741,1341,1400,406,752,183,365,831,204
21851,7331,3505,3826,1211,1662,632,1144,1844,838
21853,12054,7201,4853,1827,4738,636,2009,1953,891
21856,1047,521,526,137,261,123,126,274,126
21861,676,319,357,114,146,59,129,143,85
21862,48,8,40,0,8,0,16,18,6
21863,5085,2479,2606,726,1321,432,694,1313,599
21864,725,322,403,99,149,74,165,154,84
21865,201,80,121,31,36,13,22,73,26
21866,99,69,30,40,29,0,0,18,12
21867,162,109,53,51,36,22,13,27,13
21869,1166,591,575,228,206,157,103,272,200
21871,2054,973,1081,244,486,243,291,527,263
21872,628,315,313,69,208,38,94,150,69
21874,2263,1080,1183,343,606,131,375,621,187
21875,5428,2538,2890,852,1365,321,976,1445,469
21901,12350,6068,6282,1932,3359,777,2048,3342,892
21902,215,208,7,0,66,142,0,0,7
21903,5139,2494,2645,782,1350,362,749,1425,471
21904,6777,3445,3332,1198,1833,414,1040,1871,421
21911,8967,4421,4546,1526,2256,639,1440,2179,927
21912,1062,496,566,146,261,89,147,316,103
21913,477,222,255,58,112,52,68,127,60
21914,770,431,339,144,221,66,90,195,54
21915,3043,1479,1564,409,717,353,386,782,396
21917,1947,917,1030,282,534,101,350,511,169
21918,4061,2065,1996,690,1190,185,601,1210,185
21919,2538,1321,1217,364,673,284,312,639,266
21920,123,71,52,34,13,24,9,31,12
21921,38335,18726,19609,6316,10227,2183,6259,10672,2678
21930,147,92,55,37,49,6,4,30,21
22003,53044,25818,27226,7160,14867,3791,6924,15451,4851
22015,42998,20774,22224,6892,12284,1598,6577,13513,2134
22026,21775,10380,11395,3991,5868,521,4000,6759,636
22027,1499,683,816,185,320,178,149,525,142
22030,39274,19919,19355,6151,11647,2121,5675,10974,2706
22031,27017,13621,13396,3819,8071,1731,3400,7934,2062
22032,28904,14280,14624,4550,7874,1856,4210,8421,1993
22033,32972,16250,16722,4187,10970,1093,3995,11368,1359
22039,18331,9251,9080,3234,4953,1064,2985,5279,816
22041,27112,13856,13256,3929,8332,1595,3386,7657,2213
22042,30434,15210,15224,4051,9418,1741,3714,9236,2274
22043,22818,11302,11516,2793,7120,1389,2654,7250,1612
22044,12928,6655,6273,1737,4177,741,1536,3782,955
22046,14239,7089,7150,2024,4114,951,1717,4173,1260
22060,8062,4034,4028,1901,1970,163,1771,1965,292
22066,16984,8652,8332,3018,4580,1054,2597,4840,895
22079,19664,11007,8657,2981,7313,713,2589,5315,753
22101,28550,13789,14761,4066,7007,2716,3714,7900,3147
22102,18554,8954,9600,2103,5509,1342,1930,6016,1654
22124,13706,6591,7115,1893,3898,800,1814,4483,818
22125,75,25,50,6,7,12,0,20,30
22134,7870,5003,2867,2001,2965,37,1365,1470,32
22150,22221,11118,11103,3331,6409,1378,3083,6199,1821
22151,16503,8102,8401,2481,4366,1255,2248,4655,1498
22152,28375,13731,14644,4381,7676,1674,4137,8518,1989
22153,32995,16222,16773,5864,9311,1047,5453,10237,1083
22172,6142,3164,2978,1023,1879,262,1017,1611,350
22180,22027,10869,11158,2812,6411,1646,2989,6252,1917
22181,14357,7093,7264,2082,4050,961,2051,4242,971
22182,22758,11258,11500,3400,6402,1456,3141,6806,1553
22191,39945,20125,19820,7715,10916,1494,6852,10798,2170
22192,49179,23906,25273,8267,14137,1502,7887,15622,1764
22193,62252,30800,31452,11942,17054,1804,11478,17887,2087
22201,25258,12795,12463,1597,10388,810,1480,9888,1095
22202,16396,8333,8063,711,6385,1237,629,5729,1705
22203,18760,9447,9313,1736,6678,1033,1511,5940,1862
22204,49346,24995,24351,6382,16486,2127,6178,15374,2799
22205,15719,7773,7946,1966,4801,1006,1801,4851,1294
22206,19139,9238,9901,2023,6710,505,1862,7257,782
22207,29607,14372,15235,3805,8179,2388,3761,8405,3069
22209,11612,6258,5354,696,5082,480,558,4394,402
22211,1636,1161,475,477,684,0,261,214,0
22213,2482,1221,1261,255,809,157,226,777,258
22301,10243,4860,5383,1034,3389,437,980,3724,679
22302,14973,6910,8063,1324,4702,884,1403,5345,1315
22303,14330,7425,6905,1701,4835,889,1307,4447,1151
22304,40786,19466,21320,3950,13594,1922,4126,14226,2968
22305,15612,8228,7384,2150,5531,547,2115,4670,599
22306,28074,13696,14378,4116,8266,1314,4160,8395,1823
22307,9670,4592,5078,1116,2501,975,936,2891,1251
22308,12184,5959,6225,1705,2960,1294,1576,3032,1617
22309,29572,14153,15419,4485,7888,1780,4655,8674,2090
22310,25982,12502,13480,3206,7862,1434,3218,8523,1739
22311,16789,7960,8829,1606,5645,709,1790,5569,1470
22312,28443,14165,14278,4184,8701,1280,4031,8561,1686
22314,24887,12105,12782,2013,8477,1615,1640,9071,2071
22315,22006,10631,11375,2918,7048,665,2672,7823,880
22401,19279,8669,10610,2826,4635,1208,3955,4687,1968
22405,23401,11438,11963,3941,5995,1502,3697,6297,1969
22406,11409,5748,5661,1825,3415,508,1894,3265,502
22407,41305,20267,21038,7443,10924,1900,7030,11284,2724
22408,18326,8953,9373,3151,4892,910,2887,5246,1240
22427,3491,1774,1717,447,1042,285,454,806,457
22432,319,169,150,44,86,39,5,86,59
22433,57,27,30,0,27,0,0,24,6
22435,2043,976,1067,227,469,280,206,510,351
22436,656,326,330,109,138,79,86,161,83
22437,635,281,354,47,150,84,102,166,86
22438,623,294,329,82,161,51,97,156,76
22443,7505,3704,3801,1089,1828,787,953,1769,1079
22448,998,601,397,310,291,0,187,210,0
22454,1957,917,1040,253,475,189,266,540,234
22460,1894,964,930,266,407,291,190,396,344
22469,2073,961,1112,268,496,197,361,524,227
22473,5006,2421,2585,546,1140,735,557,1179,849
22476,432,190,242,53,110,27,58,134,50
22480,956,430,526,78,149,203,72,147,307
22482,2838,1258,1580,360,527,371,298,662,620
22485,15805,7927,7878,2579,4330,1018,2416,4229,1233
22488,1585,744,841,181,376,187,163,413,265
22503,4477,2087,2390,491,964,632,480,1083,827
22504,292,156,136,18,105,33,31,85,20
22507,27,6,21,0,0,6,0,0,21
22508,7407,3606,3801,948,1618,1040,853,1736,1212
22509,63,29,34,9,14,6,9,25,0
22511,1320,569,751,94,251,224,166,347,238
22514,1961,992,969,261,540,191,241,525,203
22520,5052,2438,2614,687,1141,610,632,1143,839
22529,112,44,68,11,18,15,24,20,24
22534,1998,990,1008,324,559,107,286,594,128
22535,491,235,256,64,118,53,82,127,47
22538,276,148,128,46,88,14,40,62,26
22539,2395,1141,1254,235,358,548,229,481,544
22542,1720,894,826,308,463,123,196,459,171
22546,10088,4972,5116,1584,2745,643,1473,2919,724
22548,26,10,16,0,0,10,0,16,0
22553,25422,12686,12736,4560,6770,1356,4283,6984,1469
22554,56774,28556,28218,11331,15621,1604,10480,15977,1761
22560,5470,2568,2902,670,1347,551,746,1449,707
22567,2097,1016,1081,282,531,203,352,531,198
22572,7280,4178,3102,925,2693,560,764,1479,859
22576,1689,871,818,269,294,308,123,389,306
22578,2740,1300,1440,329,532,439,236,635,569
22579,16,8,8,0,8,0,0,8,0
22580,4821,2405,2416,786,1236,383,699,1269,448
22601,24470,11752,12718,3594,6501,1657,3720,6421,2577
22602,21031,10486,10545,3338,5620,1528,3134,5767,1644
22603,11523,5875,5648,1621,3389,865,1391,3123,1134
22610,1790,922,868,275,475,172,188,502,178
22611,7580,3503,4077,987,1804,712,1065,2013,999
22620,2378,1229,1149,315,710,204,272,686,191
22624,2180,1149,1031,367,614,168,283,534,214
22625,2854,1461,1393,444,768,249,352,778,263
22626,7,0,7,0,0,0,0,0,7
22627,615,273,342,69,142,62,126,159,57
22630,25707,12469,13238,3955,6671,1843,3878,6772,2588
22637,1789,917,872,294,457,166,237,489,146
22639,644,302,342,87,140,75,99,183,60
22640,496,210,286,34,125,51,52,189,45
22641,140,79,61,12,47,20,7,23,31
22642,3477,1806,1671,521,1145,140,534,954,183
22643,106,57,49,20,20,17,7,34,8
22644,1883,942,941,317,465,160,275,497,169
22645,2873,1422,1451,397,782,243,375,762,314
22646,79,40,39,6,34,0,13,26,0
22650,998,520,478,128,308,84,96,282,100
22652,1023,455,568,105,226,124,184,259,125
22654,440,217,223,61,118,38,47,144,32
22655,13430,6521,6909,2331,3569,621,2277,3820,812
22656,2170,1058,1112,379,514,165,346,572,194
22657,8122,3919,4203,1094,2133,692,1180,2138,885
22660,1547,786,761,222,433,131,170,411,180
22663,1741,977,764,342,550,85,224,406,134
22664,7291,3534,3757,1036,1724,774,768,1748,1241
22701,21760,10625,11135,3467,5491,1667,3236,5786,2113
22709,861,448,413,161,224,63,149,221,43
22711,208,118,90,22,59,37,8,82,0
22712,6762,3378,3384,1281,1790,307,1214,1805,365
22713,693,319,374,78,212,29,100,215,59
22714,812,417,395,159,201,57,146,184,65
22715,1552,769,783,311,362,96,293,380,110
22716,895,472,423,115,273,84,82,230,111
22718,720,317,403,48,186,83,131,197,75
22719,213,105,108,7,77,21,30,52,26
22720,816,394,422,127,234,33,100,257,65
22722,75,49,26,31,18,0,5,14,7
22723,104,45,59,14,20,11,15,31,13
22724,1563,789,774,193,402,194,195,443,136
22726,654,343,311,144,159,40,94,165,52
22727,4441,2185,2256,632,1137,416,573,1108,575
22728,2890,1486,1404,518,816,152,444,768,192
22729,140,46,94,10,36,0,58,28,8
22730,233,121,112,24,55,42,25,55,32
22731,380,161,219,15,104,42,82,113,24
22732,325,212,113,83,106,23,19,62,32
22733,2415,1889,526,661,1105,123,135,254,137
22734,2669,1236,1433,429,734,73,554,764,115
22735,1980,951,1029,262,525,164,247,542,240
22736,278,114,164,36,78,0,82,82,0
22737,2963,1423,1540,397,797,229,511,823,206
22738,960,444,516,90,216,138,125,273,118
22740,1317,631,686,155,351,125,186,373,127
22741,196,89,107,23,60,6,31,51,25
22742,1763,883,880,271,531,81,266,517,97
22743,397,206,191,52,108,46,37,102,52
22746,299,157,142,50,60,47,23,88,31
22747,1078,553,525,143,302,108,139,278,108
22749,364,182,182,21,110,51,38,99,45
22801,33611,15974,17637,7771,6681,1522,9059,6318,2260
22802,21855,10593,11262,3314,5718,1561,3241,5735,2286
22810,619,283,336,38,118,127,53,141,142
22811,385,190,195,23,132,35,21,97,77
22812,8309,3886,4423,1414,1813,659,1505,1907,1011
22815,6814,3367,3447,969,1787,611,1005,1801,641
22820,285,126,159,15,85,26,45,78,36
22821,5550,2797,2753,963,1370,464,864,1316,573
22824,5615,2790,2825,744,1531,515,748,1436,641
22827,10971,5379,5592,1635,2827,917,1545,2890,1157
22830,1730,921,809,313,490,118,235,426,148
22831,710,394,316,120,220,54,91,166,59
22832,868,483,385,213,222,48,115,228,42
22834,1353,685,668,192,369,124,179,348,141
22835,11634,5703,5931,1743,2854,1106,1491,2900,1540
22840,3387,1692,1695,499,947,246,425,948,322
22841,2535,1237,1298,353,664,220,382,674,242
22842,4672,2353,2319,651,1242,460,681,1127,511
22843,2804,1451,1353,488,736,227,412,696,245
22844,4140,1979,2161,512,1093,374,574,1045,542
22845,40,15,25,0,6,9,5,7,13
22846,980,465,515,153,251,61,177,260,78
22847,932,462,470,118,219,125,77,243,150
22849,4450,2140,2310,586,1145,409,574,1214,522
22850,872,418,454,125,246,47,147,229,78
22851,5553,2763,2790,781,1479,503,851,1438,501
22853,3839,1890,1949,554,1014,322,498,997,454
22901,30799,14213,16586,4172,7641,2400,4063,9105,3418
22902,18409,8609,9800,2479,5022,1108,2591,5466,1743
22903,37669,17878,19791,7455,8704,1719,8601,8766,2424
22911,11965,5741,6224,2079,2842,820,1969,3397,858
22920,3468,1666,1802,477,991,198,492,1077,233
22922,1983,987,996,288,489,210,224,531,241
22923,3626,1843,1783,526,1097,220,551,969,263
22924,73,27,46,8,10,9,8,29,9
22931,272,111,161,41,51,19,42,77,42
22932,5121,2517,2604,834,1307,376,685,1392,527
22935,817,451,366,104,278,69,69,232,65
22936,4492,2201,2291,689,1220,292,665,1191,435
22937,1313,647,666,202,321,124,216,311,139
22938,1283,571,712,183,268,120,172,326,214
22939,3427,1609,1818,431,861,317,424,866,528
22940,1100,492,608,180,262,50,222,290,96
22942,7220,3421,3799,986,1876,559,926,2033,840
22943,575,270,305,72,149,49,94,171,40
22946,138,44,94,0,44,0,31,56,7
22947,3734,1914,1820,579,1045,290,428,1058,334
22948,231,101,130,23,63,15,21,86,23
22949,1439,694,745,232,355,107,202,362,181
22952,1754,785,969,168,481,136,263,509,197
22954,95,32,63,7,13,12,20,35,8
22957,39,14,25,0,14,0,11,14,0
22958,1535,752,783,137,366,249,129,409,245
22959,2030,1103,927,363,585,155,240,495,192
22960,9580,4626,4954,1410,2376,840,1304,2468,1182
22963,11147,5419,5728,1550,2709,1160,1492,2967,1269
22964,54,30,24,6,24,0,0,17,7
22967,1795,866,929,203,449,214,188,479,262
22968,8700,4360,4340,1522,2361,477,1388,2469,483
22969,1262,601,661,227,274,100,206,332,123
22971,1749,900,849,177,541,182,220,474,155
22972,317,163,154,29,62,72,18,98,38
22973,5236,2555,2681,769,1349,437,735,1402,544
22974,4039,1550,2489,453,888,209,509,1725,255
22976,376,145,231,40,88,17,64,105,62
22980,30520,14743,15777,4638,7584,2521,4101,8098,3578
22989,237,103,134,14,79,10,62,72,0
23001,10,10,0,0,10,0,0,0,0
23002,9259,4591,4668,1457,2405,729,1307,2431,930
23004,1234,638,596,192,294,152,181,307,108
23005,14308,6830,7478,2353,3563,914,2283,3771,1424
23009,4931,2370,2561,673,1421,276,761,1475,325
23011,1103,653,450,140,453,60,97,290,63
23015,3912,1952,1960,692,1024,236,628,1014,318
23021,320,148,172,36,79,33,33,82,57
23022,604,290,314,53,166,71,55,155,104
23023,114,47,67,7,20,20,21,28,18
23024,6216,3100,3116,986,1602,512,880,1762,474
23025,427,209,218,40,121,48,53,112,53
23027,1367,718,649,257,363,98,208,348,93
23030,4797,2386,2411,718,1304,364,629,1325,457
23032,388,213,175,71,94,48,41,88,46
23035,1366,710,656,154,334,222,99,323,234
23038,1780,875,905,261,436,178,270,401,234
23039,910,536,374,134,311,91,45,230,99
23040,3457,1550,1907,434,810,306,562,967,378
23043,1686,795,891,182,338,275,142,390,359
23045,151,53,98,0,36,17,31,36,31
23047,1751,832,919,204,508,120,262,455,202
23050,379,206,173,69,113,24,33,99,41
23055,1165,519,646,152,273,94,196,286,164
23056,381,206,175,46,122,38,37,94,44
23059,15683,7820,7863,2506,4536,778,2343,4585,935
23060,26940,12826,14114,4070,7804,952,4041,8648,1425
23061,19184,9296,9888,2966,4938,1392,2924,5079,1885
23062,2428,1202,1226,225,734,243,280,692,254
23063,4943,2069,2874,643,1033,393,556,1858,460
23064,155,87,68,25,29,33,6,24,38
23065,1399,698,701,173,424,101,196,390,115
23066,550,252,298,75,85,92,40,158,100
23068,361,156,205,33,88,35,38,110,57
23069,3810,2181,1629,778,1110,293,471,852,306
23070,253,111,142,9,52,50,18,64,60
23071,1219,605,614,144,315,146,140,292,182
23072,12009,5986,6023,2004,3165,817,1790,3205,1028
23075,9922,4585,5337,1760,2282,543,1610,2845,882
23076,546,272,274,41,125,106,40,118,116
23079,243,125,118,17,63,45,26,63,29
23083,1637,734,903,201,372,161,254,493,156
23084,1086,495,591,95,279,121,107,321,163
23085,513,271,242,110,117,44,69,125,48
23086,2422,1268,1154,399,706,163,318,683,153
23089,3814,1878,1936,519,995,364,470,1084,382
23091,309,142,167,39,80,23,46,72,49
23092,626,289,337,95,139,55,150,147,40
23093,9963,4735,5228,1335,2527,873,1543,2632,1053
23102,2657,1703,954,373,1203,127,177,638,139
23103,3633,1829,1804,464,1042,323,534,968,302
23106,791,416,375,125,232,59,84,234,57
23108,190,108,82,54,54,0,36,41,5
23109,2039,954,1085,252,471,231,327,481,277
23110,547,268,279,89,112,67,48,159,72
23111,30772,14911,15861,4757,8287,1867,4636,8682,2543
23112,38660,18951,19709,6931,10523,1497,6623,11246,1840
23113,31299,15307,15992,5453,8245,1609,4929,9004,2059
23115,95,58,37,11,47,0,6,26,5
23116,22868,11413,11455,4096,6036,1281,3528,6557,1370
23117,7286,3584,3702,953,1823,808,963,1930,809
23119,180,88,92,20,26,42,9,46,37
23120,2756,1328,1428,408,771,149,476,729,223
23123,1579,804,775,247,421,136,223,384,168
23124,2914,1377,1537,416,835,126,519,844,174
23125,68,22,46,0,0,22,0,15,31
23126,580,305,275,118,118,69,51,128,96
23128,925,483,442,172,217,94,129,249,64
23129,349,212,137,58,123,31,20,73,44
23130,169,96,73,42,29,25,15,32,26
23138,1350,629,721,140,282,207,147,299,275
23139,21057,11552,9505,3188,7169,1195,2723,5505,1277
23140,3453,1624,1829,464,875,285,434,961,434
23141,4831,2416,2415,729,1402,285,640,1489,286
23146,2774,1365,1409,385,731,249,344,741,324
23148,1631,798,833,251,430,117,209,465,159
23149,2508,1245,1263,359,664,222,324,646,293
23150,10968,5224,5744,1588,2914,722,1485,3163,1096
23153,594,310,284,126,124,60,69,181,34
23156,1550,760,790,204,411,145,190,414,186
23161,117,65,52,0,29,36,0,36,16
23163,166,82,84,0,47,35,0,43,41
23168,4386,2176,2210,690,1229,257,681,1224,305
23169,1168,544,624,126,247,171,142,293,189
23175,1846,830,1016,142,455,233,179,459,378
23176,690,306,384,96,158,52,103,186,95
23177,1014,450,564,113,255,82,141,282,141
23178,27,10,17,0,0,10,0,7,10
23180,415,201,214,76,89,36,50,117,47
23181,4326,2043,2283,545,1060,438,654,1113,516
23184,14,6,8,0,0,6,0,8,0
23185,37048,17642,19406,4810,8944,3888,5125,9353,4928
23186,3307,1457,1850,1259,198,0,1693,157,0
23188,23787,11681,12106,3533,5959,2189,3114,6424,2568
23192,5764,2859,2905,900,1549,410,833,1664,408
23219,2285,1171,1114,445,571,155,461,523,130
23220,30021,14623,15398,4382,8851,1390,4901,8108,2389
23221,13368,6341,7027,946,4599,796,1109,4614,1304
23222,27569,12381,15188,4629,5736,2016,4603,7322,3263
23223,43690,20256,23434,7093,10579,2584,7043,12247,4144
23224,31611,14296,17315,5493,7142,1661,6074,8879,2362
23225,38147,17282,20865,4718,10441,2123,4893,11664,4308
23226,18047,8564,9483,2921,4279,1364,2857,4406,2220
23227,22680,10074,12606,2637,5660,1777,2693,6461,3452
23228,31557,14781,16776,3924,8630,2227,3707,9240,3829
23229,31064,14778,16286,4323,7443,3012,3958,8374,3954
23230,7123,3404,3719,901,1950,553,975,1791,953
23231,27069,12452,14617,4361,6528,1563,4387,7853,2377
23233,50296,23425,26871,7622,12966,2837,7273,14962,4636
23234,38486,18602,19884,6424,9842,2336,6153,10961,2770
23235,29439,14088,15351,4348,7306,2434,3848,8129,3374
23236,23502,11460,12042,3625,6569,1266,3296,7061,1685
23237,20432,10216,10216,3568,5808,840,3256,5797,1163
23294,15715,7353,8362,1768,4712,873,1845,5362,1155
23298,0,0,0,0,0,0,0,0,0
23301,1929,982,947,296,496,190,254,464,229
23302,129,79,50,0,67,12,11,31,8
23303,645,325,320,168,122,35,114,176,30
23304,139,74,65,7,67,0,12,42,11
23306,1030,469,561,145,233,91,157,291,113
23307,1027,447,580,185,174,88,152,254,174
23308,2736,1353,1383,472,611,270,479,688,216
23310,5709,2698,3011,860,1193,645,883,1281,847
23314,4418,2169,2249,593,1197,379,683,1191,375
23315,1278,662,616,185,334,143,149,320,147
23316,147,67,80,18,41,8,25,44,11
23320,44424,21100,23324,6980,12022,2098,6640,13750,2934
23321,30045,14506,15539,5175,7558,1773,4771,8434,2334
23322,54528,27871,26657,9965,15768,2138,9177,14958,2522
23323,31471,15253,16218,5571,8051,1631,5403,8622,2193
23324,22111,9958,12153,3744,4733,1481,4063,5558,2532
23325,16605,7840,8765,2565,4036,1239,2573,4544,1648
23336,4324,2085,2239,476,1073,536,503,1039,697
23337,784,446,338,169,220,57,93,213,32
23347,289,126,163,30,59,37,40,85,38
23350,3629,1712,1917,517,792,403,464,911,542
23354,375,178,197,11,91,76,31,92,74
23356,1302,738,564,204,320,214,66,300,198
23357,627,326,301,118,152,56,79,126,96
23358,123,58,65,9,14,35,4,24,37
23359,816,391,425,115,224,52,127,209,89
23389,173,73,100,10,40,23,19,39,42
23395,1175,487,688,169,206,112,280,285,123
23401,216,94,122,24,44,26,35,50,37
23404,76,43,33,19,13,11,10,16,7
23405,852,444,408,128,183,133,113,170,125
23407,98,31,67,0,31,0,13,21,33
23409,120,63,57,8,48,7,9,40,8
23410,2520,1193,1327,429,526,238,330,679,318
23413,1065,511,554,150,222,139,126,246,182
23415,3684,1844,1840,617,910,317,656,841,343
23416,211,122,89,38,64,20,35,31,23
23417,4051,1808,2243,449,847,512,530,965,748
23418,820,384,436,136,183,65,126,223,87
23420,2919,1377,1542,491,635,251,396,786,360
23421,4349,2128,2221,784,989,355,550,1057,614
23423,414,175,239,37,86,52,34,92,113
23426,136,73,63,0,55,18,0,43,20
23427,352,148,204,29,77,42,37,78,89
23430,15121,7321,7800,2445,3781,1095,2119,4208,1473
23432,1076,480,596,129,270,81,177,291,128
23433,1097,601,496,174,271,156,77,272,147
23434,40257,19006,21251,6571,9755,2680,6425,10836,3990
23435,14947,7312,7635,2489,4059,764,2461,4196,978
23436,855,423,432,122,213,88,80,272,80
23437,4140,1993,2147,553,1093,347,563,1177,407
23438,1305,661,644,243,316,102,157,326,161
23440,691,345,346,84,206,55,98,169,79
23441,49,20,29,15,5,0,11,5,13
23442,1202,597,605,227,291,79,196,300,109
23451,41352,20887,20465,5365,12713,2809,4569,11611,4285
23452,61086,29780,31306,9925,16458,3397,9665,17086,4555
23454,63310,31381,31929,11363,17303,2715,10532,17357,4040
23455,43053,20974,22079,5901,11546,3527,5720,11788,4571
23456,75852,37954,37898,14217,21666,2071,13290,22072,2536
23457,3687,1831,1856,537,997,297,549,988,319
23459,1053,626,427,268,358,0,220,207,0
23461,901,704,197,384,320,0,117,80,0
23462,59253,28917,30336,10300,15948,2669,9510,17162,3664
23464,71771,34672,37099,12457,19238,2977,12186,20761,4152
23480,274,140,134,28,64,48,16,88,30
23487,5468,2671,2797,850,1487,334,843,1518,436
23488,330,144,186,81,48,15,71,93,22
23502,21453,10365,11088,3379,5425,1561,3315,5539,2234
23503,46809,29882,16927,11967,16273,1642,5823,8981,2123
23504,23568,9972,13596,5037,3625,1310,5512,5773,2311
23505,29647,14492,15155,5262,7767,1463,5188,7438,2529
23507,6635,3281,3354,568,2304,409,549,2245,560
23508,17833,8830,9003,3384,4577,869,3532,4276,1195
23509,12753,6076,6677,2005,3012,1059,1913,3249,1515
23510,5094,2893,2201,704,1928,261,654,1216,331
23513,29069,13798,15271,5003,7192,1603,5083,7700,2488
23517,4221,2098,2123,467,1456,175,497,1242,384
23518,29813,14700,15113,4414,8158,2128,4504,7766,2843
23521,3939,2582,1357,1255,1327,0,761,596,0
23523,7508,3066,4442,1444,1169,453,1638,1985,819
23601,25046,11763,13283,3730,6442,1591,3723,6827,2733
23602,41360,19552,21808,6789,10653,2110,6546,11986,3276
23603,3733,1995,1738,888,1012,95,654,941,143
23604,5738,3577,2161,1934,1643,0,1099,1062,0
23605,14258,7078,7180,2301,4011,766,2051,3939,1190
23606,25735,12213,13522,3654,6754,1805,3993,6887,2642
23607,26361,12376,13985,4982,5651,1743,4673,6663,2649
23608,41667,20223,21444,7531,11183,1509,7530,11910,2004
23651,1261,602,659,276,326,0,283,376,0
23661,14565,6842,7723,2017,3610,1215,2114,3748,1861
23662,11566,5796,5770,1945,3006,845,1613,3087,1070
23663,16334,8064,8270,3308,3793,963,3034,4132,1104
23664,10498,5283,5215,1510,2879,894,1331,2950,934
23665,14645,9422,5223,2168,7254,0,1962,3240,21
23666,48626,23316,25310,7464,12952,2900,7221,13664,4425
23669,42220,19606,22614,7145,9973,2488,8174,11009,3431
23690,2556,1304,1252,610,550,144,434,648,170
23691,89,47,42,29,18,0,17,25,0
23692,16712,8104,8608,2442,4325,1337,2187,4789,1632
23693,18484,9132,9352,3282,5157,693,3032,5399,921
23696,3432,1737,1695,526,882,329,427,933,335
23701,27265,12929,14336,3967,6500,2462,3727,7001,3608
23702,11283,5427,5856,2000,2762,665,1865,3020,971
23703,27625,14194,13431,5465,7253,1476,4217,7168,2046
23704,19330,8892,10438,3157,4348,1387,3301,4782,2355
23707,14913,6923,7990,2442,3590,891,2267,4004,1719
23708,149,95,54,44,51,0,16,38,0
23801,7268,4137,3131,2202,1935,0,1567,1564,0
23803,40979,19109,21870,6686,9629,2794,6763,10885,4222
23805,18210,8578,9632,2820,4375,1383,2409,4996,2227
23821,1754,823,931,274,430,119,266,436,229
23824,6998,3264,3734,972,1614,678,1021,1680,1033
23827,1374,684,690,223,307,154,172,325,193
23828,577,272,305,97,135,40,88,153,64
23829,2602,1956,646,314,1423,219,157,343,146
23830,1177,605,572,183,327,95,165,308,99
23831,24629,11860,12769,3684,6859,1317,4066,6984,1719
23832,25775,12657,13118,4561,7194,902,4187,7745,1186
23833,2092,1128,964,304,652,172,265,522,177
23834,24347,11593,12754,3870,5879,1844,3459,6431,2864
23836,8528,4167,4361,1367,2325,475,1370,2426,565
23837,3835,1963,1872,570,1004,389,468,919,485
23838,10745,5594,5151,1947,3138,509,1328,3302,521
23839,1079,528,551,164,259,105,180,256,115
23840,1398,711,687,177,366,168,211,329,147
23841,3185,1600,1585,460,884,256,362,900,323
23842,5471,2676,2795,827,1489,360,841,1515,439
23843,694,295,399,102,147,46,97,194,108
23844,810,368,442,125,192,51,144,180,118
23845,389,196,193,52,120,24,74,97,22
23846,842,396,446,122,168,106,117,195,134
23847,16153,9148,7005,2006,5984,1158,1924,3347,1734
23850,1029,507,522,227,208,72,150,260,112
23851,13412,6072,7340,1996,3086,990,1985,3607,1748
23856,1520,716,804,192,436,88,263,385,156
23857,424,215,209,49,110,56,23,117,69
23860,27343,12959,14384,4431,6498,2030,4289,7219,2876
23866,1886,946,940,291,471,184,218,497,225
23867,2361,1093,1268,263,576,254,352,578,338
23868,7661,4605,3056,859,3231,515,981,1349,726
23872,2207,1070,1137,258,585,227,296,608,233
23874,899,461,438,120,255,86,87,247,104
23875,8651,4233,4418,1407,2203,623,1285,2505,628
23876,512,238,274,91,92,55,76,132,66
23878,1317,623,694,155,346,122,221,343,130
23879,558,264,294,53,152,59,77,141,76
23881,4283,3038,1245,429,2380,229,343,681,221
23882,2541,1170,1371,329,584,257,331,695,345
23883,2341,1209,1132,412,618,179,315,607,210
23885,2561,1263,1298,338,691,234,262,767,269
23887,564,281,283,56,109,116,24,134,125
23888,2127,958,1169,321,451,186,305,581,283
23889,661,353,308,142,166,45,64,185,59
23890,6595,4431,2164,722,3322,387,596,1075,493
23893,558,282,276,99,124,59,58,150,68
23894,648,311,337,74,156,81,78,166,93
23897,537,268,269,88,110,70,49,139,81
23898,2161,1044,1117,306,599,139,302,649,166
23899,304,134,170,30,78,26,50,90,30
23901,14695,6844,7851,2556,3241,1047,2875,3151,1825
23915,1047,737,310,117,563,57,60,158,92
23917,3907,2213,1694,460,1381,372,432,816,446
23919,1887,904,983,208,418,278,233,492,258
23920,3652,1786,1866,511,968,307,550,926,390
23921,2077,944,1133,239,480,225,436,462,235
23922,3703,2337,1366,328,1683,326,337,603,426
23923,2403,1189,1214,353,569,267,365,523,326
23924,6649,3096,3553,912,1512,672,947,1690,916
23927,4496,2197,2299,595,1093,509,555,1144,600
23930,5842,2861,2981,991,1368,502,882,1427,672
23934,716,357,359,118,186,53,82,191,86
23936,7372,4563,2809,942,3135,486,858,1301,650
23937,2088,946,1142,289,474,183,338,581,223
23938,336,195,141,57,55,83,16,85,40
23939,75,41,34,19,22,0,12,22,0
23942,1109,551,558,158,303,90,148,302,108
23943,1107,985,122,797,160,28,31,58,33
23944,4490,2172,2318,658,1079,435,670,1063,585
23947,4344,2074,2270,576,1064,434,577,1056,637
23950,3063,1515,1548,388,762,365,325,808,415
23952,159,69,90,18,33,18,12,46,32
23954,1832,879,953,284,440,155,333,476,144
23958,2924,1415,1509,389,741,285,386,807,316
23959,1331,622,709,206,278,138,198,308,203
23960,1737,870,867,367,336,167,189,446,232
23962,121,65,56,18,39,8,16,24,16
23963,541,281,260,104,122,55,108,113,39
23964,1443,724,719,244,359,121,173,336,210
23966,1815,865,950,263,408,194,329,439,182
23967,1237,546,691,124,279,143,222,325,144
23968,807,375,432,91,200,84,113,183,136
23970,8185,3837,4348,1181,1937,719,1039,2125,1184
23974,4911,2874,2037,585,1863,426,504,955,578
23976,197,113,84,39,61,13,0,57,27
24011,29,0,29,0,0,0,4,21,4
24012,27218,12269,14949,3241,6638,2390,3518,7336,4095
24013,7984,3952,4032,1358,2055,539,1146,2053,833
24014,22476,10564,11912,2779,5958,1827,2821,6513,2578
24015,15418,7184,8234,1844,4353,987,1917,4468,1849
24016,9589,4987,4602,1424,2995,568,1166,2501,935
24017,23274,10680,12594,3788,4984,1908,3615,6314,2665
24018,28979,13796,15183,4003,7098,2695,3601,7882,3700
24019,24713,11641,13072,3445,6430,1766,3671,6884,2517
24020,78,0,78,0,0,0,78,0,0
24053,2738,1441,1297,412,768,261,269,706,322
24054,6596,3205,3391,983,1742,480,979,1838,574
24055,14626,7160,7466,2050,3630,1480,1964,3687,1815
24058,169,81,88,0,72,9,13,57,18
24059,848,449,399,181,195,73,81,250,68
24060,48595,26506,22089,12663,12001,1842,9870,9837,2382
24064,4837,2386,2451,673,1364,349,684,1327,440
24065,5784,2905,2879,820,1599,486,795,1543,541
24066,4613,2246,2367,588,1281,377,593,1246,528
24067,1956,982,974,185,620,177,198,580,196
24069,2158,1079,1079,304,608,167,283,610,186
24070,1142,546,596,137,364,45,141,363,92
24072,973,551,422,170,286,95,113,234,75
24073,25266,12339,12927,3664,7076,1599,3526,7175,2226
24076,869,463,406,149,273,41,110,221,75
24077,586,319,267,139,171,9,52,178,37
24078,7603,3554,4049,989,1901,664,968,2139,942
24079,1831,861,970,201,517,143,261,538,171
24082,275,126,149,37,75,14,37,90,22
24083,1908,977,931,275,504,198,234,465,232
24084,11232,5593,5639,1266,3486,841,1335,3236,1068
24085,2249,1137,1112,337,547,253,243,603,266
24086,195,101,94,24,55,22,18,46,30
24087,3659,1844,1815,603,940,301,512,973,330
24088,4199,2132,2067,724,1120,288,705,1044,318
24089,2316,1151,1165,264,596,291,239,566,360
24090,4021,2013,2008,528,1170,315,474,1130,404
24091,6222,2978,3244,767,1517,694,779,1555,910
24092,2608,1316,1292,327,759,230,289,734,269
24093,302,131,171,36,59,36,42,60,69
24094,49,33,16,13,11,9,0,10,6
24095,4163,2109,2054,643,1232,234,566,1229,259
24101,5210,2663,2547,696,1432,535,691,1443,413
24102,1747,789,958,215,426,148,268,515,175
24104,3170,1657,1513,437,711,509,276,713,524
24105,364,216,148,64,100,52,6,99,43
24112,34901,16444,18457,4710,8648,3086,4747,9087,4623
24120,2023,945,1078,171,484,290,323,412,343
24121,8879,4588,4291,1024,2356,1208,791,2257,1243
24122,2019,1024,995,285,534,205,286,532,177
24124,4541,2125,2416,599,1154,372,571,1218,627
24127,4237,2131,2106,648,1104,379,629,1033,444
24128,1881,955,926,252,557,146,195,550,181
24131,190,114,76,0,102,12,27,28,21
24132,452,163,289,48,88,27,99,125,65
24133,2559,1203,1356,269,750,184,388,783,185
24134,5472,2733,2739,790,1409,534,667,1435,637
24136,3112,1528,1584,363,938,227,413,822,349
24137,2415,1265,1150,275,787,203,267,665,218
24138,1439,732,707,224,389,119,202,397,108
24139,387,204,183,42,129,33,27,110,46
24141,18834,9088,9746,2937,4874,1277,3313,4596,1837
24142,2765,1018,1747,920,98,0,1620,127,0
24147,1010,509,501,125,276,108,108,271,122
24148,8372,4159,4213,1160,2256,743,999,2290,924
24149,2659,1233,1426,280,756,197,435,758,233
24150,397,182,215,88,74,20,55,104,56
24151,18209,8764,9445,2633,4549,1582,2623,4694,2128
24153,35523,16836,18687,5028,8574,3234,4879,9060,4748
24161,362,195,167,40,115,40,44,99,24
24162,2513,1225,1288,337,678,210,357,686,245
24165,1619,811,808,163,470,178,206,412,190
24167,235,125,110,38,79,8,32,48,30
24168,419,198,221,58,120,20,51,105,65
24171,9278,4465,4813,1194,2314,957,1163,2286,1364
24174,2441,1246,1195,356,701,189,281,704,210
24175,8321,4191,4130,1108,2244,839,1141,2158,831
24176,1041,523,518,66,313,144,99,299,120
24179,17495,8348,9147,2435,4525,1388,2261,4766,2120
24184,3150,1506,1644,432,802,272,461,840,343
24185,956,462,494,129,242,91,110,254,130
24201,16610,7528,9082,2138,3819,1571,2050,4262,2770
24202,12232,6124,6108,1721,3250,1153,1453,3349,1306
24210,14532,6746,7786,1574,3766,1406,1585,4068,2133
24211,9018,4483,4535,1243,2425,815,1111,2428,996
24215,98,46,52,0,37,9,22,15,15
24216,3162,1491,1671,451,792,248,448,843,380
24217,526,245,281,89,137,19,65,145,71
24218,111,61,50,19,20,22,12,38,0
24219,11109,5441,5668,1683,2808,950,1434,2989,1245
24220,806,396,410,124,215,57,148,204,58
24221,1198,565,633,158,342,65,183,325,125
24224,6862,3339,3523,946,1799,594,935,1860,728
24225,1991,1026,965,279,559,188,230,546,189
24226,1832,890,942,279,470,141,215,493,234
24228,7515,3654,3861,980,1964,710,949,2003,909
24230,9400,4692,4708,1571,2424,697,1350,2498,860
24236,3166,1441,1725,382,772,287,411,832,482
24237,1114,580,534,168,260,152,99,261,174
24239,251,151,100,61,75,15,14,54,32
24243,2311,1094,1217,278,623,193,352,583,282
24244,5392,2669,2723,823,1365,481,682,1356,685
24245,1187,576,611,164,315,97,151,300,160
24248,2697,1348,1349,446,682,220,270,769,310
24250,1328,646,682,137,331,178,131,378,173
24251,8887,4284,4603,1086,2322,876,1089,2282,1232
24256,2651,1256,1395,393,693,170,408,736,251
24258,1676,759,917,195,434,130,277,494,146
24260,6184,3037,3147,830,1822,385,783,1748,616
24263,5576,2753,2823,753,1475,525,732,1402,689
24265,831,425,406,159,207,59,120,227,59
24266,8999,4420,4579,1347,2313,760,1134,2393,1052
24269,112,54,58,7,28,19,12,19,27
24270,520,247,273,72,138,37,79,137,57
24271,2622,1281,1341,303,721,257,341,677,323
24272,596,332,264,118,194,20,69,164,31
24273,6359,2916,3443,839,1578,499,919,1716,808
24277,5711,2690,3021,740,1452,498,785,1451,785
24279,4702,2348,2354,707,1235,406,617,1265,472
24280,712,342,370,74,218,50,79,213,78
24281,2303,1059,1244,293,510,256,324,576,344
24282,1063,526,537,195,249,82,155,258,124
24283,2153,969,1184,256,511,202,377,510,297
24285,55,22,33,0,8,14,7,4,22
24290,2036,925,1111,233,465,227,231,524,356
24292,572,270,302,12,209,49,69,142,91
24293,10599,5196,5403,1723,2741,732,1668,2737,998
24301,14966,7186,7780,1887,4006,1293,1811,3936,2033
24311,2098,1009,1089,311,592,106,284,581,224
24312,2419,1248,1171,407,613,228,243,661,267
24313,760,396,364,102,214,80,100,225,39
24314,1578,774,804,206,440,128,241,417,146
24315,3776,2179,1597,526,1372,281,335,866,396
24316,38,14,24,0,14,0,10,14,0
24317,4115,2155,1960,676,1151,328,514,1000,446
24318,728,347,381,78,205,64,109,191,81
24319,7197,3463,3734,1034,1819,610,853,1912,969
24322,256,104,152,9,66,29,27,68,57
24323,919,488,431,142,280,66,105,244,82
24324,2342,1208,1134,344,659,205,256,672,206
24325,1007,489,518,151,250,88,177,236,105
24326,1253,635,618,134,333,168,126,293,199
24327,466,241,225,222,9,10,200,25,0
24328,1308,649,659,156,382,111,122,350,187
24330,3594,1668,1926,420,914,334,491,909,526
24333,17603,8557,9046,2365,4530,1662,2148,4633,2265
24340,5486,2564,2922,723,1371,470,839,1472,611
24343,8959,4406,4553,1185,2209,1012,920,2315,1318
24347,1853,984,869,290,523,171,181,476,212
24348,4304,2130,2174,559,1134,437,470,1103,601
24350,1282,641,641,176,358,107,138,326,177
24351,554,253,301,87,120,46,86,151,64
24352,963,455,508,126,249,80,114,240,154
24354,16028,7720,8308,2102,4191,1427,2119,4249,1940
24360,5507,2654,2853,706,1570,378,865,1553,435
24361,5178,2649,2529,780,1479,390,686,1374,469
24363,1565,810,755,198,400,212,182,372,201
24366,1193,644,549,143,329,172,108,286,155
24368,4213,2055,2158,598,1065,392,655,1049,454
24370,6896,3314,3582,903,1732,679,913,1764,905
24374,806,387,419,137,213,37,116,239,64
24375,1436,715,721,190,343,182,195,346,180
24377,431,231,200,79,142,10,51,95,54
24378,2341,1631,710,188,1239,204,162,343,205
24380,2639,1292,1347,365,725,202,424,633,290
24381,3789,2021,1768,568,1120,333,352,1014,402
24382,13617,6289,7328,1713,3263,1313,1594,3626,2108
24401,34137,16302,17835,4321,8951,3030,4785,8566,4484
24412,71,24,47,0,13,11,6,24,17
24413,265,141,124,26,61,54,20,71,33
24415,8,0,8,0,0,0,0,0,8
24416,8695,4116,4579,1181,2176,759,1286,2214,1079
24421,3886,1928,1958,544,1118,266,490,1114,354
24422,6990,3213,3777,877,1660,676,881,1721,1175
24426,15298,7518,7780,2078,3884,1556,1870,3893,2017
24430,2368,1537,831,231,1121,185,214,393,224
24431,2556,1296,1260,435,652,209,332,691,237
24432,310,159,151,57,84,18,49,76,26
24433,116,52,64,3,28,21,0,35,29
24435,1544,840,704,251,434,155,89,426,189
24437,797,401,396,145,168,88,90,189,117
24439,1391,674,717,191,350,133,213,372,132
24440,2682,1592,1090,274,1135,183,266,668,156
24441,5334,2598,2736,775,1447,376,789,1454,493
24442,119,60,59,4,24,32,14,14,31
24445,2659,1332,1327,376,676,280,280,693,354
24448,305,161,144,30,83,48,27,69,48
24450,15533,8245,7288,3418,3400,1427,2163,3371,1754
24457,278,130,148,28,53,49,11,90,47
24458,585,296,289,76,149,71,90,127,72
24459,754,402,352,114,204,84,90,144,118
24460,1910,950,960,269,513,168,292,509,159
24463,18,11,7,0,11,0,0,0,7
24464,101,52,49,0,48,4,11,25,13
24465,1416,699,717,192,352,155,139,376,202
24467,2056,977,1079,261,573,143,322,570,187
24471,1493,715,778,206,434,75,277,412,89
24472,2280,1153,1127,377,589,187,288,618,221
24473,921,467,454,121,246,100,110,231,113
24474,165,93,72,18,55,20,21,23,28
24475,355,176,179,55,92,29,93,52,34
24477,8615,4263,4352,1402,2199,662,1179,2368,805
24479,1301,596,705,168,299,129,218,348,139
24482,4309,2147,2162,630,1175,342,577,1220,365
24483,524,272,252,75,156,41,51,127,74
24484,900,466,434,134,254,78,87,251,96
24485,326,186,140,47,115,24,6,90,44
24486,2170,1128,1042,378,592,158,249,607,186
24487,202,112,90,24,51,37,7,44,39
24501,25373,11640,13733,4039,5888,1713,4205,6672,2856
24502,32277,15167,17110,5267,7315,2585,5299,7986,3825
24503,17706,8012,9694,2411,4051,1550,2789,4503,2402
24504,9724,4663,5061,1394,2482,787,1277,2509,1275
24517,5429,2494,2935,806,1200,488,693,1485,757
24520,2328,1197,1131,452,578,167,236,580,315
24521,10134,4940,5194,1584,2505,851,1400,2659,1135
24522,8620,4113,4507,1204,2152,757,1182,2330,995
24523,18215,8704,9511,2346,4430,1928,2436,4632,2443
24526,1859,956,903,247,524,185,179,473,251
24527,2961,1391,1570,388,796,207,441,881,248
24528,3297,1488,1809,433,740,315,492,795,522
24529,1753,872,881,231,402,239,164,443,274
24530,939,446,493,135,208,103,113,258,122
24531,8720,4274,4446,1241,2251,782,1058,2172,1216
24533,122,70,52,28,32,10,8,36,8
24534,2166,1053,1113,324,496,233,296,540,277
24536,237,118,119,44,65,9,41,58,20
24538,3632,1847,1785,600,935,312,533,855,397
24539,136,61,75,12,22,27,8,38,29
24540,33586,15412,18174,4661,7772,2979,4614,8923,4637
24541,31029,14485,16544,4525,7265,2695,4206,8120,4218
24549,4379,2207,2172,711,1208,288,641,1184,347
24550,7421,3659,3762,1168,2015,476,1070,2151,541
24551,16447,8003,8444,2543,4427,1033,2509,4717,1218
24553,1738,849,889,269,414,166,259,407,223
24554,4363,2343,2020,722,1217,404,421,1142,457
24555,1941,972,969,253,480,239,246,437,286
24556,2847,1385,1462,415,762,208,391,840,231
24557,8164,3762,4402,1061,1940,761,1104,2141,1157
24558,6601,3240,3361,978,1709,553,780,1800,781
24562,281,167,114,52,92,23,17,70,27
24563,5616,2753,2863,755,1478,520,726,1485,652
24565,1312,639,673,199,308,132,187,302,184
24566,1263,577,686,161,306,110,159,378,149
24569,1064,517,547,167,255,95,151,294,102
24571,1839,877,962,236,441,200,318,394,250
24572,16683,8051,8632,2324,4293,1434,2233,4653,1746
24574,3706,1906,1800,683,913,310,608,885,307
24577,5667,2814,2853,878,1400,536,728,1394,731
24578,1019,496,523,85,290,121,103,300,120
24579,1631,835,796,268,405,162,207,381,208
24580,756,356,400,116,213,27,136,198,66
24581,35,14,21,0,7,7,0,11,10
24586,5507,2745,2762,838,1498,409,748,1443,571
24588,8662,4284,4378,1318,2465,501,1279,2406,693
24589,2459,1213,1246,407,626,180,316,679,251
24590,6946,3357,3589,1116,1729,512,887,2056,646
24592,13986,6236,7750,1751,3176,1309,1986,3569,2195
24593,2022,986,1036,321,478,187,258,543,235
24594,1669,744,925,187,431,126,284,514,127
24595,780,20,760,3,17,0,617,139,4
24597,1237,625,612,196,325,104,156,351,105
24598,2063,1004,1059,263,502,239,288,513,258
24599,519,251,268,33,157,61,46,138,84
24601,226,81,145,18,49,14,52,65,28
24602,711,363,348,132,208,23,64,214,70
24603,1665,855,810,248,486,121,224,493,93
24604,271,128,143,8,102,18,43,64,36
24605,10247,4707,5540,1234,2371,1102,1348,2580,1612
24606,443,198,245,26,144,28,43,132,70
24607,449,263,186,68,135,60,30,118,38
24609,8928,4867,4061,1078,3141,648,1057,2249,755
24612,282,163,119,42,79,42,23,52,44
24613,1266,631,635,219,350,62,171,393,71
24614,9600,4680,4920,1380,2543,757,1316,2607,997
24620,3107,1468,1639,429,841,198,484,931,224
24622,1301,615,686,201,308,106,202,336,148
24624,69,36,33,10,20,6,0,25,8
24628,400,175,225,57,73,45,43,112,70
24630,6179,2922,3257,872,1566,484,768,1799,690
24631,2696,1759,937,362,1300,97,236,534,167
24634,445,243,202,91,107,45,42,107,53
24635,639,313,326,87,162,64,75,145,106
24637,2626,1265,1361,332,739,194,388,810,163
24639,3481,1671,1810,415,1001,255,494,1012,304
24641,7025,3293,3732,938,1799,556,893,1972,867
24646,899,478,421,155,244,79,100,258,63
24649,2333,1114,1219,285,657,172,336,684,199
24651,5790,2769,3021,727,1518,524,718,1602,701
24656,3999,1984,2015,543,1048,393,482,1077,456
24657,398,199,199,71,91,37,24,105,70
24701,21203,9950,11253,2830,5157,1963,2719,5425,3109
24712,2337,1256,1081,531,529,196,396,471,214
24714,116,59,57,24,23,12,5,43,9
24715,703,328,375,86,175,67,52,211,112
24716,689,398,291,112,226,60,51,168,72
24719,261,164,97,76,60,28,10,43,44
24724,185,111,74,33,54,24,17,39,18
24726,391,199,192,36,100,63,40,104,48
24731,130,67,63,14,35,18,21,29,13
24733,1475,766,709,253,411,102,186,378,145
24736,1157,559,598,201,252,106,190,322,86
24737,759,371,388,93,140,138,91,156,141
24739,87,39,48,9,24,6,13,26,9
24740,30385,14154,16231,4007,7324,2823,4070,7961,4200
24747,3144,1599,1545,456,906,237,417,833,295
24801,5208,2399,2809,680,1271,448,691,1324,794
24808,579,267,312,78,144,45,75,169,68
24811,528,220,308,76,111,33,85,182,41
24813,461,245,216,86,127,32,60,106,50
24815,781,363,418,122,166,75,114,206,98
24816,41,20,21,4,10,6,0,21,0
24817,967,424,543,128,219,77,175,260,108
24818,1638,835,803,247,489,99,220,460,123
24821,299,138,161,44,70,24,57,81,23
24822,304,151,153,57,72,22,56,63,34
24823,1132,564,568,150,296,118,133,343,92
24824,83,46,37,19,27,0,0,37,0
24825,532,276,256,92,136,48,65,131,60
24827,1538,803,735,239,489,75,205,431,99
24828,1103,531,572,166,298,67,190,301,81
24829,103,24,79,10,6,8,31,37,11
24830,210,105,105,14,46,45,15,47,43
24831,89,29,60,7,10,12,4,36,20
24836,705,312,393,85,120,107,73,137,183
24839,1916,963,953,277,537,149,221,518,214
24842,186,95,91,35,39,21,26,53,12
24843,79,45,34,6,25,14,9,16,9
24844,2663,1283,1380,365,719,199,348,754,278
24845,105,33,72,10,23,0,20,32,20
24846,28,18,10,4,5,9,6,4,0
24848,248,117,131,36,58,23,52,52,27
24849,420,218,202,67,113,38,83,93,26
24850,1175,546,629,158,299,89,172,352,105
24851,543,269,274,73,157,39,72,139,63
24852,389,157,232,74,48,35,54,108,70
24853,1045,495,550,148,243,104,151,254,145
24854,986,501,485,146,267,88,133,269,83
24855,52,32,20,5,22,5,0,10,10
24856,98,52,46,18,34,0,10,36,0
24857,722,281,441,80,136,65,143,206,92
24860,246,92,154,12,62,18,37,74,43
24861,277,132,145,41,64,27,22,93,30
24862,752,403,349,135,204,64,90,215,44
24866,615,294,321,85,172,37,85,170,66
24867,333,141,192,52,77,12,51,72,69
24868,1578,737,841,249,347,141,196,406,239
24869,199,109,90,15,82,12,40,42,8
24870,4221,2076,2145,661,1074,341,516,1153,476
24871,678,322,356,74,180,68,78,162,116
24872,873,444,429,138,266,40,102,278,49
24873,638,313,325,102,148,63,67,166,92
24874,4000,1954,2046,520,1042,392,475,1118,453
24879,528,282,246,109,135,38,69,144,33
24880,233,112,121,38,61,13,26,61,34
24881,834,388,446,114,243,31,120,235,91
24882,147,80,67,35,39,6,18,43,6
24884,278,149,129,45,88,16,40,77,12
24887,83,33,50,14,19,0,17,20,13
24888,120,57,63,16,20,21,14,25,24
24892,2416,1178,1238,344,673,161,378,583,277
24894,154,81,73,33,37,11,23,38,12
24895,105,53,52,9,34,10,9,21,22
24897,91,44,47,18,10,16,18,17,12
24898,124,88,36,57,31,0,18,18,0
24901,7446,3415,4031,811,1887,717,931,2062,1038
24910,5728,2218,3510,677,1211,330,664,2342,504
24915,543,280,263,56,155,69,77,118,68
24916,301,135,166,22,94,19,60,81,25
24918,1520,797,723,225,426,146,164,385,174
24919,75,37,38,0,20,17,8,9,21
24920,335,187,148,47,85,55,16,87,45
24924,405,190,215,28,108,54,34,105,76
24925,712,341,371,82,194,65,72,206,93
24927,409,255,154,103,105,47,45,87,22
24931,1572,781,791,209,439,133,162,432,197
24934,516,258,258,53,123,82,68,111,79
24935,495,222,273,51,135,36,67,135,71
24936,167,77,90,31,46,0,27,52,11
24938,1673,811,862,283,417,111,193,454,215
24941,1156,588,568,164,341,83,176,276,116
24943,117,72,45,37,35,0,18,27,0
24944,609,310,299,94,155,61,87,163,49
24945,253,107,146,18,74,15,16,82,48
24946,1650,929,721,178,586,165,136,388,197
24950,34,23,11,15,8,0,5,6,0
24951,1922,949,973,266,453,230,270,418,285
24954,3746,1853,1893,538,924,391,465,971,457
24957,192,79,113,14,41,24,37,50,26
24962,49,15,34,0,0,15,0,0,34
24963,3308,1581,1727,444,826,311,428,873,426
24966,1586,793,793,251,408,134,206,399,188
24970,4876,2358,2518,680,1205,473,658,1239,621
24974,241,127,114,44,63,20,23,68,23
24976,1188,525,663,165,295,65,225,310,128
24977,372,208,164,59,104,45,13,88,63
24981,642,363,279,109,186,68,51,163,65
24983,2184,1038,1146,268,511,259,240,561,345
24984,161,82,79,13,56,13,11,39,29
24985,344,157,187,20,94,43,50,84,53
24986,5083,2506,2577,803,1153,550,546,1286,745
24991,577,304,273,148,127,29,106,135,32
25002,63,22,41,4,14,4,0,24,17
25003,3139,1665,1474,497,944,224,324,885,265
25005,341,186,155,69,112,5,34,97,24
25007,327,185,142,53,127,5,49,76,17
25008,523,260,263,79,148,33,57,125,81
25009,1656,876,780,279,490,107,247,408,125
25010,491,267,224,63,146,58,29,169,26
25011,659,304,355,106,147,51,104,196,55
25015,5255,2623,2632,803,1390,430,652,1372,608
25019,811,444,367,131,252,61,89,211,67
25021,275,134,141,66,43,25,54,55,32
25022,79,32,47,8,16,8,22,10,15
25024,792,379,413,82,224,73,90,234,89
25025,291,137,154,46,66,25,42,64,48
25028,241,98,143,26,43,29,49,69,25
25030,345,212,133,66,110,36,30,79,24
25031,711,338,373,50,208,80,67,147,159
25033,2033,951,1082,230,572,149,315,540,227
25035,1307,652,655,127,375,150,143,348,164
25036,1440,1178,262,83,976,119,52,151,59
25039,822,378,444,142,179,57,114,197,133
25040,664,324,340,100,160,64,66,164,110
25043,1641,800,841,262,403,135,245,384,212
25044,283,153,130,65,54,34,36,70,24
25045,6130,2980,3150,827,1602,551,846,1644,660
25047,352,199,153,77,94,28,25,79,49
25048,27,17,10,0,17,0,0,10,0
25049,349,169,180,52,92,25,61,99,20
25051,151,76,75,19,39,18,32,32,11
25053,3405,1640,1765,496,904,240,432,983,350
25054,587,313,274,98,158,57,80,136,58
25057,272,153,119,49,77,27,38,55,26
25059,686,352,334,127,187,38,84,194,56
25060,317,148,169,26,90,32,45,78,46
25063,1113,565,548,131,303,131,156,227,165
25064,10329,4777,5552,1419,2487,871,1178,2831,1543
25067,1854,882,972,296,430,156,260,517,195
25070,1090,519,571,138,276,105,126,279,166
25071,11467,5542,5925,1583,3004,955,1519,3222,1184
25075,694,329,365,125,187,17,102,168,95
25076,288,114,174,33,51,30,82,73,19
25081,635,281,354,83,151,47,100,199,55
25082,1368,728,640,206,400,122,149,391,100
25083,610,283,327,78,121,84,108,144,75
25085,1403,695,708,193,361,141,205,348,155
25086,1187,548,639,181,298,69,193,288,158
25088,43,18,25,4,14,0,12,7,6
25090,238,125,113,20,76,29,28,49,36
25102,333,167,166,43,88,36,45,78,43
25103,417,199,218,41,113,45,59,120,39
25106,654,325,329,72,185,68,83,157,89
25107,798,369,429,79,205,85,110,224,95
25108,455,236,219,75,128,33,70,103,46
25109,627,307,320,80,165,62,91,172,57
25110,534,254,280,61,90,103,51,135,94
25111,441,227,214,92,105,30,82,96,36
25113,1129,539,590,186,272,81,154,300,136
25114,304,138,166,28,81,29,60,67,39
25115,78,32,46,7,8,17,18,10,18
25118,388,138,250,36,59,43,86,89,75
25119,315,164,151,48,98,18,24,80,47
25121,1086,587,499,174,339,74,82,306,111
25123,3459,1728,1731,491,901,336,427,952,352
25124,1096,556,540,131,321,104,150,285,105
25125,1184,560,624,161,298,101,180,315,129
25126,280,126,154,24,82,20,15,81,58
25130,5621,2730,2891,814,1474,442,771,1541,579
25132,618,322,296,59,176,87,84,178,34
25133,985,463,522,161,255,47,152,279,91
25134,589,267,322,69,145,53,102,151,69
25136,2510,1351,1159,556,611,184,299,520,340
25139,481,257,224,83,151,23,66,130,28
25140,1624,873,751,271,460,142,193,413,145
25141,354,213,141,70,112,31,31,104,6
25143,8363,3985,4378,997,2284,704,1013,2309,1056
25148,272,129,143,73,46,10,52,68,23
25149,293,137,156,46,57,34,48,65,43
25150,118,36,82,8,20,8,17,39,26
25152,428,200,228,40,125,35,95,116,17
25154,843,399,444,96,242,61,122,227,95
25159,4548,2284,2264,633,1320,331,626,1278,360
25160,267,136,131,16,73,47,39,82,10
25161,1133,566,567,187,273,106,159,296,112
25162,615,300,315,57,139,104,42,142,131
25164,795,399,396,113,214,72,111,201,84
25165,114,57,57,16,29,12,15,24,18
25168,3422,1736,1686,587,912,237,443,991,252
25169,492,269,223,137,103,29,65,146,12
25173,882,442,440,149,225,68,123,243,74
25174,1316,617,699,190,327,100,200,371,128
25177,25012,11942,13070,3512,6179,2251,3158,6587,3325
25181,2725,1374,1351,356,796,222,360,710,281
25183,250,112,138,18,94,0,40,74,24
25186,903,438,465,143,207,88,105,212,148
25187,667,298,369,85,167,46,108,156,105
25193,572,280,292,81,153,46,75,138,79
25202,1229,606,623,238,299,69,151,383,89
25204,323,158,165,19,91,48,33,39,93
25205,167,81,86,11,51,19,19,52,15
25206,692,294,398,73,165,56,100,213,85
25208,469,249,220,72,155,22,47,138,35
25209,1316,611,705,193,286,132,141,370,194
25211,277,149,128,71,70,8,47,76,5
25213,4620,2194,2426,596,1293,305,695,1385,346
25214,723,336,387,88,192,56,90,180,117
25231,50,27,23,0,27,0,0,16,7
25234,1074,543,531,177,239,127,160,221,150
25235,888,476,412,151,224,101,110,236,66
25239,1613,793,820,255,403,135,214,447,159
25241,1441,751,690,268,371,112,216,357,117
25243,954,489,465,141,258,90,120,251,94
25244,784,417,367,125,222,70,110,208,49
25245,889,454,435,165,257,32,118,265,52
25247,442,227,215,62,126,39,52,130,33
25248,2926,1404,1522,377,802,225,419,824,279
25251,714,305,409,78,147,80,111,217,81
25252,968,460,508,165,218,77,137,291,80
25253,1950,900,1050,276,503,121,315,542,193
25259,703,387,316,117,220,50,124,152,40
25260,1740,865,875,241,423,201,195,443,237
25261,271,115,156,30,72,13,44,94,18
25262,1116,536,580,128,302,106,156,323,101
25264,416,237,179,95,111,31,37,101,41
25265,1657,817,840,257,398,162,200,408,232
25266,717,316,401,57,211,48,135,178,88
25267,866,429,437,102,231,96,115,248,74
25268,828,416,412,71,211,134,77,196,139
25270,934,437,497,114,218,105,126,226,145
25271,8072,3856,4216,1188,1909,759,1102,2044,1070
25275,2454,1214,1240,389,601,224,332,663,245
25276,8169,4017,4152,1275,2016,726,1147,2051,954
25279,376,206,170,67,103,36,44,84,42
25281,58,32,26,0,26,6,14,12,0
25283,338,171,167,36,98,37,32,102,33
25285,474,212,262,52,139,21,120,111,31
25286,1633,835,798,242,468,125,231,400,167
25287,697,427,270,108,220,99,79,122,69
25301,3391,1492,1899,255,982,255,304,838,757
25302,16405,7763,8642,2098,4218,1447,1867,4414,2361
25303,6933,3248,3685,813,1831,604,844,1927,914
25304,8754,3971,4783,1057,2099,815,907,2370,1506
25306,7376,3359,4017,921,1771,667,953,2063,1001
25309,12711,5864,6847,1588,3111,1165,1561,3492,1794
25311,11384,5352,6032,1508,2945,899,1573,3196,1263
25312,15967,7598,8369,2164,4214,1220,2177,4451,1741
25313,13821,6789,7032,2002,3846,941,1844,3974,1214
25314,15232,7115,8117,1998,3755,1362,2141,4256,1720
25315,3512,1630,1882,399,896,335,390,949,543
25320,5930,2921,3009,847,1556,518,839,1546,624
25401,43337,21575,21762,6787,11669,3119,6185,11555,4022
25411,10924,5400,5524,1386,2855,1159,1357,2766,1401
25413,5222,2600,2622,805,1456,339,777,1486,359
25414,13202,6532,6670,1932,3647,953,1821,3545,1304
25419,7267,3583,3684,1102,1945,536,1129,2051,504
25420,3654,1878,1776,660,1070,148,515,1121,140
25421,303,166,137,44,87,35,29,74,34
25422,1399,714,685,189,354,171,150,368,167
25425,10941,5576,5365,1597,3257,722,1525,3060,780
25427,10295,5137,5158,1573,2804,760,1592,2917,649
25428,6877,3353,3524,1049,1947,357,1130,1943,451
25430,6571,3224,3347,1013,1809,402,981,1834,532
25431,94,59,35,21,30,8,12,23,0
25434,1833,911,922,266,469,176,268,434,220
25437,582,286,296,74,142,70,68,160,68
25438,3168,1405,1763,477,713,215,582,906,275
25441,274,154,120,40,65,49,41,52,27
25442,1824,954,870,295,517,142,245,508,117
25443,5886,2904,2982,1035,1462,407,1070,1368,544
25444,695,356,339,131,198,27,127,185,27
25446,1062,492,570,133,297,62,169,324,77
25501,1175,563,612,183,282,98,200,279,133
25502,1139,586,553,211,262,113,142,293,118
25503,837,430,407,141,178,111,105,203,99
25504,10872,5234,5638,1448,2885,901,1463,2973,1202
25505,114,51,63,9,13,29,18,37,8
25506,5245,2609,2636,798,1422,389,765,1394,477
25507,1275,520,755,145,250,125,170,322,263
25508,9655,4707,4948,1357,2704,646,1323,2699,926
25510,5449,2604,2845,735,1439,430,770,1439,636
25511,1121,619,502,219,334,66,141,292,69
25512,1708,804,904,229,390,185,266,434,204
25514,4008,2012,1996,699,1027,286,595,1082,319
25515,2168,1038,1130,283,649,106,383,630,117
25517,1578,814,764,297,364,153,280,341,143
25520,1399,706,693,210,380,116,179,363,151
25521,907,459,448,93,262,104,99,240,109
25523,2976,1399,1577,411,716,272,453,784,340
25524,3661,1820,1841,643,948,229,568,1007,266
25526,19667,9522,10145,2999,5210,1313,2851,5507,1787
25529,1455,721,734,172,432,117,171,411,152
25530,6347,2995,3352,828,1518,649,858,1661,833
25534,336,175,161,63,92,20,48,86,27
25535,2780,1402,1378,387,787,228,334,770,274
25537,2253,1067,1186,238,651,178,281,637,268
25540,228,115,113,44,55,16,28,67,18
25541,8029,4022,4007,1158,2168,696,1031,2215,761
25544,91,44,47,9,19,16,7,32,8
25545,4722,2344,2378,786,1264,294,732,1310,336
25547,1432,694,738,191,397,106,211,392,135
25550,9049,4233,4816,1286,2074,873,1109,2375,1332
25555,2059,1097,962,403,549,145,258,525,179
25557,2030,1051,979,257,648,146,293,511,175
25559,1986,995,991,255,618,122,251,581,159
25560,7878,3928,3950,1272,2044,612,1095,2099,756
25564,998,457,541,135,207,115,116,286,139
25565,730,429,301,143,192,94,53,174,74
25567,683,326,357,80,210,36,106,183,68
25570,5888,2823,3065,849,1449,525,858,1529,678
25571,2127,1016,1111,322,550,144,307,569,235
25573,1224,643,581,181,333,129,160,281,140
25601,6836,3154,3682,846,1644,664,802,1770,1110
25606,1583,780,803,211,473,96,220,462,121
25607,1094,557,537,169,312,76,128,316,93
25608,1748,865,883,229,497,139,246,497,140
25611,821,408,413,174,193,41,90,265,58
25612,41,27,14,6,15,6,0,8,6
25617,1150,554,596,165,307,82,152,326,118
25621,2163,1103,1060,299,673,131,285,628,147
25624,161,77,84,17,30,30,30,38,16
25625,1220,595,625,197,297,101,160,317,148
25628,678,312,366,88,173,51,86,220,60
25630,760,399,361,133,210,56,87,202,72
25632,557,277,280,52,170,55,97,129,54
25634,217,127,90,42,73,12,14,52,24
25635,1532,717,815,248,370,99,257,415,143
25636,906,389,517,123,227,39,212,214,91
25637,998,462,536,116,260,86,114,272,150
25638,1227,623,604,194,357,72,193,292,119
25639,671,335,336,118,180,37,61,198,77
25644,0,0,0,0,0,0,0,0,0
25646,953,399,554,84,230,85,165,229,160
25647,575,259,316,65,153,41,72,175,69
25649,1110,638,472,140,438,60,132,257,83
25650,723,375,348,115,212,48,98,201,49
25651,249,136,113,52,64,20,34,51,28
25652,1363,667,696,193,386,88,162,371,163
25653,304,135,169,21,76,38,30,80,59
25654,252,138,114,54,65,19,23,53,38
25661,5669,2581,3088,754,1272,555,672,1657,759
25665,108,59,49,21,31,7,5,34,10
25666,215,129,86,54,62,13,16,60,10
25667,183,86,97,17,56,13,30,48,19
25669,1617,915,702,329,439,147,126,444,132
25670,7364,3611,3753,1211,1985,415,1178,2001,574
25671,1937,957,980,291,524,142,346,476,158
25672,243,118,125,43,56,19,23,72,30
25674,3139,1470,1669,511,746,213,531,866,272
25676,619,320,299,128,167,25,101,158,40
25678,1373,669,704,207,372,90,174,382,148
25682,1325,658,667,201,349,108,211,339,117
25685,133,60,73,23,37,0,28,34,11
25688,110,59,51,17,26,16,20,20,11
25691,614,314,300,95,138,81,50,188,62
25692,637,249,388,73,150,26,144,175,69
25696,190,105,85,21,52,32,42,32,11
25699,41,16,25,0,10,6,4,21,0
25701,25058,11848,13210,3420,6352,2076,3794,5996,3420
25702,8220,3767,4453,1067,1971,729,1061,2189,1203
25703,5671,2949,2722,1483,1224,242,1174,1133,415
25704,17214,8152,9062,2470,4028,1654,2284,4610,2168
25705,21654,10275,11379,3050,5218,2007,2910,5762,2707
25801,35194,16117,19077,4692,8432,2993,4896,9094,5087
25812,1995,896,1099,242,464,190,277,491,331
25813,5906,4125,1781,529,3270,326,438,1009,334
25817,943,494,449,190,262,42,129,246,74
25818,76,47,29,6,35,6,0,17,12
25820,265,148,117,48,83,17,19,68,30
25823,2619,1262,1357,295,689,278,333,731,293
25825,1656,794,862,224,431,139,254,433,175
25826,432,175,257,18,89,68,34,130,93
25827,2864,1330,1534,365,741,224,428,819,287
25831,1296,640,656,196,342,102,212,325,119
25832,3530,1732,1798,454,948,330,369,903,526
25836,505,256,249,69,148,39,69,128,52
25837,226,122,104,32,78,12,26,54,24
25839,353,172,181,48,80,44,42,102,37
25840,6659,3302,3357,1043,1776,483,810,1795,752
25841,441,223,218,50,109,64,44,131,43
25843,757,390,367,111,233,46,68,214,85
25844,1653,833,820,243,465,125,206,516,98
25845,374,165,209,24,97,44,34,93,82
25846,200,96,104,26,51,19,32,45,27
25847,1472,689,783,161,395,133,204,412,167
25848,328,163,165,63,77,23,50,93,22
25849,154,90,64,11,65,14,15,33,16
25853,214,98,116,26,39,33,24,33,59
25854,901,411,490,134,228,49,112,250,128
25855,37,19,18,9,10,0,0,10,8
25856,66,39,27,26,13,0,6,21,0
25857,552,256,296,66,155,35,75,156,65
25862,378,180,198,52,108,20,73,85,40
25864,590,292,298,102,142,48,84,138,76
25865,1825,925,900,310,477,138,254,411,235
25866,71,23,48,11,12,0,23,9,16
25868,498,258,240,80,154,24,64,146,30
25870,70,29,41,12,17,0,14,15,12
25871,290,137,153,49,62,26,37,82,34
25875,619,294,325,82,170,42,72,187,66
25878,466,228,238,50,130,48,42,140,56
25879,325,184,141,47,101,36,48,76,17
25880,7506,3697,3809,1203,1972,522,1052,2041,716
25882,2724,1298,1426,366,676,256,378,656,392
25901,12678,6087,6591,1767,3154,1166,1549,3378,1664
25902,741,375,366,156,163,56,110,174,82
25904,526,246,280,92,108,46,67,131,82
25907,55,35,20,24,4,7,7,7,6
25908,187,113,74,27,66,20,18,39,17
25909,64,25,39,2,11,12,10,14,15
25913,152,87,65,25,48,14,15,42,8
25915,351,150,201,54,87,9,59,104,38
25916,92,36,56,16,20,0,24,26,6
25917,2486,1184,1302,397,613,174,348,651,303
25918,4442,2170,2272,599,1194,377,590,1212,470
25920,172,68,104,23,45,0,42,37,25
25921,2005,953,1052,274,516,163,223,564,265
25922,395,213,182,59,97,57,33,102,47
25928,593,294,299,70,196,28,45,189,65
25932,446,238,208,99,122,17,42,140,26
25936,86,53,33,15,32,6,13,20,0
25938,1377,705,672,232,339,134,206,344,122
25942,205,102,103,15,69,18,24,60,19
25951,6673,3163,3510,906,1483,774,835,1524,1151
25958,735,357,378,76,228,53,120,215,43
25962,4410,2119,2291,568,1030,521,537,1081,673
25966,178,89,89,22,36,31,15,32,42
25969,1152,578,574,117,297,164,122,332,120
25971,484,227,257,50,124,53,69,132,56
25972,171,103,68,39,56,8,8,54,6
25976,2377,1145,1232,263,625,257,301,628,303
25977,43,17,26,3,9,5,15,11,0
25978,678,364,314,114,188,62,65,188,61
25979,716,331,385,101,180,50,80,200,105
25981,1169,591,578,120,279,192,108,286,184
25984,1917,911,1006,293,440,178,256,477,273
25985,478,281,197,86,141,54,33,108,56
25986,57,29,28,12,17,0,10,12,6
25989,116,51,65,25,26,0,23,25,17
26003,46234,21558,24676,6352,10927,4279,6559,11514,6603
26030,574,291,283,96,133,62,64,143,76
26031,2056,951,1105,260,500,191,291,552,262
26032,1465,783,682,413,321,49,350,278,54
26033,3520,1729,1791,552,869,308,462,884,445
26034,5320,2625,2695,701,1331,593,594,1275,826
26035,2454,1226,1228,354,702,170,280,692,256
26036,374,159,215,28,80,51,53,101,61
26037,7286,3469,3817,902,1875,692,872,1911,1034
26038,3539,1664,1875,417,853,394,520,905,450
26039,1011,541,470,191,306,44,166,262,42
26040,2345,1061,1284,303,515,243,303,581,400
26041,16835,8237,8598,2331,4398,1508,2096,4387,2115
26047,6538,3166,3372,809,1805,552,797,1857,718
26050,2190,1105,1085,331,573,201,378,475,232
26055,1901,951,950,255,553,143,271,530,149
26056,151,59,92,27,32,0,28,32,32
26059,3310,1594,1716,446,871,277,503,869,344
26060,1854,950,904,284,503,163,235,490,179
26062,22343,10598,11745,2821,5323,2454,2574,5662,3509
26070,9388,4463,4925,1162,2351,950,1212,2491,1222
26074,448,261,187,96,140,25,55,90,42
26075,423,196,227,54,102,40,55,104,68
26101,40559,19438,21121,5982,10110,3346,5659,10532,4930
26104,8622,3854,4768,955,1930,969,911,2176,1681
26105,12004,5623,6381,1611,2828,1184,1519,3162,1700
26133,1300,664,636,216,357,91,201,362,73
26134,1236,541,695,175,277,89,179,339,177
26136,688,344,344,93,196,55,90,165,89
26137,729,380,349,113,199,68,83,192,74
26138,89,49,40,16,15,18,8,23,9
26141,234,140,94,17,82,41,12,42,40
26142,2317,1129,1188,372,637,120,341,685,162
26143,4670,2375,2295,826,1181,368,603,1228,464
26146,966,449,517,91,247,111,157,247,113
26147,2448,1196,1252,330,613,253,353,600,299
26148,218,116,102,28,47,41,26,55,21
26149,2506,1201,1305,348,618,235,340,641,324
26150,5505,2733,2772,868,1479,386,809,1524,439
26151,648,332,316,110,184,38,108,169,39
26152,51,8,43,0,8,0,12,18,13
26155,8988,4354,4634,1248,2267,839,1152,2230,1252
26159,3130,1475,1655,392,728,355,438,809,408
26160,940,465,475,116,216,133,130,250,95
26161,453,228,225,65,127,36,53,127,45
26162,50,22,28,0,10,12,5,23,0
26164,7967,3809,4158,1088,1831,890,1091,1951,1116
26167,1065,522,543,173,284,65,175,253,115
26169,896,453,443,134,246,73,137,230,76
26170,5954,3071,2883,904,1640,527,759,1490,634
26175,3821,1867,1954,570,943,354,482,984,488
26178,780,400,380,120,191,89,119,161,100
26180,2420,1274,1146,340,728,206,308,685,153
26181,6553,3282,3271,902,1862,518,908,1804,559
26184,2027,1000,1027,292,576,132,291,592,144
26186,405,211,194,25,133,53,49,100,45
26187,5720,2680,3040,698,1526,456,842,1545,653
26201,19414,9373,10041,3176,4568,1629,3059,4852,2130
26202,615,246,369,59,115,72,84,191,94
26203,222,117,105,37,64,16,20,72,13
26205,3829,1846,1983,520,965,361,548,995,440
26206,3053,1420,1633,383,776,261,443,834,356
26208,952,495,457,150,270,75,144,227,86
26209,215,128,87,26,83,19,21,66,0
26210,128,77,51,36,19,22,16,23,12
26215,103,60,43,9,51,0,13,22,8
26217,485,280,205,64,148,68,67,99,39
26218,2414,1171,1243,304,705,162,367,665,211
26222,582,334,248,90,186,58,61,130,57
26224,223,135,88,31,61,43,18,47,23
26228,63,35,28,17,18,0,0,22,6
26230,179,102,77,45,42,15,22,49,6
26234,1313,700,613,218,295,187,172,283,158
26236,75,37,38,6,25,6,13,18,7
26237,298,174,124,59,90,25,38,64,22
26238,729,368,361,103,186,79,76,217,68
26241,14151,6740,7411,2047,3349,1344,1808,3681,1922
26250,4331,2104,2227,612,1075,417,551,1134,542
26253,3852,1867,1985,626,1005,236,587,1082,316
26254,419,225,194,68,126,31,44,102,48
26257,839,440,399,146,211,83,134,187,78
26259,145,76,69,16,46,14,17,39,13
26260,1101,547,554,163,276,108,116,277,161
26261,3436,1677,1759,449,789,439,352,812,595
26263,244,149,95,37,69,43,5,62,28
26264,556,267,289,72,138,57,87,148,54
26266,389,195,194,76,112,7,91,91,12
26267,130,60,70,7,26,27,19,31,20
26268,4,0,4,0,0,0,0,4,0
26269,1030,491,539,131,293,67,133,291,115
26270,860,454,406,129,252,73,95,225,86
26271,278,124,154,36,62,26,47,80,27
26273,1529,1131,398,202,846,83,123,211,64
26275,755,385,370,133,196,56,132,168,70
26276,320,177,143,31,91,55,19,76,48
26278,388,202,186,82,88,32,52,106,28
26280,2110,1029,1081,260,564,205,285,559,237
26282,106,53,53,9,32,12,18,35,0
26283,1817,889,928,289,469,131,287,486,155
26285,300,132,168,31,54,47,58,63,47
26287,3341,1681,1660,458,871,352,420,864,376
26288,3787,1810,1977,507,914,389,486,992,499
26289,77,28,49,0,16,12,11,16,22
26291,124,61,63,18,43,0,16,40,7
26292,802,376,426,66,183,127,71,185,170
26293,565,302,263,92,149,61,63,130,70
26294,730,363,367,60,220,83,87,181,99
26296,245,130,115,22,62,46,37,57,21
26298,132,75,57,47,28,0,15,37,5
26301,31126,14689,16437,4261,7698,2730,4055,7963,4419
26302,40,11,29,0,0,11,0,19,10
26320,977,490,487,124,263,103,134,261,92
26321,481,234,247,61,110,63,56,119,72
26323,569,273,296,106,134,33,83,149,64
26325,342,172,170,71,70,31,44,99,27
26327,99,39,60,16,13,10,23,8,29
26330,12682,6103,6579,1904,3086,1113,1786,3296,1497
26332,1513,695,818,203,362,130,278,430,110
26334,192,110,82,21,74,15,33,39,10
26335,1262,648,614,206,330,112,179,324,111
26337,1295,642,653,196,326,120,160,355,138
26338,513,292,221,105,119,68,54,104,63
26339,186,88,98,22,38,28,13,62,23
26342,431,221,210,45,105,71,49,109,52
26343,485,242,243,89,102,51,71,107,65
26346,957,475,482,146,254,75,150,246,86
26347,2000,1054,946,342,526,186,244,499,203
26348,229,109,120,37,58,14,36,59,25
26349,283,143,140,62,73,8,48,68,24
26351,3457,1752,1705,698,780,274,566,716,423
26354,10633,5079,5554,1389,2729,961,1344,2689,1521
26361,249,147,102,43,78,26,21,61,20
26362,3186,1546,1640,403,803,340,380,851,409
26366,163,68,95,38,26,4,33,48,14
26369,539,264,275,73,144,47,58,157,60
26372,607,262,345,69,148,45,124,177,44
26374,1356,646,710,165,385,96,220,389,101
26376,522,260,262,71,140,49,63,139,60
26377,674,384,290,143,190,51,57,172,61
26378,3610,1757,1853,496,890,371,460,921,472
26384,453,242,211,102,118,22,71,117,23
26385,3914,1959,1955,605,1103,251,561,1020,374
26386,2402,1181,1221,385,650,146,406,598,217
26404,827,396,431,143,200,53,124,215,92
26405,1069,565,504,135,316,114,44,290,170
26408,2480,1310,1170,412,685,213,336,642,192
26410,1088,540,548,182,236,122,123,260,165
26411,680,349,331,92,155,102,91,159,81
26412,782,410,372,70,266,74,91,189,92
26415,2677,1286,1391,359,731,196,408,673,310
26416,6988,3440,3548,1121,1699,620,1056,1661,831
26419,1208,564,644,148,312,104,192,335,117
26421,361,184,177,62,99,23,60,92,25
26422,747,340,407,125,152,63,97,198,112
26424,81,50,31,17,27,6,5,21,5
26425,1451,719,732,207,406,106,209,379,144
26426,5850,2908,2942,1040,1471,397,894,1385,663
26430,624,326,298,95,166,65,72,152,74
26431,6252,3032,3220,901,1576,555,935,1555,730
26435,136,59,77,29,30,0,32,45,0
26436,231,115,116,48,40,27,37,64,15
26437,619,290,329,73,145,72,103,172,54
26438,16,6,10,0,0,6,0,0,10
26440,1044,522,522,87,304,131,144,258,120
26443,385,195,190,83,94,18,51,104,35
26444,3238,1617,1621,510,806,301,459,841,321
26447,814,428,386,133,244,51,123,224,39
26448,1316,722,594,230,363,129,142,313,139
26451,743,353,390,106,186,61,106,217,67
26452,10481,4969,5512,1353,2714,902,1375,2769,1368
26456,4162,1998,2164,608,1008,382,654,1052,458
26463,170,105,65,48,48,9,8,57,0
26501,18892,9254,9638,2619,5220,1415,2602,5034,2002
26505,32566,16522,16044,6833,8287,1402,6453,7263,2328
26508,22002,10767,11235,3348,6029,1390,2985,6560,1690
26519,1494,743,751,203,432,108,218,429,104
26520,673,329,344,68,173,88,93,169,82
26521,374,192,182,55,106,31,40,87,55
26525,4014,2056,1958,594,1130,332,517,1014,427
26529,2600,1760,840,297,1357,106,247,456,137
26531,141,73,68,34,23,16,22,32,14
26534,654,311,343,97,161,53,92,168,83
26537,5861,2879,2982,846,1503,530,779,1459,744
26541,835,408,427,163,191,54,148,220,59
26542,2358,1139,1219,320,621,198,357,625,237
26543,94,46,48,0,41,5,7,34,7
26544,184,112,72,48,45,19,15,36,21
26547,1986,937,1049,280,522,135,309,605,135
26554,40986,19456,21530,5661,10089,3706,5453,10391,5686
26559,1046,500,546,168,248,84,109,274,163
26562,715,367,348,87,189,91,103,169,76
26563,408,171,237,34,101,36,45,138,54
26568,564,266,298,72,138,56,79,159,60
26570,3051,1479,1572,412,794,273,422,822,328
26571,2444,1168,1276,338,628,202,358,606,312
26572,203,81,122,17,64,0,72,43,7
26574,715,340,375,103,178,59,92,188,95
26575,828,404,424,138,165,101,83,197,144
26576,322,186,136,83,86,17,36,78,22
26581,767,355,412,128,167,60,120,190,102
26582,5026,2411,2615,716,1210,485,656,1260,699
26585,599,325,274,77,179,69,70,146,58
26586,198,106,92,55,51,0,39,53,0
26587,406,185,221,35,90,60,72,116,33
26588,2598,1276,1322,378,692,206,314,679,329
26589,739,346,393,76,222,48,126,207,60
26590,218,100,118,12,68,20,48,60,10
26591,1479,726,753,209,364,153,151,408,194
26601,5325,2828,2497,731,1568,529,628,1242,627
26610,1397,754,643,255,365,134,193,333,117
26611,329,165,164,38,93,34,52,85,27
26615,163,65,98,21,31,13,32,44,22
26617,128,56,72,6,31,19,18,28,26
26619,409,200,209,37,138,25,63,113,33
26621,982,489,493,122,294,73,153,252,88
26623,1325,662,663,159,381,122,155,364,144
26624,3073,1456,1617,438,675,343,449,728,440
26627,364,187,177,39,102,46,34,92,51
26629,267,94,173,16,62,16,78,89,6
26631,84,42,42,16,19,7,0,20,22
26634,77,37,40,11,19,7,8,24,8
26636,357,168,189,54,93,21,63,102,24
26638,0,0,0,0,0,0,0,0,0
26639,490,208,282,51,113,44,85,99,98
26641,66,49,17,10,34,5,0,11,6
26651,8948,4295,4653,1327,2205,763,1249,2396,1008
26656,505,227,278,81,128,18,104,129,45
26660,133,66,67,16,45,5,23,34,10
26662,617,315,302,98,186,31,53,183,66
26667,75,40,35,8,20,12,9,16,10
26671,154,80,74,36,36,8,36,30,8
26674,403,245,158,57,146,42,23,95,40
26676,502,246,256,90,126,30,55,156,45
26678,1164,598,566,183,324,91,119,365,82
26679,1795,909,886,275,502,132,237,465,184
26680,431,205,226,63,83,59,57,123,46
26681,1784,863,921,314,442,107,370,417,134
26684,109,57,52,23,27,7,0,40,12
26690,250,118,132,38,58,22,34,82,16
26691,371,181,190,48,88,45,44,92,54
26704,4730,2471,2259,773,1303,395,668,1160,431
26705,1047,543,504,175,249,119,129,254,121
26707,343,185,158,32,109,44,36,86,36
26710,1749,856,893,273,421,162,229,518,146
26711,2285,1183,1102,389,618,176,293,621,188
26714,180,91,89,36,50,5,30,59,0
26716,710,350,360,65,180,105,94,165,101
26717,1107,605,502,204,303,98,126,283,93
26719,2513,1173,1340,314,633,226,369,632,339
26720,170,102,68,32,35,35,0,32,36
26722,595,325,270,124,168,33,58,190,22
26726,12568,6061,6507,1985,2909,1167,1812,3135,1560
26731,270,111,159,33,60,18,61,79,19
26739,838,407,431,83,217,107,89,247,95
26743,1901,1030,871,336,565,129,220,490,161
26750,1095,505,590,155,258,92,174,284,132
26753,6055,2945,3110,825,1640,480,878,1619,613
26755,190,95,95,13,56,26,28,34,33
26757,5816,2698,3118,772,1338,588,958,1405,755
26761,784,383,401,129,206,48,102,231,68
26763,1118,568,550,220,245,103,135,284,131
26764,4126,2056,2070,629,1045,382,595,1068,407
26767,791,414,377,105,203,106,91,195,91
26801,1307,561,746,103,294,164,267,323,156
26802,1534,775,759,208,421,146,210,383,166
26804,719,367,352,127,174,66,109,155,88
26807,3166,1552,1614,417,787,348,384,758,472
26808,763,368,395,89,210,69,92,210,93
26810,350,142,208,18,63,61,41,81,86
26812,1595,784,811,229,403,152,210,380,221
26814,498,239,259,41,114,84,48,123,88
26815,699,380,319,104,184,92,58,189,72
26817,285,151,134,39,95,17,27,68,39
26818,601,323,278,105,192,26,77,178,23
26823,114,49,65,10,24,15,25,29,11
26833,2350,1237,1113,383,705,149,300,607,206
26836,6185,3060,3125,949,1518,593,855,1634,636
26838,21,12,9,2,7,3,0,6,3
26845,758,351,407,80,200,71,111,224,72
26847,5811,2796,3015,821,1409,566,739,1542,734
26851,1795,938,857,273,478,187,190,480,187
26852,776,429,347,127,193,109,63,197,87
26855,788,413,375,134,212,67,69,239,67
26865,280,120,160,15,60,45,50,74,36
26866,856,460,396,92,250,118,106,190,100
26884,511,258,253,72,124,62,80,133,40
26886,213,104,109,5,59,40,34,45,30
27006,10660,5416,5244,1675,2757,984,1226,2885,1133
27007,1451,700,751,280,348,72,235,403,113
27009,2220,1101,1119,320,669,112,283,657,179
27011,5281,2555,2726,761,1303,491,728,1377,621
27012,21365,10309,11056,3119,5833,1357,3052,6155,1849
27013,5324,2565,2759,780,1426,359,886,1415,458
27014,550,281,269,82,156,43,67,131,71
27016,1635,780,855,206,444,130,206,393,256
27017,8610,4470,4140,1248,2461,761,1065,2254,821
27018,7276,3588,3688,1037,1995,556,988,1981,719
27019,4376,2247,2129,679,1278,290,499,1249,381
27020,6143,3109,3034,1032,1659,418,947,1560,527
27021,15825,7757,8068,2484,4210,1063,2149,4453,1466
27022,1816,890,926,243,503,144,259,495,172
27023,9931,4819,5112,1506,2722,591,1465,2982,665
27024,2332,1232,1100,262,741,229,212,636,252
27025,10668,5140,5528,1525,2710,905,1524,2704,1300
27027,4331,2028,2303,587,1061,380,574,1112,617
27028,23384,11413,11971,3481,6100,1832,3296,6255,2420
27030,38900,18950,19950,5641,10041,3268,5155,10133,4662
27040,9429,4616,4813,1357,2485,774,1305,2627,881
27041,6959,3342,3617,907,1808,627,926,1914,777
27042,685,356,329,84,185,87,112,184,33
27043,5406,2775,2631,850,1568,357,702,1465,464
27045,7225,3518,3707,1006,1932,580,933,2050,724
27046,2136,1051,1085,264,673,114,278,639,168
27047,1214,552,662,184,295,73,194,337,131
27048,8320,4069,4251,1095,2306,668,1172,2288,791
27050,3823,1845,1978,543,1073,229,590,1103,285
27051,6920,3333,3587,946,1874,513,1014,1873,700
27052,10369,4963,5406,1398,2739,826,1528,2761,1117
27053,3041,1582,1459,527,852,203,388,745,326
27054,2422,1304,1118,495,626,183,379,550,189
27055,13012,6469,6543,1926,3386,1157,1646,3473,1424
27101,19807,9389,10418,2907,5406,1076,3510,4979,1929
27103,27792,13121,14671,3699,7327,2095,3371,8116,3184
27104,27134,12609,14525,3254,6897,2458,2962,8015,3548
27105,40681,19242,21439,6846,9480,2916,6168,10764,4507
27106,39492,18581,20911,6007,9869,2705,5797,10920,4194
27107,38986,18908,20078,6504,9785,2619,6312,10354,3412
27109,1630,899,731,787,112,0,642,89,0
27127,26252,12379,13873,3787,6983,1609,3748,7785,2340
27202,29,13,16,0,5,8,0,7,9
27203,49927,24412,25515,7498,13448,3466,7444,12971,5100
27207,3836,1910,1926,558,1116,236,510,1073,343
27208,1677,797,880,235,447,115,243,457,180
27209,3846,1971,1875,701,988,282,587,871,417
27212,1498,655,843,208,327,120,207,433,203
27214,6198,3078,3120,961,1694,423,822,1739,559
27215,33564,15962,17602,4662,8368,2932,4328,8874,4400
27217,34125,16391,17734,5292,8573,2526,4811,9035,3888
27229,3879,1950,1929,716,992,242,634,918,377
27231,2144,1091,1053,355,579,157,308,586,159
27233,3574,1726,1848,518,911,297,523,973,352
27235,2373,1111,1262,279,630,202,392,660,210
27239,8599,4207,4392,1236,2343,628,1122,2420,850
27242,2266,1059,1207,428,458,173,449,538,220
27243,3030,1449,1581,431,804,214,470,886,225
27244,10619,5011,5608,2106,2298,607,2553,2323,732
27248,4653,2246,2407,614,1296,336,710,1253,444
27249,10961,5333,5628,1755,2885,693,1692,3007,929
27252,1444,663,781,162,345,156,182,371,228
27253,25120,12255,12865,3772,6596,1887,3400,6921,2544
27256,190,113,77,27,57,29,9,45,23
27258,5128,2612,2516,769,1497,346,731,1373,412
27260,25692,12212,13480,4622,6043,1547,4256,6606,2618
27262,23730,11306,12424,3675,5872,1759,3506,5944,2974
27263,19022,9325,9697,2705,5067,1553,2563,5221,1913
27265,32991,15968,17023,4740,9176,2052,4665,9720,2638
27278,20588,9773,10815,3009,5569,1195,3061,6033,1721
27281,2630,1433,1197,548,593,292,324,611,262
27282,11564,5628,5936,1672,3243,713,1748,3345,843
27283,2885,1454,1431,424,785,245,352,822,257
27284,41838,20728,21110,6145,11977,2606,5498,12227,3385
27288,24831,11723,13108,3534,6017,2172,3133,6612,3363
27291,2365,1144,1221,407,555,182,383,578,260
27292,38836,19143,19693,5844,10501,2798,5293,10616,3784
27295,34156,16890,17266,4735,9259,2896,4810,8944,3512
27298,9643,4843,4800,1516,2667,660,1324,2624,852
27299,4123,2131,1992,672,1229,230,538,1145,309
27301,5733,2879,2854,857,1578,444,788,1560,506
27302,22156,10920,11236,3480,5953,1487,3108,6225,1903
27305,1603,728,875,214,434,80,264,502,109
27306,6436,3209,3227,1039,1570,600,765,1689,773
27310,4027,1986,2041,650,1084,252,669,1120,252
27311,3804,1912,1892,519,1109,284,488,1025,379
27312,12641,6022,6619,1630,3352,1040,1638,3526,1455
27313,6338,3149,3189,871,1787,491,837,1792,560
27314,586,301,285,67,167,67,74,129,82
27315,1597,760,837,210,420,130,181,430,226
27316,6780,3321,3459,1143,1701,477,1067,1671,721
27317,14178,7127,7051,2274,4004,849,2111,3892,1048
27320,39068,19188,19880,5769,10352,3067,5079,10338,4463
27325,6702,3365,3337,1103,1770,492,918,1613,806
27326,3795,1892,1903,542,990,360,487,993,423
27330,54853,27261,27592,9006,14519,3736,8167,14209,5216
27341,5050,2518,2532,704,1421,393,674,1324,534
27342,19,9,10,0,6,3,0,3,7
27343,1602,832,770,186,438,208,108,429,233
27344,15715,7907,7808,2375,4278,1254,2135,3956,1717
27349,4566,2302,2264,727,1274,301,682,1171,411
27350,5772,2932,2840,876,1640,416,757,1610,473
27355,2425,1200,1225,342,660,198,259,701,265
27356,3250,1625,1625,504,894,227,485,844,296
27357,6287,3243,3044,1017,1831,395,814,1699,531
27358,9925,4989,4936,1680,2750,559,1380,2885,671
27360,41719,20108,21611,6080,10924,3104,6016,11132,4463
27370,15414,7628,7786,2453,4313,862,2237,4406,1143
27371,7952,4211,3741,1089,2531,591,1052,1811,878
27376,7307,3576,3731,859,1603,1114,802,1673,1256
27377,3645,1791,1854,409,1077,305,475,1076,303
27379,5910,3355,2555,769,2137,449,733,1226,596
27401,19164,8737,10427,3102,4553,1082,3865,4723,1839
27403,22596,10385,12211,3477,5919,989,5108,5574,1529
27405,40712,19654,21058,7185,10240,2229,6472,10872,3714
27406,50117,23332,26785,7549,12437,3346,7830,14250,4705
27407,42909,21140,21769,6741,12146,2253,5890,12515,3364
27408,17209,8143,9066,2004,4474,1665,1994,4737,2335
27409,13556,6435,7121,1598,4286,551,1782,4449,890
27410,45091,21569,23522,5815,12181,3573,5540,13156,4826
27455,22888,10926,11962,3369,6404,1153,3162,7296,1504
27501,13360,6733,6627,2271,3753,709,2179,3597,851
27502,44349,21849,22500,7545,13051,1253,7306,13592,1602
27503,3377,1736,1641,482,1049,205,426,975,240
27504,12407,6182,6225,1907,3476,799,1759,3361,1105
27505,4436,2145,2291,646,1193,306,652,1216,423
27506,1880,800,1080,518,243,39,714,250,116
27507,1868,935,933,314,463,158,252,490,191
27508,1689,1000,689,218,677,105,242,307,140
27509,8562,6130,2432,1632,4062,436,633,1378,421
27510,14406,7108,7298,1937,4768,403,1902,4812,584
27511,45045,22332,22713,6746,13216,2370,6562,13331,2820
27513,37066,18398,18668,5937,11550,911,5766,11731,1171
27514,50388,22731,27657,8715,10975,3041,11495,12218,3944
27516,28287,13904,14383,4391,8469,1044,4391,8495,1497
27520,31952,15888,16064,5351,9279,1258,4785,9604,1675
27521,5585,2690,2895,746,1621,323,967,1466,462
27522,8619,4270,4349,1337,2404,529,1233,2432,684
27524,10048,5102,4946,1610,2828,664,1370,2688,888
27525,10529,5170,5359,1572,3003,595,1568,2992,799
27526,25105,12327,12778,4145,6880,1302,3882,7123,1773
27529,30498,15053,15445,4969,8550,1534,4583,8748,2114
27530,38558,18935,19623,5990,10180,2765,5549,10063,4011
27534,33220,16892,16328,5673,9116,2103,5038,8438,2852
27536,39893,18830,21063,6699,9497,2634,6031,10887,4145
27540,12239,6088,6151,2182,3646,260,1920,3865,366
27541,3318,1725,1593,544,852,329,332,926,335
27542,7657,3836,3821,1150,2033,653,1113,1892,816
27544,3865,1858,2007,641,986,231,666,1051,290
27545,15671,7614,8057,2585,4426,603,2605,4618,834
27546,14600,7463,7137,2217,4422,824,2065,3788,1284
27549,21515,10257,11258,3446,5312,1499,3299,5690,2269
27551,1978,912,1066,210,512,190,256,531,279
27553,2013,986,1027,347,503,136,350,492,185
27555,461,217,244,73,120,24,50,121,73
27557,6647,3155,3492,975,1793,387,1049,1811,632
27559,2140,1065,1075,308,664,93,229,602,244
27560,10083,5093,4990,1372,3441,280,1287,3345,358
27562,1644,839,805,183,492,164,156,500,149
27563,5156,2708,2448,717,1584,407,694,1175,579
27565,23593,11353,12240,3831,5717,1805,3335,6301,2604
27568,57,15,42,5,10,0,9,22,11
27569,6290,3021,3269,870,1666,485,945,1700,624
27570,245,134,111,34,67,33,0,64,47
27571,1206,589,617,200,317,72,169,362,86
27572,6495,3255,3240,962,1902,391,859,1874,507
27573,24092,11452,12640,3343,6146,1963,3276,6510,2854
27576,16446,8128,8318,2817,4300,1011,2468,4371,1479
27577,19088,9624,9464,2847,5300,1477,2515,4597,2352
27581,2574,1228,1346,396,710,122,422,746,178
27582,81,43,38,3,26,14,8,11,19
27583,4844,2404,2440,823,1325,256,745,1395,300
27584,147,63,84,18,45,0,41,43,0
27587,29422,14345,15077,4741,8385,1219,4967,8517,1593
27589,8345,3910,4435,1309,1837,764,1272,2001,1162
27591,15020,7245,7775,2485,3981,779,2419,4221,1135
27592,8662,4315,4347,1323,2611,381,1304,2648,395
27596,8566,4315,4251,1348,2569,398,1186,2612,453
27597,17243,8558,8685,2778,4879,901,2544,4820,1321
27601,9950,4864,5086,1765,2646,453,1937,2387,762
27603,31779,16305,15474,4758,10218,1329,4644,9020,1810
27604,32209,15467,16742,4334,9588,1545,4528,10207,2007
27605,4061,2036,2025,274,1492,270,268,1290,467
27606,43504,24540,18964,9476,13933,1131,7198,10272,1494
27607,18687,8927,9760,2588,5299,1040,3546,4598,1616
27608,10082,4607,5475,966,2922,719,1017,3263,1195
27609,32791,16296,16495,4369,9696,2231,3786,9549,3160
27610,43538,20072,23466,7199,10919,1954,7310,13065,3091
27612,27102,13085,14017,3198,8251,1636,3151,8600,2266
27613,36509,18013,18496,5592,11336,1085,5270,11959,1267
27614,11246,5609,5637,1929,3297,383,1807,3396,434
27615,40643,19568,21075,5983,11642,1943,5933,12471,2671
27616,21588,10790,10798,3801,6528,461,3446,6669,683
27701,24933,12412,12521,4779,6575,1058,4601,6346,1574
27703,31935,15580,16355,5532,8793,1255,5122,9076,2157
27704,26812,12291,14521,4211,6568,1512,3924,7817,2780
27705,40218,19907,20311,5937,11596,2374,5536,11047,3728
27706,519,272,247,184,63,25,187,17,43
27707,42956,20445,22511,6562,11563,2320,6537,12760,3214
27712,17782,8583,9199,2666,4749,1168,2292,5298,1609
27713,31073,14642,16431,3965,9639,1038,3790,11177,1464
27801,22390,9931,12459,3891,4703,1337,3925,6452,2082
27803,21682,10159,11523,3499,5106,1554,3324,6027,2172
27804,25747,12003,13744,3844,6411,1748,3972,6987,2785
27805,3361,1551,1810,482,743,326,544,851,415
27806,2582,1240,1342,357,639,244,342,647,353
27807,5713,2851,2862,970,1584,297,798,1624,440
27808,2419,1157,1262,331,560,266,314,662,286
27809,4974,2371,2603,846,1229,296,817,1322,464
27810,4488,2195,2293,654,1081,460,497,1181,615
27812,2965,1319,1646,438,654,227,486,753,407
27813,387,177,210,57,101,19,80,96,34
27814,1485,682,803,190,391,101,287,421,95
27816,2033,1042,991,282,583,177,298,529,164
27817,6307,3082,3225,899,1604,579,843,1735,647
27818,1389,641,748,205,337,99,182,367,199
27819,488,231,257,74,111,46,82,128,47
27820,2663,1254,1409,412,559,283,393,662,354
27821,377,187,190,86,54,47,43,69,78
27822,7766,3773,3993,1206,2011,556,1008,2150,835
27823,8819,4134,4685,1511,2000,623,1531,2282,872
27824,1464,656,808,133,359,164,190,313,305
27826,1319,904,415,143,719,42,118,194,103
27827,63,21,42,2,18,1,18,15,9
27828,8945,4188,4757,1329,2196,663,1331,2347,1079
27829,1796,810,986,278,430,102,279,523,184
27830,5135,2503,2632,771,1284,448,745,1349,538
27831,3176,1453,1723,515,648,290,514,831,378
27832,2951,1380,1571,415,771,194,417,824,330
27834,42962,20116,22846,7217,10878,2021,7495,12153,3198
27837,4398,2224,2174,721,1269,234,593,1266,315
27839,4292,2555,1737,487,1789,279,452,875,410
27840,406,186,220,61,105,20,41,112,67
27841,27,10,17,2,8,0,4,11,2
27842,1362,696,666,143,313,240,82,337,247
27843,1456,713,743,226,349,138,209,337,197
27844,2516,1239,1277,512,532,195,377,667,233
27845,2545,1454,1091,290,965,199,262,471,358
27846,2974,1472,1502,496,769,207,407,817,278
27847,954,424,530,147,203,74,165,255,110
27849,1666,753,913,266,391,96,308,434,171
27850,7396,3500,3896,858,1670,972,942,1791,1163
27851,4723,2339,2384,776,1221,342,635,1290,459
27852,2569,1254,1315,305,663,286,299,665,351
27853,872,385,487,149,195,41,221,209,57
27855,5849,2781,3068,999,1320,462,866,1527,675
27856,15345,7659,7686,2282,4388,989,2153,4137,1396
27857,2096,980,1116,279,494,207,291,523,302
27858,44986,21434,23552,7665,11770,1999,9242,11345,2965
27860,2062,986,1076,260,534,192,297,558,221
27862,741,337,404,72,194,71,95,168,141
27863,7805,3789,4016,1189,2120,480,1180,2235,601
27864,4213,2014,2199,722,1002,290,661,1136,402
27865,1932,937,995,302,476,159,226,473,296
27866,1024,497,527,135,261,101,124,263,140
27869,2721,1260,1461,395,611,254,351,664,446
27870,27472,12993,14479,4495,6562,1936,4017,7310,3152
27871,5139,2486,2653,906,1188,392,715,1273,665
27872,329,156,173,44,74,38,38,80,55
27873,358,167,191,53,74,40,39,79,73
27874,5670,2628,3042,951,1187,490,839,1372,831
27875,607,279,328,84,151,44,116,173,39
27876,1476,677,799,213,360,104,198,372,229
27877,251,110,141,20,62,28,36,62,43
27878,1714,805,909,320,428,57,345,486,78
27880,2386,1295,1091,464,679,152,280,592,219
27882,6160,2995,3165,1023,1534,438,897,1580,688
27883,3380,1582,1798,525,807,250,571,908,319
27884,1001,499,502,140,261,98,119,291,92
27885,1212,570,642,150,275,145,159,321,162
27886,19895,9578,10317,3225,4974,1379,2654,5296,2367
27888,2634,1366,1268,476,671,219,411,613,244
27889,25487,11923,13564,3708,6088,2127,3843,6751,2970
27890,2825,1271,1554,479,572,220,466,732,356
27891,5031,2425,2606,736,1334,355,760,1340,506
27892,15425,7038,8387,2315,3516,1207,2428,4032,1927
27893,41160,19287,21873,6817,9850,2620,6736,10822,4315
27896,13679,6453,7226,1784,3704,965,1885,3991,1350
27897,2221,996,1225,323,504,169,432,515,278
27909,34897,16813,18084,5571,8600,2642,5728,8556,3800
27910,11016,4976,6040,1788,2284,904,1709,2831,1500
27915,808,418,390,76,282,60,96,247,47
27916,512,270,242,73,134,63,31,110,101
27917,770,346,424,115,200,31,129,207,88
27919,946,458,488,167,178,113,128,274,86
27920,1633,746,887,176,391,179,229,448,210
27921,3095,1569,1526,480,809,280,386,798,342
27922,895,417,478,98,223,96,87,229,162
27923,623,296,327,89,184,23,103,181,43
27924,3649,1693,1956,538,862,293,504,966,486
27925,3798,2064,1734,587,1125,352,434,848,452
27926,1669,853,816,334,411,108,220,435,161
27927,625,339,286,22,243,74,33,206,47
27928,2063,1019,1044,316,468,235,297,489,258
27929,666,328,338,93,139,96,71,155,112
27932,12136,5698,6438,1862,2685,1151,1876,2891,1671
27935,1503,789,714,203,444,142,186,392,136
27936,316,193,123,34,126,33,19,77,27
27937,2929,1383,1546,427,701,255,424,769,353
27938,1660,844,816,284,459,101,242,404,170
27939,1573,799,774,197,390,212,152,402,220
27941,89,37,52,4,16,17,5,19,28
27942,1178,502,676,223,226,53,222,316,138
27943,647,338,309,79,187,72,69,155,85
27944,10167,4842,5325,1390,2259,1193,1333,2443,1549
27946,1242,606,636,159,347,100,138,337,161
27947,667,310,357,111,186,13,143,178,36
27948,9205,4725,4480,1227,2851,647,1171,2583,726
27949,6073,3016,3057,717,1541,758,630,1607,820
27950,1840,914,926,312,510,92,292,529,105
27953,1169,611,558,190,340,81,149,303,106
27954,5164,2651,2513,852,1408,391,584,1438,491
27956,538,310,228,64,199,47,66,108,54
27957,1013,508,505,163,247,98,140,247,118
27958,6976,3500,3476,1231,1764,505,1054,1928,494
27959,2782,1379,1403,299,781,299,303,799,301
27960,730,367,363,86,200,81,52,199,112
27962,8024,3734,4290,1339,1786,609,1291,2082,917
27964,522,252,270,38,144,70,37,141,92
27965,571,274,297,81,150,43,135,133,29
27966,1483,686,797,193,370,123,245,443,109
27967,665,299,366,110,140,49,116,153,97
27968,277,160,117,19,99,42,9,92,16
27970,3706,1809,1897,540,973,296,491,998,408
27972,277,118,159,15,84,19,28,101,30
27973,1006,462,544,122,266,74,115,293,136
27974,1216,580,636,188,298,94,206,295,135
27976,2303,1159,1144,332,668,159,328,634,182
27979,1599,743,856,234,360,149,303,373,180
27980,2440,1210,1230,423,542,245,315,603,312
27981,1560,786,774,259,433,94,201,476,97
27982,56,29,27,0,20,9,0,13,14
27983,8999,4215,4784,1366,2060,789,1269,2364,1151
27985,119,51,68,18,21,12,21,22,25
27986,1560,750,810,221,421,108,227,425,158
28001,26311,12332,13979,3928,6315,2089,3988,6757,3234
28006,627,347,280,112,200,35,61,169,50
28007,743,322,421,92,153,77,121,210,90
28009,869,386,483,118,178,90,131,233,119
28012,19074,9268,9806,2750,5250,1268,2575,5303,1928
28016,14493,7078,7415,2272,4001,805,2301,3996,1118
28017,1708,782,926,470,269,43,611,248,67
28018,5367,2617,2750,715,1491,411,798,1333,619
28019,613,301,312,56,174,71,62,129,121
28020,2451,1211,1240,308,719,184,340,675,225
28021,12561,6099,6462,1700,3278,1121,1587,3169,1706
28023,13027,6325,6702,1724,3573,1028,2055,3395,1252
28025,41468,20418,21050,6613,11196,2609,5748,11118,4184
28027,32274,16019,16255,5242,9022,1755,4907,8952,2396
28031,13540,6830,6710,1719,4341,770,1749,4130,831
28032,2387,1187,1200,383,642,162,328,616,256
28033,2048,1013,1035,319,590,104,339,574,122
28034,14132,7096,7036,2195,3945,956,1916,3846,1274
28036,10245,5135,5110,2103,2469,563,1800,2500,810
28037,13037,6635,6402,1997,3757,881,1672,3729,1001
28038,107,52,55,10,36,6,22,27,6
28040,6609,3228,3381,939,1775,514,1025,1812,544
28043,20516,9714,10802,3094,4918,1702,3001,5172,2629
28052,36732,17323,19409,5802,9061,2460,5981,9722,3706
28054,33173,15825,17348,4427,8929,2469,4284,8917,4147
28056,27917,13759,14158,4347,7829,1583,4218,7995,1945
28071,2854,1402,1452,443,815,144,456,743,253
28072,240,109,131,28,44,37,50,57,24
28073,4501,2257,2244,824,1205,228,756,1207,281
28075,14461,7198,7263,2266,4340,592,2187,4346,730
28076,253,87,166,8,42,37,41,70,55
28077,540,249,291,88,132,29,87,146,58
28078,27936,13791,14145,4467,8283,1041,4412,8258,1475
28079,10976,5254,5722,1709,3014,531,1831,3216,675
28080,6076,3022,3054,934,1731,357,891,1725,438
28081,23512,11488,12024,3651,6106,1731,3453,6086,2485
28083,20058,9497,10561,2922,5004,1571,2712,5181,2668
28086,24554,11966,12588,3790,6474,1702,3567,6536,2485
28088,3179,1553,1626,484,813,256,409,785,432
28089,254,109,145,52,39,18,92,33,20
28090,8321,4035,4286,1189,2179,667,1279,2109,898
28091,2317,1142,1175,370,572,200,303,589,283
28092,35428,17465,17963,5343,9635,2487,5054,9354,3555
28097,3062,1520,1542,466,827,227,472,790,280
28098,2670,1213,1457,366,668,179,372,754,331
28101,492,261,231,75,136,50,66,115,50
28102,99,50,49,11,27,12,12,25,12
28103,9315,4678,4637,1526,2531,621,1343,2449,845
28104,19284,9667,9617,3241,5534,892,3009,5560,1048
28105,32081,15459,16622,5137,8925,1397,5140,9293,2189
28107,5161,2521,2640,792,1288,441,747,1454,439
28109,459,243,216,153,90,0,171,45,0
28110,36388,18438,17950,6368,10278,1792,5532,9846,2572
28112,22778,11344,11434,3858,5909,1577,3387,5833,2214
28114,6938,3444,3494,1029,1867,548,916,1810,768
28115,24908,12133,12775,4030,6494,1609,3703,6624,2448
28117,18395,9362,9033,2731,5427,1204,2551,5158,1324
28119,2836,1309,1527,480,692,137,576,731,220
28120,15471,7417,8054,2058,4271,1088,2088,4306,1660
28124,5470,2772,2698,779,1629,364,824,1410,464
28125,2103,1114,989,368,598,148,310,534,145
28127,6846,3868,2978,892,2322,654,628,1658,692
28128,7603,3813,3790,1248,1914,651,979,2041,770
28129,4901,2501,2400,718,1352,431,601,1239,560
28133,3108,1586,1522,584,805,197,428,787,307
28134,7486,3541,3945,1049,2151,341,1113,2219,613
28135,4035,2499,1536,389,1812,298,420,725,391
28137,2778,1351,1427,389,787,175,502,731,194
28138,10018,5029,4989,1678,2748,603,1495,2678,816
28139,18141,8815,9326,2705,4648,1462,2456,4523,2347
28144,26817,12987,13830,4125,6336,2526,3668,6513,3649
28146,25103,12434,12669,3787,6847,1800,3572,6614,2483
28147,21618,11082,10536,3325,6442,1315,3264,5609,1663
28150,28364,13264,15100,4179,6750,2335,4009,7287,3804
28152,22002,10645,11357,3578,5592,1475,3236,5958,2163
28159,3044,1477,1567,509,720,248,444,744,379
28160,4110,2009,2101,523,1101,385,544,977,580
28163,6475,3270,3205,1069,1795,406,989,1679,537
28164,12610,6186,6424,1869,3453,864,1795,3462,1167
28166,6201,3039,3162,831,1760,448,797,1788,577
28167,2196,1040,1156,269,576,195,354,559,243
28168,9092,4445,4647,1364,2546,535,1369,2552,726
28169,215,107,108,31,52,24,28,55,25
28170,12253,5622,6631,1839,2815,968,1848,3198,1585
28173,17758,8839,8919,3048,4861,930,2911,4929,1079
28174,7030,3530,3500,1376,1840,314,1361,1685,454
28202,4870,2815,2055,457,2123,235,378,1171,506
28203,10304,4910,5394,1369,3199,342,1259,3299,836
28204,4965,2531,2434,605,1744,182,588,1565,281
28205,46509,23587,22922,7297,13965,2325,6179,13272,3471
28206,12341,6043,6298,2294,3275,474,2173,3390,735
28207,8763,4110,4653,1065,2232,813,1121,2465,1067
28208,35866,17420,18446,6701,9096,1623,6088,9699,2659
28209,19643,9450,10193,2039,6256,1155,1660,6381,2152
28210,40960,20034,20926,5084,12304,2646,4673,12458,3795
28211,27821,13194,14627,3670,7446,2078,3426,7917,3284
28212,35109,17144,17965,5453,10361,1330,4980,10794,2191
28213,25948,13592,12356,4622,8150,820,4067,7364,925
28214,20834,10313,10521,3156,5709,1448,2972,5764,1785
28215,41580,20352,21228,7107,11381,1864,6654,11959,2615
28216,29800,13922,15878,4850,7250,1822,4926,8123,2829
28217,19258,9721,9537,3322,5625,774,3083,5352,1102
28223,3254,1402,1852,1230,172,0,1654,198,0
28226,35465,17191,18274,5141,9775,2275,4509,10672,3093
28227,39496,19071,20425,5995,11077,1999,5843,12028,2554
28262,17753,9263,8490,2985,5831,447,2888,4936,666
28269,42701,20992,21709,6434,13393,1165,6586,13693,1430
28270,25726,12723,13003,4239,7270,1214,3629,7945,1429
28273,18375,8979,9396,2751,5858,370,2792,5986,618
28277,33852,16673,17179,5378,10209,1086,5177,10699,1303
28278,6211,3145,3066,818,1998,329,764,1958,344
28301,35195,16353,18842,5679,7908,2766,5708,8948,4186
28303,32049,15590,16459,5145,8559,1886,5032,8829,2598
28304,35895,17159,18736,6056,9264,1839,6083,10137,2516
28305,5918,2652,3266,700,1455,497,706,1664,896
28306,29861,14731,15130,5136,8033,1562,4812,8327,1991
28307,31791,21566,10225,10548,11018,0,5199,4972,54
28311,33014,16469,16545,6131,8915,1423,5560,9159,1826
28314,47965,23705,24260,8969,13354,1382,8948,13486,1826
28315,9439,4518,4921,1462,2360,696,1484,2445,992
28318,4121,1946,2175,567,1113,266,746,1032,397
28320,8721,4210,4511,1238,2248,724,1159,2306,1046
28323,2528,1160,1368,348,669,143,491,644,233
28325,351,185,166,71,79,35,32,83,51
28326,10321,5255,5066,1971,2808,476,1724,2823,519
28327,13595,6553,7042,1928,3345,1280,1998,3427,1617
28328,25290,12276,13014,3994,6418,1864,3942,6151,2921
28330,305,154,151,60,59,35,38,61,52
28332,514,269,245,86,126,57,62,120,63
28333,11430,5627,5803,2134,2926,567,1824,3357,622
28334,23096,10929,12167,3450,5711,1768,3369,6182,2616
28337,9181,4192,4989,1424,2054,714,1449,2292,1248
28338,4593,2241,2352,763,1121,357,675,1171,506
28339,6693,3215,3478,957,1669,589,961,1776,741
28340,11251,5192,6059,1826,2620,746,1982,2930,1147
28341,4157,2041,2116,607,1201,233,677,1010,429
28342,377,216,161,133,74,9,65,73,23
28343,1766,896,870,365,455,76,252,494,124
28344,2810,1390,1420,441,781,168,447,722,251
28345,12299,5866,6433,1913,2938,1015,1887,3239,1307
28347,2777,1838,939,1074,678,86,351,466,122
28348,25924,12477,13447,4578,6895,1004,4717,7257,1473
28349,3768,2108,1660,666,1157,285,327,940,393
28350,372,162,210,65,84,13,79,99,32
28351,4825,2376,2449,808,1266,302,778,1284,387
28352,25457,11612,13845,4228,5898,1486,4425,6970,2450
28356,3839,1936,1903,580,1113,243,598,1064,241
28357,2918,1315,1603,501,686,128,563,857,183
28358,36388,17421,18967,6008,9351,2062,5967,9564,3436
28360,12468,6333,6135,2368,3337,628,2246,3201,688
28362,92,50,42,15,31,4,9,20,13
28363,982,455,527,113,249,93,135,262,130
28364,13409,6447,6962,2474,3294,679,2424,3693,845
28365,14917,7284,7633,2443,3783,1058,2231,3717,1685
28366,4914,2441,2473,714,1395,332,712,1204,557
28367,67,34,33,12,18,4,13,11,9
28368,387,193,194,77,100,16,64,100,30
28369,2837,1385,1452,454,704,227,393,783,276
28371,4792,2422,2370,937,1312,173,829,1246,295
28372,12183,5812,6371,2297,2907,608,2242,3215,914
28373,1145,532,613,161,284,87,200,294,119
28374,11443,5320,6123,826,1808,2686,705,2459,2959
28376,25888,13102,12786,4797,7159,1146,4514,6636,1636
28377,12243,6011,6232,2265,3016,730,2346,2908,978
28378,33,16,17,0,6,10,6,6,5
28379,26111,12470,13641,4202,6352,1916,4000,6760,2881
28382,5920,2886,3034,966,1481,439,877,1605,552
28383,7836,3729,4107,1559,1800,370,1363,2141,603
28384,10429,5162,5267,1811,2782,569,1809,2629,829
28385,4470,2187,2283,726,1161,300,677,1203,403
28386,5364,2629,2735,1005,1450,174,1124,1323,288
28387,13315,6066,7249,1660,2801,1605,1640,3062,2547
28390,20036,9947,10089,3875,5464,608,3926,5222,941
28391,4327,2172,2155,694,1184,294,647,1151,357
28392,1654,811,843,216,444,151,183,471,189
28393,2016,1045,971,328,576,141,296,459,216
28394,4160,1998,2162,520,1107,371,722,1056,384
28395,2212,1081,1131,295,645,141,337,592,202
28396,2652,1330,1322,502,669,159,340,738,244
28398,7082,3410,3672,1237,1667,506,1100,1835,737
28399,2191,1124,1067,399,578,147,338,511,218
28401,21619,10195,11424,2892,5900,1403,2886,5764,2774
28403,30354,14558,15796,4428,8232,1898,5119,7719,2958
28405,25087,11874,13213,3567,6308,1999,3636,7103,2474
28409,26461,12941,13520,3903,7029,2009,3737,7613,2170
28411,17098,8476,8622,2452,4731,1293,2111,5140,1371
28412,23457,11165,12292,3023,6298,1844,3095,6783,2414
28420,3723,1873,1850,601,1034,238,581,988,281
28421,1564,746,818,223,390,133,263,448,107
28422,4578,2208,2370,614,1166,428,679,1238,453
28423,2057,1019,1038,316,566,137,320,541,177
28425,9387,4855,4532,1381,2814,660,1214,2366,952
28428,5199,2645,2554,466,1634,545,441,1525,588
28429,7512,3791,3721,1347,2080,364,1128,2142,451
28430,2048,917,1131,314,437,166,311,577,243
28431,7259,3422,3837,1109,1705,608,1094,1884,859
28432,1684,832,852,328,395,109,258,441,153
28433,4709,2207,2502,707,1120,380,733,1192,577
28434,1882,908,974,253,528,127,295,517,162
28435,2360,1128,1232,420,578,130,412,620,200
28436,1626,784,842,224,409,151,245,440,157
28438,1603,688,915,224,387,77,283,455,177
28439,1786,878,908,294,402,182,255,411,242
28441,3614,1885,1729,677,883,325,559,906,264
28442,1713,778,935,231,414,133,324,395,216
28443,11679,5802,5877,1378,2989,1435,1325,3059,1493
28444,2139,1078,1061,321,594,163,310,503,248
28445,4717,2255,2462,635,1233,387,674,1295,493
28447,1015,469,546,132,255,82,166,243,137
28448,1046,468,578,116,297,55,193,319,66
28449,1448,669,779,99,405,165,135,468,176
28450,2440,1139,1301,357,570,212,321,650,330
28451,15987,8007,7980,2649,4477,881,2511,4577,892
28452,205,95,110,28,22,45,48,35,27
28453,3367,1717,1650,589,900,228,516,834,300
28454,2506,1225,1281,390,639,196,344,684,253
28455,1607,839,768,234,471,134,177,454,137
28456,3667,1714,1953,592,846,276,676,891,386
28457,7864,4031,3833,1320,2208,503,1136,2080,617
28458,5985,2765,3220,936,1423,406,1111,1484,625
28460,5132,2552,2580,554,1427,571,587,1405,588
28461,9099,4399,4700,1135,2175,1089,1031,2509,1160
28462,10163,5093,5070,1398,2400,1295,1140,2662,1268
28463,8095,3807,4288,1298,1934,575,1344,2110,834
28464,1988,970,1018,344,507,119,311,563,144
28465,6782,3295,3487,625,1653,1017,610,1839,1038
28466,8186,3962,4224,1225,2015,722,1040,2081,1103
28467,5123,2501,2622,356,926,1219,311,1059,1252
28468,3173,1540,1633,286,678,576,225,760,648
28469,4309,2128,2181,437,1030,661,390,1078,713
28470,7046,3368,3678,1068,1571,729,1023,1766,889
28471,2026,1046,980,350,572,124,264,590,126
28472,19131,9316,9815,2959,5008,1349,2914,4849,2052
28478,2345,1133,1212,359,593,181,338,574,300
28479,2720,1258,1462,353,751,154,373,730,359
28480,2648,1447,1201,231,994,222,188,737,276
28501,21845,9658,12187,3298,4586,1774,3226,5547,3414
28504,21475,10639,10836,3282,5669,1688,2891,5724,2221
28508,1925,1077,848,456,545,76,293,437,118
28510,1486,735,751,211,340,184,156,390,205
28511,822,449,373,134,223,92,47,189,137
28512,3541,1782,1759,205,920,657,187,888,684
28513,9993,4756,5237,1587,2497,672,1473,2690,1074
28515,3269,1781,1488,459,1061,261,388,727,373
28516,10253,4866,5387,1152,2675,1039,1295,2833,1259
28518,6069,2978,3091,1020,1547,411,817,1679,595
28519,343,167,176,43,98,26,41,95,40
28520,352,203,149,44,152,7,55,86,8
28521,1908,962,946,260,521,181,243,477,226
28523,2605,1337,1268,408,735,194,337,673,258
28524,424,182,242,44,95,43,71,115,56
28525,2987,1458,1529,471,776,211,469,826,234
28526,2536,1232,1304,380,624,228,319,629,356
28527,1055,546,509,178,285,83,110,306,93
28528,555,291,264,85,153,53,62,160,42
28529,1946,945,1001,272,500,173,299,460,242
28530,6256,3083,3173,1123,1542,418,835,1710,628
28531,1588,808,780,139,476,193,182,366,232
28532,27454,15307,12147,6479,8010,818,4741,6395,1011
28537,308,172,136,40,88,44,22,77,37
28538,2416,1153,1263,355,659,139,440,595,228
28539,12466,6315,6151,2358,3527,430,2234,3276,641
28540,44818,23478,21340,9634,12054,1790,7866,10945,2529
28543,6335,3292,3043,1815,1477,0,1690,1353,0
28544,6285,3139,3146,1329,1698,112,1369,1625,152
28546,31883,15464,16419,5768,8376,1320,6124,8303,1992
28547,21630,18149,3481,10872,7269,8,1875,1599,7
28551,11952,5890,6062,2105,3085,700,1769,3306,987
28552,265,99,166,0,69,30,54,65,47
28553,493,247,246,47,99,101,40,118,88
28554,1538,1262,276,96,1116,50,101,143,32
28555,4498,2222,2276,741,1197,284,659,1235,382
28556,1110,530,580,139,277,114,169,297,114
28557,12950,5950,7000,1546,3013,1391,1478,3552,1970
28560,25708,12245,13463,3562,6299,2384,3661,6675,3127
28562,27807,13180,14627,3703,6238,3239,3731,7019,3877
28570,18661,9349,9312,2735,5318,1296,2839,5014,1459
28571,2410,1160,1250,184,487,489,178,484,588
28572,5870,2905,2965,859,1636,410,898,1526,541
28573,2003,945,1058,253,500,192,280,503,275
28574,9952,4789,5163,1526,2595,668,1700,2643,820
28575,129,45,84,0,40,5,23,31,30
28577,475,267,208,60,99,108,19,94,95
28578,4384,2411,1973,896,1312,203,631,1057,285
28579,407,212,195,80,112,20,52,96,47
28580,9295,4452,4843,1607,2249,596,1337,2411,1095
28581,199,96,103,11,75,10,31,52,20
28582,1041,483,558,118,276,89,162,321,75
28584,7802,3882,3920,1048,1976,858,914,1958,1048
28585,4190,2043,2147,651,1083,309,607,1086,454
28586,6671,3515,3156,838,2232,445,917,1626,613
28589,339,148,191,31,90,27,46,92,53
28590,13493,6147,7346,2051,3608,488,2321,4278,747
28594,3503,1783,1720,273,950,560,273,911,536
28601,46239,22758,23481,6998,12539,3221,6568,12200,4713
28602,27780,13426,14354,4426,7246,1754,4133,7604,2617
28604,5492,2701,2791,770,1449,482,815,1445,531
28605,3198,1530,1668,337,811,382,332,864,472
28606,1735,821,914,219,444,158,260,408,246
28607,27257,13579,13678,5669,6403,1507,5788,6046,1844
28609,5640,2877,2763,830,1712,335,720,1553,490
28610,8610,4307,4303,1364,2491,452,1353,2358,592
28611,610,351,259,115,187,49,49,158,52
28612,12125,5926,6199,1794,3227,905,1739,3206,1254
28613,20177,9916,10261,3074,5607,1235,2830,5611,1820
28615,1897,959,938,263,521,175,255,497,186
28616,503,215,288,77,91,47,89,128,71
28617,2253,1115,1138,267,579,269,234,621,283
28618,1659,848,811,210,500,138,189,500,122
28619,1257,579,678,185,293,101,190,302,186
28621,10245,4814,5431,1420,2470,924,1236,2573,1622
28622,2548,1297,1251,391,692,214,327,667,257
28623,1789,906,883,280,495,131,219,453,211
28624,1355,644,711,158,370,116,190,380,141
28625,31018,15371,15647,4772,8321,2278,4281,8324,3042
28626,1723,867,856,248,513,106,184,521,151
28627,1258,632,626,165,327,140,128,299,199
28629,51,25,26,12,13,0,8,12,6
28630,17161,8493,8668,2444,4965,1084,2274,4882,1512
28631,529,282,247,47,167,68,46,132,69
28634,5218,2479,2739,728,1423,328,862,1362,515
28635,3192,1513,1679,365,853,295,448,825,406
28636,4717,2327,2390,720,1281,326,711,1197,482
28637,1546,719,827,184,405,130,202,425,200
28638,11992,5917,6075,1672,3429,816,1747,3261,1067
28640,4054,1931,2123,466,960,505,438,973,712
28642,5384,2512,2872,721,1311,480,691,1478,703
28643,3171,1569,1602,404,872,293,358,804,440
28644,1625,788,837,187,432,169,206,398,233
28645,46577,22959,23618,6502,12521,3936,6130,12207,5281
28646,199,91,108,0,60,31,0,72,36
28649,1082,492,590,123,284,85,203,278,109
28650,10182,5031,5151,1462,2908,661,1422,2724,1005
28651,5998,2993,3005,848,1748,397,726,1725,554
28654,2941,1495,1446,457,820,218,444,778,224
28655,55050,28206,26844,9286,14779,4141,7240,14122,5482
28657,10032,4916,5116,1292,2617,1007,1243,2552,1321
28658,24798,12450,12348,3812,6707,1931,3248,6518,2582
28659,21206,10555,10651,2969,5812,1774,2758,5481,2412
28660,1742,907,835,304,426,177,268,426,141
28662,44,21,23,0,13,8,0,16,7
28663,581,327,254,63,153,111,61,111,82
28665,2598,1292,1306,331,718,243,358,733,215
28666,622,315,307,111,157,47,90,203,14
28668,108,50,58,0,12,38,16,22,20
28669,3005,1483,1522,402,866,215,522,765,235
28670,2884,1452,1432,413,790,249,351,765,316
28671,482,225,257,86,101,38,75,118,64
28673,4028,1984,2044,425,1205,354,482,1198,364
28675,6019,2868,3151,755,1497,616,691,1507,953
28676,3161,1577,1584,405,927,245,382,827,375
28677,31896,15164,16732,4916,7917,2331,4742,8263,3727
28678,4725,2430,2295,666,1441,323,661,1223,411
28679,1605,814,791,234,437,143,211,401,179
28681,24082,11975,12107,3537,6657,1781,3337,6508,2262
28682,823,415,408,88,261,66,85,244,79
28683,1940,946,994,347,475,124,312,472,210
28684,2196,1071,1125,271,571,229,266,545,314
28685,1957,1003,954,315,515,173,272,518,164
28689,1728,831,897,171,521,139,209,504,184
28690,9392,4383,5009,1235,2292,856,1270,2481,1258
28692,3471,1724,1747,407,1021,296,443,1004,300
28693,1774,837,937,222,454,161,257,489,191
28694,6854,3373,3481,898,1813,662,779,1789,913
28697,12717,6092,6625,1692,3242,1158,1779,3311,1535
28698,2345,1124,1221,347,557,220,347,621,253
28701,3039,1507,1532,470,779,258,407,854,271
28702,16,16,0,0,16,0,0,0,0
28704,14868,7198,7670,2143,4019,1036,1817,4458,1395
28705,5542,2733,2809,566,1540,627,584,1407,818
28707,62,39,23,10,29,0,6,17,0
28708,534,281,253,74,165,42,85,114,54
28709,1687,807,880,244,437,126,277,427,176
28710,163,79,84,20,50,9,16,38,30
28711,11882,5523,6359,1503,2837,1183,1377,3215,1767
28712,17715,8277,9438,2254,3793,2230,2134,4321,2983
28713,8527,4224,4303,1208,2106,910,893,2213,1197
28714,15732,7638,8094,2116,3886,1636,1939,4025,2130
28715,22129,10747,11382,3129,5792,1826,2962,6073,2347
28716,16891,8175,8716,2202,4292,1681,1936,4461,2319
28717,1330,672,658,124,375,173,99,318,241
28718,353,170,183,53,85,32,41,84,58
28719,6096,2943,3153,1187,1434,322,1218,1490,445
28721,8292,4025,4267,1185,1981,859,1087,2164,1016
28722,5462,2506,2956,503,1161,842,530,1229,1197
28723,8724,4381,4343,2012,1924,445,1983,1868,492
28725,98,49,49,14,33,2,4,35,10
28726,2982,1451,1531,433,784,234,408,780,343
28729,2755,1413,1342,368,599,446,238,572,532
28730,8121,3911,4210,1236,2124,551,1051,2269,890
28731,6298,3047,3251,786,1495,766,725,1547,979
28732,12247,5994,6253,1740,3344,910,1762,3451,1040
28733,10,10,0,0,10,0,0,0,0
28734,23109,11038,12071,3034,5116,2888,2733,5644,3694
28735,90,38,52,2,17,19,10,21,21
28736,693,322,371,82,136,104,64,191,116
28739,17686,8415,9271,2054,3842,2519,1800,4256,3215
28740,2441,1295,1146,420,605,270,267,616,263
28741,3424,1625,1799,341,777,507,342,867,590
28742,6139,2979,3160,816,1656,507,812,1772,576
28743,2348,1166,1182,310,612,244,281,623,278
28745,586,264,322,29,75,160,51,85,186
28746,2240,1179,1061,263,513,403,157,527,377
28747,1803,831,972,213,454,164,302,460,210
28748,9706,4852,4854,1523,2707,622,1341,2779,734
28749,7,7,0,0,0,7,0,0,0
28751,2932,1399,1533,266,704,429,232,794,507
28752,29127,14509,14618,4018,8110,2381,3817,7555,3246
28753,10171,5016,5155,1456,2605,955,1258,2704,1193
28754,7361,3595,3766,1131,1798,666,1164,1813,789
28755,170,101,69,27,63,11,4,46,19
28756,3934,1955,1979,590,1064,301,511,1082,386
28757,477,254,223,148,71,35,122,61,40
28758,706,361,345,102,203,56,57,160,128
28761,6988,3461,3527,1029,1875,557,974,1913,640
28762,6241,3130,3111,904,1718,508,759,1639,713
28763,2494,1198,1296,316,599,283,252,656,388
28765,61,34,27,24,10,0,6,21,0
28766,866,440,426,114,240,86,107,206,113
28768,6637,3251,3386,826,1600,825,767,1662,957
28771,7983,3831,4152,1014,1972,845,1052,2012,1088
28772,1098,569,529,203,258,108,160,244,125
28773,2728,1319,1409,316,755,248,316,758,335
28774,819,403,416,108,167,128,80,208,128
28777,10776,5748,5028,1309,3533,906,1223,2440,1365
28778,9221,4475,4746,1630,2209,636,1420,2415,911
28779,13559,6370,7189,1702,3359,1309,1653,3796,1740
28781,883,419,464,113,181,125,82,242,140
28782,6372,3061,3311,797,1389,875,602,1519,1190
28783,1288,661,627,200,340,121,150,345,132
28784,157,65,92,31,34,0,38,32,22
28786,25332,12110,13222,3130,6250,2730,2904,6554,3764
28787,16678,8018,8660,2351,4318,1349,2246,4654,1760
28789,5089,2528,2561,795,1307,426,716,1335,510
28790,2453,1227,1226,398,592,237,358,614,254
28791,12346,5793,6553,1177,2579,2037,1201,2585,2767
28792,27063,13160,13903,3717,6603,2840,3508,6541,3854
28801,13592,6627,6965,1691,4049,887,1606,3865,1494
28803,24005,11372,12633,3162,5867,2343,2954,6265,3414
28804,19275,9429,9846,2362,5129,1938,2539,4735,2572
28805,15718,7263,8455,1807,3876,1580,1855,4380,2220
28806,33073,15614,17459,4523,8607,2484,4361,9346,3752
28901,5208,2491,2717,651,1283,557,560,1385,772
28902,832,408,424,133,180,95,80,219,125
28904,7428,3700,3728,952,1759,989,723,1753,1252
28905,2687,1354,1333,356,717,281,305,722,306
28906,16403,7874,8529,1934,3879,2061,2105,3976,2448
28909,515,249,266,48,158,43,44,181,41
29001,2310,1082,1228,381,568,133,483,560,185
29003,7217,3372,3845,1208,1579,585,1192,1852,801
29006,9729,4664,5065,1607,2369,688,1522,2372,1171
29009,2193,1077,1116,285,565,227,225,608,283
29010,13635,7104,6531,2083,4193,828,2063,3154,1314
29014,1799,874,925,255,440,179,296,451,178
29015,1829,839,990,303,389,147,333,495,162
29016,10262,4979,5283,1646,2819,514,1568,3103,612
29018,4141,1983,2158,735,981,267,627,1143,388
29020,21351,9894,11457,3021,5034,1839,3012,5380,3065
29030,2100,1004,1096,270,542,192,268,557,271
29031,1468,698,770,226,361,111,256,399,115
29032,4189,2147,2042,885,1097,165,728,1088,226
29033,12072,5674,6398,1807,2968,899,1805,3243,1350
29036,11840,6058,5782,1695,3157,1206,1503,3174,1105
29037,943,461,482,130,247,84,105,271,106
29038,2493,1209,1284,385,647,177,410,660,214
29039,3767,1768,1999,679,915,174,653,1090,256
29040,7091,3349,3742,1320,1659,370,1261,2039,442
29042,6417,3002,3415,1174,1433,395,1180,1632,603
29044,5917,2837,3080,1046,1480,311,986,1653,441
29045,13757,6758,6999,2355,3844,559,2371,4051,577
29046,285,128,157,72,37,19,41,95,21
29047,3700,1722,1978,479,810,433,482,956,540
29048,4898,2329,2569,790,1099,440,785,1222,562
29051,896,396,500,137,180,79,174,227,99
29052,2268,1065,1203,384,527,154,380,671,152
29053,16056,8029,8027,2973,4371,685,2931,4395,701
29054,7782,3937,3845,1163,2174,600,1092,2224,529
29055,4873,2377,2496,805,1184,388,681,1258,557
29056,2736,1258,1478,417,634,207,427,727,324
29058,4760,2342,2418,822,1151,369,672,1185,561
29059,6084,2789,3295,1003,1383,403,1052,1654,589
29061,12976,6160,6816,2099,3390,671,2136,3845,835
29062,39,20,19,0,20,0,0,12,7
29063,24396,11636,12760,4534,6371,731,4386,7421,953
29065,598,278,320,40,189,49,107,119,94
29067,10000,5593,4407,1503,3318,772,1265,2167,975
29069,4871,2373,2498,779,1243,351,671,1333,494
29070,12982,6531,6451,2012,3529,990,1891,3499,1061
29072,30982,15409,15573,4963,8832,1614,4508,8850,2215
29073,29417,14261,15156,4522,8500,1239,4583,8847,1726
29074,426,223,203,14,138,71,7,112,84
29075,2549,1201,1348,341,670,190,367,658,323
29078,12473,6050,6423,2020,3207,823,1989,3615,819
29079,305,131,174,56,54,21,39,94,41
29080,4100,1978,2122,724,977,277,607,1039,476
29081,1521,664,857,221,348,95,220,417,220
29082,620,307,313,126,139,42,94,145,74
29101,2785,1340,1445,432,737,171,472,761,212
29102,15807,7421,8386,2635,3576,1210,2525,4244,1617
29104,1998,866,1132,345,384,137,347,563,222
29105,1208,553,655,187,296,70,195,385,75
29107,3003,1489,1514,492,722,275,410,805,299
29108,19755,9391,10364,3342,4678,1371,3316,4748,2300
29111,2734,1948,786,879,951,118,213,391,182
29112,4673,2251,2422,741,1164,346,737,1242,443
29113,1683,783,900,273,391,119,297,435,168
29114,2278,1062,1216,413,508,141,401,587,228
29115,33141,15230,17911,5846,7210,2174,6136,8124,3651
29118,13597,6408,7189,2183,3353,872,2054,3892,1243
29122,68,29,39,10,12,7,8,21,10
29123,6461,3241,3220,1247,1697,297,1148,1649,423
29124,151,55,96,24,23,8,42,37,17
29125,3459,1540,1919,520,705,315,578,792,549
29126,2288,1170,1118,348,670,152,285,559,274
29127,7463,3604,3859,938,1910,756,992,2066,801
29128,6265,3375,2890,1127,1836,412,965,1371,554
29129,2867,1396,1471,468,722,206,509,664,298
29130,5312,2495,2817,682,1283,530,757,1415,645
29132,64,36,28,18,18,0,6,22,0
29133,1049,475,574,147,251,77,172,305,97
29135,9658,4488,5170,1495,2275,718,1529,2650,991
29137,2575,1245,1330,391,648,206,363,733,234
29138,10244,5214,5030,1793,2655,766,1536,2467,1027
29142,4648,2109,2539,710,928,471,764,1197,578
29145,938,455,483,123,268,64,153,250,80
29146,1963,988,975,336,480,172,212,472,291
29148,6384,2976,3408,794,1391,791,895,1575,938
29150,38738,17846,20892,6488,8617,2741,6272,9826,4794
29152,6136,3388,2748,1712,1676,0,1353,1390,5
29153,14512,7139,7373,2497,3606,1036,2358,3705,1310
29154,24686,12340,12346,4314,6759,1267,3965,6885,1496
29160,6965,3289,3676,1090,1746,453,1068,2011,597
29161,10960,5481,5479,2077,2729,675,1614,2982,883
29162,2541,1240,1301,457,590,193,376,705,220
29163,2064,956,1108,373,427,156,326,566,216
29164,4267,2107,2160,725,1055,327,718,1072,370
29166,971,486,485,146,295,45,146,211,128
29168,3450,1697,1753,597,866,234,596,874,283
29169,20462,9344,11118,2289,5280,1775,2420,5392,3306
29170,18307,8945,9362,2853,4918,1174,2773,5239,1350
29172,8964,4432,4532,1586,2349,497,1411,2521,600
29175,393,172,221,60,80,32,37,110,74
29177,447,63,384,0,0,63,0,54,330
29178,3822,1786,2036,483,942,361,543,948,545
29180,14547,6974,7573,2376,3535,1063,2286,3888,1399
29201,15885,7589,8296,3069,3844,676,3895,3333,1068
29202,635,446,189,96,350,0,93,96,0
29203,42384,19669,22715,6966,10100,2603,7449,11272,3994
29204,22041,9846,12195,3407,4835,1604,3597,5550,3048
29205,25719,12539,13180,3688,7490,1361,3662,7418,2100
29206,21729,10034,11695,3296,4968,1770,3460,5795,2440
29207,6250,4056,2194,2681,1375,0,1396,798,0
29209,28036,13440,14596,4208,7475,1757,4166,8113,2317
29210,39112,20158,18954,5781,12632,1745,4961,11662,2331
29212,27803,13502,14301,4695,7438,1369,4116,8482,1703
29223,44177,20869,23308,6694,11690,2485,6466,13552,3290
29229,17924,8725,9199,3469,4768,488,3211,5431,557
29301,29780,14390,15390,4733,7672,1985,4810,7977,2603
29302,17311,8129,9182,2324,4493,1312,2622,4822,1738
29303,24888,12185,12703,4008,6551,1626,4075,6141,2487
29306,16002,7172,8830,2633,3551,988,2715,4284,1831
29307,19903,9244,10659,2731,4610,1903,2430,5112,3117
29316,15155,7503,7652,2430,4162,911,2253,4359,1040
29320,439,197,242,20,129,48,44,165,33
29321,2490,1137,1353,327,604,206,367,709,277
29322,7753,3873,3880,1225,2149,499,1073,2116,691
29323,13582,6672,6910,2115,3679,878,1954,3722,1234
29325,16010,7491,8519,2693,3644,1154,2711,4002,1806
29330,7987,3885,4102,1276,2083,526,1245,2031,826
29332,2680,1255,1425,292,637,326,385,735,305
29334,7997,3981,4016,1351,2071,559,1237,2103,676
29335,4529,2118,2411,597,1231,290,735,1219,457
29338,6,0,6,0,0,0,0,0,6
29340,21310,10314,10996,3526,5294,1494,3297,5501,2198
29341,16683,8015,8668,2623,4346,1046,2565,4493,1610
29349,23477,11371,12106,3396,6367,1608,3488,6412,2206
29351,1750,772,978,216,383,173,318,387,273
29353,4361,2213,2148,772,1115,326,550,1169,429
29355,775,397,378,121,223,53,96,223,59
29356,7825,3785,4040,1031,1981,773,991,2031,1018
29360,21965,10469,11496,3466,5367,1636,3076,5705,2715
29364,597,299,298,88,140,71,87,129,82
29365,7855,3840,4015,1073,2123,644,949,2144,922
29369,9295,4507,4788,1600,2405,502,1395,2804,589
29370,936,454,482,138,238,78,139,275,68
29372,5385,2595,2790,772,1340,483,733,1385,672
29373,195,80,115,19,39,22,35,47,33
29374,4717,2920,1797,568,2147,205,594,895,308
29375,18,8,10,0,0,8,0,0,10
29376,5501,2754,2747,866,1561,327,783,1554,410
29377,287,132,155,77,55,0,77,59,19
29379,19895,9210,10685,2882,4666,1662,2922,5085,2678
29384,4057,2039,2018,619,1009,411,532,1018,468
29385,6540,3134,3406,1052,1625,457,1017,1835,554
29388,13698,6543,7155,2133,3428,982,2043,3725,1387
29401,11269,4937,6332,1413,2652,872,2511,2576,1245
29403,23317,11580,11737,5185,5108,1287,3866,5384,2487
29404,4482,2392,2090,1120,1260,12,995,1086,9
29405,30385,15419,14966,5321,8157,1941,4860,7122,2984
29406,36366,18130,18236,5697,10232,2201,5779,9511,2946
29407,36515,17157,19358,4714,9508,2935,4959,10283,4116
29412,31993,15406,16587,4280,8594,2532,3827,9062,3698
29414,23594,11379,12215,3494,6607,1278,2994,7455,1766
29418,21362,10354,11008,3538,5888,928,3499,6381,1128
29420,15165,7651,7514,3324,3921,406,2574,4423,517
29423,865,326,539,302,24,0,484,55,0
29426,1928,889,1039,337,441,111,335,476,228
29429,2675,1264,1411,404,671,189,469,697,245
29430,106,38,68,16,14,8,41,22,5
29431,5619,2714,2905,849,1455,410,870,1557,478
29432,2670,1267,1403,457,597,213,358,727,318
29434,774,381,393,178,179,24,163,183,47
29435,3772,1859,1913,568,1009,282,567,1061,285
29436,4417,2097,2320,822,947,328,738,1151,431
29437,2154,1004,1150,340,516,148,364,622,164
29438,2302,1076,1226,307,481,288,265,622,339
29439,1879,959,920,141,667,151,157,618,145
29440,28602,13541,15061,4617,6811,2113,4804,7460,2797
29445,48673,25374,23299,10983,12609,1782,8457,12776,2066
29446,1507,727,780,306,349,72,229,421,130
29448,2329,1135,1194,377,549,209,320,602,272
29449,7251,3486,3765,1196,1734,556,1139,1984,642
29450,2932,1462,1470,523,755,184,467,819,184
29451,4592,2252,2340,532,1233,487,458,1364,518
29452,508,268,240,93,125,50,72,122,46
29453,1177,540,637,136,308,96,153,354,130
29455,13777,6674,7103,1848,3441,1385,1809,3730,1564
29456,17870,8758,9112,3196,4890,672,3069,5164,879
29458,2954,1460,1494,522,687,251,422,784,288
29461,23821,11589,12232,3862,6047,1680,3688,6425,2119
29464,39455,18893,20562,5609,10855,2429,5139,12119,3304
29466,12977,6369,6608,2124,3723,522,1950,4057,601
29468,2202,1094,1108,362,561,171,288,540,280
29469,995,527,468,171,290,66,152,236,80
29470,4101,1959,2142,670,1007,282,655,1170,317
29471,1701,878,823,294,454,130,218,443,162
29472,9416,5691,3725,1359,3766,566,1141,1943,641
29474,1579,782,797,206,412,164,272,364,161
29475,2572,1164,1408,346,645,173,500,672,236
29477,6590,3101,3489,995,1576,530,1004,1623,862
29479,7240,3396,3844,1366,1537,493,1346,1867,631
29481,2009,982,1027,376,434,172,328,485,214
29482,1911,954,957,260,570,124,230,562,165
29483,47640,23122,24518,8575,12238,2309,7762,13519,3237
29485,28598,13984,14614,4956,7368,1660,4625,7906,2083
29487,2584,1208,1376,390,620,198,392,721,263
29488,21620,10620,11000,3945,5186,1489,3210,5658,2132
29492,2084,1013,1071,409,539,65,379,634,58
29493,149,69,80,19,37,13,23,38,19
29501,38546,17878,20668,5417,9882,2579,5478,11068,4122
29505,19340,9108,10232,3105,4760,1243,3050,5393,1789
29506,21153,9757,11396,3714,4845,1198,3773,5687,1936
29510,11789,5546,6243,1969,2773,804,2133,2942,1168
29511,4383,2123,2260,730,1174,219,678,1220,362
29512,19001,9490,9511,3062,5151,1277,2865,4809,1837
29516,707,328,379,88,172,68,138,159,82
29518,1298,652,646,222,381,49,176,378,92
29519,160,72,88,17,39,16,12,44,32
29520,14060,6462,7598,2159,3329,974,2284,3865,1449
29525,2029,920,1109,344,441,135,342,574,193
29526,30505,14976,15529,4906,7678,2392,4581,7973,2975
29527,17908,8771,9137,3197,4530,1044,2835,4831,1471
29530,2655,1267,1388,407,707,153,403,737,248
29532,21211,9973,11238,3441,4998,1534,3241,5800,2197
29536,17145,7890,9255,3009,3911,970,3143,4437,1675
29540,4956,2346,2610,869,1257,220,798,1386,426
29541,8203,4026,4177,1282,2280,464,1379,2215,583
29543,644,303,341,66,160,77,70,159,112
29544,4536,2223,2313,711,1220,292,702,1208,403
29545,1306,658,648,231,332,95,182,336,130
29546,3036,1518,1518,522,807,189,460,822,236
29547,2493,1152,1341,432,610,110,466,694,181
29550,31312,14708,16604,4860,7724,2124,4902,8630,3072
29554,10347,4899,5448,1794,2396,709,1637,2849,962
29555,6394,3063,3331,1159,1525,379,1008,1752,571
29556,14182,6560,7622,2578,3042,940,2470,3698,1454
29560,13466,6222,7244,2403,2993,826,2238,3684,1322
29563,2791,1250,1541,427,601,222,422,751,368
29564,1162,536,626,200,288,48,187,317,122
29565,6747,3122,3625,1219,1526,377,1137,1875,613
29566,11397,5355,6042,1151,2744,1460,1310,3101,1631
29567,637,361,276,139,169,53,87,166,23
29568,7788,3707,4081,1216,1934,557,1295,2144,642
29569,13687,6471,7216,2083,3477,911,2236,3668,1312
29570,4281,2090,2191,808,1021,261,681,1161,349
29571,16531,7672,8859,2906,3754,1012,2686,4494,1679
29572,8088,3936,4152,671,2135,1130,556,2181,1415
29574,13263,6065,7198,2176,2971,918,2139,3605,1454
29575,29524,14403,15121,3642,7262,3499,3239,7940,3942
29576,15329,7499,7830,1321,3634,2544,1061,3983,2786
29577,28027,14129,13898,3651,8623,1855,3405,7656,2837
29579,15002,7384,7618,2482,4086,816,2332,4283,1003
29580,1585,671,914,269,312,90,324,442,148
29581,4670,2314,2356,806,1209,299,672,1186,498
29582,12046,6004,6042,1105,3294,1605,1016,3284,1742
29583,5165,2340,2825,699,1248,393,880,1347,598
29584,2487,1335,1152,479,709,147,282,685,185
29585,10281,4919,5362,1041,2265,1613,1054,2674,1634
29589,115,43,72,15,18,10,26,27,19
29590,3223,1477,1746,675,613,189,637,829,280
29591,5345,2597,2748,773,1454,370,804,1419,525
29592,1032,482,550,182,250,50,175,285,90
29593,2368,1145,1223,330,618,197,351,676,196
29594,42,7,35,2,1,4,4,14,17
29596,2635,1271,1364,415,671,185,398,719,247
29601,9994,5238,4756,1160,3375,703,1091,2316,1349
29605,31058,14143,16915,4663,7372,2108,4776,8610,3529
29607,28175,13165,15010,4070,7245,1850,3774,8531,2705
29609,32002,15283,16719,5487,7756,2040,5838,7984,2897
29611,28254,13611,14643,4553,7066,1992,4295,7399,2949
29615,31344,15637,15707,3900,9053,2684,3462,8719,3526
29617,23385,11232,12153,3461,5897,1874,3361,6042,2750
29620,13601,6446,7155,2190,3214,1042,2093,3569,1493
29621,32265,15230,17035,4885,7762,2583,4880,8381,3774
29624,15968,7615,8353,2439,3838,1338,2356,3935,2062
29625,23555,11308,12247,3373,6169,1766,3316,6426,2505
29626,11992,5606,6386,1681,2961,964,1784,3483,1119
29627,17373,8270,9103,2346,4370,1554,2549,4577,1977
29628,3343,1599,1744,545,751,303,498,849,397
29630,11817,6137,5680,2112,3296,729,1782,3005,893
29631,17921,9359,8562,5116,3430,813,4767,2693,1102
29635,1065,545,520,139,249,157,103,255,162
29638,3165,1551,1614,527,733,291,391,874,349
29639,1712,817,895,328,365,124,391,323,181
29640,29203,14444,14759,4543,7880,2021,4030,8118,2611
29642,24655,11891,12764,3718,6720,1453,3817,6975,1972
29643,2382,1147,1235,223,694,230,345,570,320
29644,15997,8046,7951,2809,4327,910,2372,4442,1137
29645,10710,5416,5294,1680,3091,645,1592,2853,849
29646,28046,13188,14858,4561,6689,1938,4545,7114,3199
29649,23166,10571,12595,3521,5550,1500,4022,6392,2181
29650,23782,11539,12243,3638,6643,1258,3734,6717,1792
29651,33205,16359,16846,5137,8946,2276,4872,8810,3164
29653,4511,2117,2394,591,1153,373,688,1250,456
29654,9781,4668,5113,1287,2639,742,1469,2581,1063
29655,6962,3338,3624,920,1819,599,962,1836,826
29656,253,112,141,23,74,15,39,69,33
29657,14524,7255,7269,2372,3917,966,2185,3919,1165
29658,263,122,141,34,66,22,58,78,5
29659,192,69,123,14,44,11,70,44,9
29661,5857,3014,2843,985,1618,411,776,1542,525
29662,13116,6328,6788,1953,3571,804,1851,3719,1218
29664,1336,723,613,161,400,162,99,353,161
29665,37,12,25,0,6,6,7,0,18
29666,6306,3032,3274,996,1516,520,892,1694,688
29667,254,104,150,40,47,17,56,68,26
29669,10988,5557,5431,1826,2864,867,1495,2896,1040
29670,7114,3388,3726,1026,1852,510,925,2038,763
29671,18049,8836,9213,2584,4747,1505,2601,4713,1899
29672,9485,4634,4851,1151,2354,1129,1092,2499,1260
29673,21587,10792,10795,3610,5778,1404,2968,6117,1710
29676,4901,2445,2456,417,929,1099,380,953,1123
29677,170,63,107,13,30,20,22,41,44
29678,18877,9147,9730,2715,5005,1427,2814,4898,2018
29680,20025,10529,9496,3318,6545,666,3020,5738,738
29681,29982,14693,15289,5112,8167,1414,4689,8708,1892
29682,3311,1695,1616,592,834,269,461,900,255
29683,255,112,143,29,71,12,38,93,12
29684,4370,2130,2240,714,1131,285,674,1185,381
29685,995,495,500,129,256,110,114,269,117
29686,936,472,464,122,248,102,133,235,96
29687,35123,17118,18005,5564,9408,2146,5135,9930,2940
29688,692,276,416,230,46,0,354,62,0
29689,3752,1858,1894,500,1006,352,502,1035,357
29690,17125,8507,8618,3089,4462,956,2518,4671,1429
29691,11083,5485,5598,1798,2833,854,1463,2861,1274
29692,4967,2328,2639,653,1229,446,823,1214,602
29693,13873,6973,6900,2189,3617,1167,1814,3675,1411
29696,3283,1617,1666,502,871,244,411,934,321
29697,10773,5350,5423,1785,2876,689,1618,2829,976
29702,9711,4780,4931,1448,2655,677,1439,2634,858
29704,2882,1427,1455,416,814,197,467,788,200
29706,21233,9970,11263,3412,5185,1373,3421,5660,2182
29708,10718,5331,5387,1683,3042,606,1704,3124,559
29709,6090,2927,3163,905,1567,455,906,1581,676
29710,21989,11087,10902,3495,6094,1498,3025,5898,1979
29712,2338,1198,1140,412,670,116,365,621,154
29714,2919,1365,1554,419,787,159,483,838,233
29715,19710,9608,10102,3322,5018,1268,2779,5602,1721
29717,1188,636,552,220,323,93,140,311,101
29718,3316,1644,1672,562,840,242,473,873,326
29720,44039,21095,22944,6951,11222,2922,6851,11859,4234
29724,121,73,48,34,32,7,12,28,8
29726,1613,812,801,293,441,78,223,448,130
29727,1471,757,714,291,363,103,242,364,108
29728,9184,4381,4803,1537,2363,481,1632,2408,763
29729,1903,963,940,372,502,89,243,543,154
29730,45750,21672,24078,7403,11745,2524,8060,12395,3623
29732,39786,18941,20845,6091,10520,2330,6154,11083,3608
29741,1588,760,828,185,421,154,170,489,169
29742,1794,853,941,236,480,137,297,434,210
29743,1139,590,549,172,350,68,165,318,66
29745,22970,11308,11662,3807,6140,1361,3746,6076,1840
29801,25976,11978,13998,4042,6050,1886,4331,6502,3165
29803,30036,14697,15339,4605,7648,2444,4311,8125,2903
29805,4714,2295,2419,707,1297,291,748,1342,329
29809,2521,1226,1295,359,630,237,358,669,268
29810,5405,2499,2906,954,1128,417,919,1331,656
29812,11923,5793,6130,2136,2864,793,1914,3184,1032
29816,1132,623,509,192,324,107,121,261,127
29817,5282,2557,2725,890,1305,362,802,1392,531
29819,1366,760,606,298,367,95,167,384,55
29821,1018,519,499,178,251,90,141,303,55
29822,464,195,269,67,93,35,86,142,41
29824,8675,5022,3653,1067,3382,573,982,1870,801
29826,50,25,25,4,16,5,4,18,3
29827,4720,2755,1965,735,1682,338,682,915,368
29828,1037,466,571,171,212,83,185,266,120
29829,6908,3284,3624,1136,1660,488,1113,1841,670
29831,4390,2081,2309,699,1101,281,695,1242,372
29832,5561,2619,2942,915,1307,397,955,1409,578
29834,1038,518,520,165,287,66,96,267,157
29835,7422,4079,3343,953,2351,775,819,1518,1006
29836,651,343,308,154,140,49,92,169,47
29838,381,182,199,39,88,55,17,83,99
29840,272,113,159,58,48,7,51,94,14
29841,30434,14271,16163,4474,7659,2138,4632,8553,2978
29842,6852,3295,3557,1391,1520,384,1230,1785,542
29843,1453,777,676,258,346,173,173,338,165
29844,229,112,117,15,74,23,12,76,29
29845,1170,551,619,150,318,83,167,333,119
29846,69,34,35,6,16,12,6,13,16
29847,4127,2223,1904,827,1128,268,612,1024,268
29848,973,464,509,102,249,113,130,224,155
29849,368,183,185,54,121,8,31,125,29
29850,81,43,38,6,37,0,5,33,0
29851,6619,3272,3347,1017,1740,515,987,1756,604
29853,6800,3246,3554,1202,1543,501,1008,1806,740
29856,2742,1388,1354,565,705,118,524,740,90
29860,11129,5390,5739,1841,2986,563,1785,3252,702
29902,27190,14420,12770,6095,6746,1579,4168,6254,2348
29906,21756,11224,10532,4653,5848,723,4233,5491,808
29910,17615,8529,9086,2323,4035,2171,2105,4603,2378
29911,1858,915,943,326,473,116,301,455,187
29916,1560,712,848,225,351,136,287,405,156
29918,6754,4011,2743,1038,2618,355,913,1322,508
29920,9486,4569,4917,1359,2043,1167,1348,2244,1325
29921,269,144,125,63,59,22,33,76,16
29922,896,407,489,163,175,69,176,188,125
29923,481,219,262,80,116,23,102,121,39
29924,4447,2152,2295,746,1023,383,640,1144,511
29926,18761,9261,9500,2193,4315,2753,2140,4433,2927
29927,6537,3382,3155,1281,1702,399,1080,1572,503
29928,17075,8688,8387,1602,4306,2780,1221,4179,2987
29929,1285,661,624,204,362,95,154,320,150
29932,185,90,95,23,49,18,19,43,33
29934,1256,564,692,203,254,107,240,346,106
29935,3590,1739,1851,651,965,123,553,980,318
29936,11030,6096,4934,1865,3392,839,1453,2552,929
29939,184,78,106,27,45,6,43,46,17
29940,4385,2080,2305,820,1035,225,811,1132,362
29941,0,0,0,0,0,0,0,0,0
29943,245,124,121,33,77,14,21,70,30
29944,4618,2139,2479,787,1052,300,881,1202,396
29945,4266,2032,2234,757,888,387,750,1006,478
30002,5302,2462,2840,744,1489,229,881,1527,432
30004,41436,20627,20809,6479,12192,1956,5922,12542,2345
30005,26913,13353,13560,4756,8091,506,4698,8245,617
30008,31010,16244,14766,5306,10045,893,4290,8586,1890
30011,11505,5906,5599,2159,3436,311,1970,3188,441
30012,23899,12132,11767,4185,6527,1420,3572,6079,2116
30013,18260,9070,9190,3139,4894,1037,2603,5364,1223
30014,25799,12491,13308,4381,6335,1775,4194,6729,2385
30016,26179,12896,13283,4591,7129,1176,4169,7614,1500
30017,12408,6180,6228,2239,3450,491,2146,3575,507
30019,19465,9652,9813,3388,5595,669,3231,5742,840
30021,24419,12139,12280,4540,7159,440,4402,7152,726
30022,54532,27105,27427,9722,15983,1400,8975,16756,1696
30024,35416,17723,17693,6365,10492,866,5964,10634,1095
30025,7071,3383,3688,1118,1776,489,1074,1922,692
30030,25288,10873,14415,2670,6936,1267,3298,8244,2873
30032,59700,28982,30718,10698,16126,2158,10219,17069,3430
30033,26814,12276,14538,2615,7597,2064,2701,8112,3725
30034,44836,20861,23975,8228,11177,1456,7740,13924,2311
30035,19160,8616,10544,3441,4499,676,3559,6159,826
30038,23700,10939,12761,4202,6007,730,4183,7558,1020
30039,12889,6484,6405,2371,3687,426,2069,3688,648
30040,42426,21416,21010,7019,12305,2092,6207,11750,3053
30041,32771,16748,16023,5366,9889,1493,4786,9607,1630
30043,62243,31524,30719,11634,18438,1452,10879,17980,1860
30044,66330,32720,33610,11563,19446,1711,10661,20289,2660
30045,36701,18252,18449,6414,10287,1551,5701,10338,2410
30047,53384,26646,26738,9075,15187,2384,8113,15474,3151
30052,35266,17418,17848,6088,9555,1775,5977,9907,1964
30054,9423,4534,4889,1549,2396,589,1736,2483,670
30055,2029,1022,1007,308,548,166,233,580,194
30056,1957,983,974,378,528,77,351,544,79
30058,58122,27088,31034,10829,14875,1384,10580,18267,2187
30060,36210,18578,17632,6400,10152,2026,5352,9553,2727
30062,61785,30720,31065,9924,18120,2676,9176,18814,3075
30064,42612,20747,21865,6967,11579,2201,6243,12498,3124
30066,50751,25012,25739,8435,14447,2130,8065,15068,2606
30067,47873,24044,23829,6473,15931,1640,5989,15681,2159
30068,31959,15377,16582,4804,8563,2010,4520,9835,2227
30070,357,168,189,67,76,25,68,90,31
30071,22335,12334,10001,4047,7735,552,3305,5896,800
30072,444,209,235,45,144,20,31,184,20
30075,46330,22841,23489,7466,13002,2373,6973,13630,2886
30076,42124,21358,20766,6437,13170,1751,5758,12560,2448
30078,28952,14273,14679,5108,7734,1431,4614,8116,1949
30079,2665,1218,1447,530,562,126,483,748,216
30080,43660,21451,22209,5435,14353,1663,4907,14882,2420
30082,23187,11191,11996,3230,6645,1316,2969,7041,1986
30083,56234,26655,29579,9892,14906,1857,9305,17354,2920
30084,32711,15824,16887,4276,9302,2246,3942,9631,3314
30087,32504,15704,16800,5409,8479,1816,5060,9776,1964
30088,29190,13480,15710,5316,7443,721,5026,9621,1063
30092,35051,17441,17610,5199,11295,947,5309,11100,1201
30093,49134,25573,23561,8157,16415,1001,7750,14477,1334
30094,26565,13068,13497,4676,7046,1346,4437,7437,1623
30096,52681,26352,26329,7667,17094,1591,7299,16830,2200
30097,24192,11806,12386,4107,6949,750,4289,7273,824
30101,38983,19279,19704,6789,11140,1350,6471,11599,1634
30102,32740,16865,15875,6026,9706,1133,5249,9362,1264
30103,11148,5510,5638,1736,3056,718,1759,3031,848
30104,3822,1810,2012,487,1049,274,597,1066,349
30105,2305,1115,1190,334,577,204,334,603,253
30106,15289,7101,8188,2380,3920,801,2421,4489,1278
30107,8054,4090,3964,1341,2245,504,1213,2242,509
30108,7399,3563,3836,1146,1850,567,1074,1916,846
30110,11426,5587,5839,1880,2852,855,1686,2986,1167
30113,5731,2814,2917,865,1516,433,828,1473,616
30114,22342,11312,11030,3638,6483,1191,3269,6022,1739
30115,19872,9942,9930,3034,5814,1094,3021,5738,1171
30116,18140,9008,9132,3337,4754,917,2999,4970,1163
30117,32585,15618,16967,5759,7989,1870,5894,8138,2935
30120,29730,14387,15343,5087,7641,1659,4828,8031,2484
30121,15559,7779,7780,2510,4438,831,2415,4079,1286
30122,16380,8005,8375,2516,4677,812,2562,4734,1079
30124,2849,1392,1457,413,688,291,380,798,279
30125,22903,11372,11531,3652,6099,1621,3424,5531,2576
30126,26523,12967,13556,4177,7314,1476,3973,7519,2064
30127,47199,23153,24046,8853,12617,1683,8301,13560,2185
30132,17601,8784,8817,3105,4788,891,2859,4670,1288
30134,31978,15953,16025,5919,8733,1301,4923,9342,1760
30135,43280,21142,22138,7060,12196,1886,7252,12508,2378
30137,1209,611,598,199,329,83,172,319,107
30139,3422,1735,1687,558,943,234,459,918,310
30141,12896,6212,6684,2158,3516,538,2374,3608,702
30143,17788,8471,9317,2174,4532,1765,2463,4671,2183
30144,39432,19488,19944,6247,11893,1348,6043,12018,1883
30145,5914,2969,2945,1064,1656,249,940,1677,328
30147,4709,2298,2411,746,1230,322,786,1151,474
30148,413,227,186,64,146,17,43,126,17
30152,26597,13365,13232,4914,7432,1019,4468,7492,1272
30153,14409,7075,7334,2505,3635,935,2270,3726,1338
30157,28004,14166,13838,5229,8040,897,4623,8067,1148
30161,34148,16664,17484,5244,8657,2763,4711,8688,4085
30165,37322,17824,19498,6136,8997,2691,6407,8951,4140
30168,20589,10159,10430,3676,5833,650,3528,6009,893
30170,2994,1488,1506,545,796,147,503,760,243
30171,2986,1534,1452,589,848,97,415,871,166
30173,6162,3203,2959,1147,1656,400,820,1724,415
30175,4568,2356,2212,747,1205,404,685,1153,374
30176,6496,3040,3456,950,1544,546,1089,1627,740
30177,334,183,151,61,87,35,20,92,39
30178,2841,1490,1351,531,840,119,407,754,190
30179,9600,4754,4846,1483,2675,596,1540,2614,692
30180,17780,8721,9059,2966,4781,974,2782,4852,1425
30182,2456,1310,1146,540,664,106,383,586,177
30183,3762,1882,1880,581,948,353,564,963,353
30184,4773,2355,2418,809,1271,275,711,1358,349
30185,3821,1938,1883,660,1096,182,586,1036,261
30187,6203,3129,3074,1048,1718,363,903,1763,408
30188,36630,18116,18514,5921,10873,1322,5781,10869,1864
30189,33200,16489,16711,5779,9761,949,5811,9783,1117
30204,12410,5924,6486,2032,2952,940,2129,3172,1185
30205,2647,1333,1314,427,682,224,460,681,173
30206,2287,1116,1171,394,548,174,320,615,236
30213,14566,7109,7457,2355,3848,906,2359,3951,1147
30214,21970,10406,11564,3223,5624,1559,3226,6286,2052
30215,26525,13042,13483,4673,7059,1310,4269,7650,1564
30216,2334,1155,1179,418,616,121,419,618,142
30217,8854,4296,4558,1386,2332,578,1445,2356,757
30218,1868,968,900,305,543,120,259,507,134
30220,3128,1423,1705,489,761,173,598,813,294
30222,4317,2104,2213,778,1025,301,604,1086,523
30223,34764,16294,18470,5877,8376,2041,6130,9190,3150
30224,21240,10551,10689,3535,5400,1616,2917,5525,2247
30228,21529,11299,10230,4089,6296,914,3312,5668,1250
30230,8183,3910,4273,1321,2062,527,1458,2038,777
30233,19130,10288,8842,2895,6112,1281,2582,4631,1629
30234,679,290,389,97,157,36,148,198,43
30236,42787,21039,21748,7260,11834,1945,6736,12392,2620
30238,30775,14575,16200,5999,7666,910,5849,9108,1243
30240,26228,12262,13966,4329,6369,1564,4518,6741,2707
30241,19873,9696,10177,3296,5089,1311,3167,5088,1922
30248,11156,5586,5570,2009,3096,481,1819,3188,563
30250,83,35,48,9,20,6,11,32,5
30251,2155,984,1171,346,523,115,459,553,159
30252,18634,9304,9330,3164,5134,1006,2857,5292,1181
30253,26327,12884,13443,4548,7240,1096,4447,7442,1554
30256,2110,1062,1048,384,555,123,319,518,211
30257,2981,1441,1540,374,800,267,431,818,291
30258,2245,1181,1064,398,585,198,295,571,198
30259,2557,1281,1276,455,609,217,363,708,205
30260,23248,11228,12020,4202,5780,1246,3858,6390,1772
30263,41393,20230,21163,6876,10918,2436,6567,11028,3568
30265,18079,9054,9025,3204,5080,770,2933,5317,775
30268,7141,3404,3737,1179,1800,425,1186,1960,591
30269,32753,16050,16703,5985,8386,1679,5368,9258,2077
30273,11142,5226,5916,1907,3038,281,1976,3509,431
30274,32571,15061,17510,6160,7969,932,6221,10010,1279
30275,222,117,105,68,49,0,36,48,21
30276,8845,4504,4341,1632,2418,454,1415,2396,530
30277,15541,7779,7762,2616,4454,709,2439,4647,676
30281,49011,24163,24848,8241,13718,2204,7917,14150,2781
30285,645,291,354,137,139,15,138,192,24
30286,23939,11388,12551,3750,5763,1875,3287,6254,3010
30288,6465,3074,3391,1296,1529,249,1145,1828,418
30290,5126,2515,2611,854,1342,319,779,1478,354
30291,12138,5411,6727,1957,2889,565,1869,3534,1324
30292,4709,2422,2287,817,1376,229,726,1340,221
30293,3614,1694,1920,524,855,315,534,933,453
30294,27622,13443,14179,5010,7583,850,4800,8276,1103
30295,3265,1558,1707,483,846,229,539,872,296
30296,21227,10143,11084,3635,5548,960,3556,6420,1108
30297,29605,14985,14620,5489,8056,1440,5285,7456,1879
30303,4077,2758,1319,352,2295,111,473,793,53
30305,21361,10396,10965,1610,7020,1766,1574,6529,2862
30306,21043,10885,10158,1449,8708,728,1345,7747,1066
30307,16591,8196,8395,2150,5449,597,2183,5424,788
30308,11688,6551,5137,888,5175,488,922,3346,869
30309,18725,10121,8604,1001,8445,675,1139,6677,788
30310,33774,15976,17798,5722,8436,1818,5887,9013,2898
30311,35460,15711,19749,5756,7876,2079,5639,10446,3664
30312,20066,9529,10537,3269,5475,785,3314,5650,1573
30313,10695,6139,4556,3013,2933,193,2528,1866,162
30314,27342,13076,14266,5686,5782,1608,5469,5928,2869
30315,40162,20099,20063,7579,10827,1693,7790,9471,2802
30316,32551,15344,17207,5381,8592,1371,5290,9869,2048
30317,13854,6835,7019,2211,3737,887,1908,3694,1417
30318,53591,27197,26394,9310,15388,2499,8967,13547,3880
30319,36778,17960,18818,3455,12310,2195,3851,11333,3634
30322,1749,878,871,802,76,0,850,21,0
30324,20804,11909,8895,1676,9231,1002,1137,6375,1383
30326,942,497,445,25,409,63,41,359,45
30327,20936,10091,10845,2714,5612,1765,2569,5951,2325
30328,28844,13617,15227,3042,8538,2037,2926,9096,3205
30329,27396,14687,12709,3703,9908,1076,2591,7826,2292
30331,44511,20115,24396,7670,10291,2154,8156,12776,3464
30336,247,134,113,52,48,34,27,68,18
30337,16047,7674,8373,2976,4287,411,2842,4763,768
30338,29120,14026,15094,3345,8126,2555,3135,8971,2988
30339,15862,8074,7788,906,6701,467,1087,6198,503
30340,26626,13987,12639,4275,8556,1156,3658,7532,1449
30341,31300,17350,13950,4444,11415,1491,3631,8393,1926
30342,25821,13405,12416,2969,9234,1202,2634,8051,1731
30344,36426,17368,19058,6818,8828,1722,6408,10163,2487
30345,23273,12693,10580,3283,7686,1724,2710,5760,2110
30346,1290,702,588,52,640,10,4,565,19
30349,55868,25868,30000,9912,14431,1525,9862,17924,2214
30350,30974,15149,15825,3288,10693,1168,2934,11393,1498
30354,17866,8472,9394,3486,4339,647,3391,5067,936
30360,14679,8107,6572,2194,5310,603,1663,4119,790
30401,12629,5899,6730,2239,2720,940,2202,3087,1441
30410,1852,925,927,278,483,164,279,479,169
30411,3645,2270,1375,607,1484,179,441,672,262
30412,224,110,114,25,63,22,27,56,31
30413,1532,735,797,208,377,150,197,376,224
30414,239,130,109,35,68,27,24,63,22
30415,5547,2603,2944,922,1305,376,987,1425,532
30417,9373,4527,4846,1669,2238,620,1468,2471,907
30420,2041,1075,966,382,512,181,231,525,210
30421,2554,1260,1294,383,595,282,393,579,322
30423,270,136,134,50,48,38,22,94,18
30425,1434,658,776,246,279,133,289,311,176
30426,1287,626,661,238,319,69,194,364,103
30427,11462,6304,5158,2007,3637,660,1655,2502,1001
30428,2460,1213,1247,391,632,190,361,566,320
30429,574,284,290,112,160,12,118,137,35
30434,6202,2915,3287,1061,1437,417,1124,1517,646
30436,11510,5568,5942,1912,2866,790,2068,2917,957
30438,235,116,119,30,67,19,27,49,43
30439,8845,4332,4513,1501,2050,781,1353,2145,1015
30441,2076,930,1146,303,503,124,361,545,240
30442,7582,3714,3868,1384,1762,568,1167,1890,811
30445,3262,1733,1529,599,1006,128,614,703,212
30446,1377,674,703,221,287,166,227,304,172
30447,54,31,23,6,10,15,0,17,6
30448,58,41,17,21,15,5,9,5,3
30450,2757,1337,1420,478,686,173,480,684,256
30452,1429,677,752,231,318,128,268,349,135
30453,8495,5438,3057,1370,3695,373,1010,1552,495
30454,610,297,313,104,132,61,114,119,80
30455,753,403,350,144,198,61,115,151,84
30456,2064,1034,1030,437,447,150,344,518,168
30457,6209,3052,3157,1095,1495,462,944,1499,714
30458,31896,15359,16537,7053,6890,1416,7297,7077,2163
30461,10644,5289,5355,1882,2815,592,1891,2747,717
30464,252,181,71,87,91,3,32,29,10
30467,13270,6350,6920,2280,3095,975,2110,3389,1421
30470,907,438,469,134,261,43,137,251,81
30471,4446,2212,2234,795,1138,279,747,1070,417
30473,2790,1429,1361,563,647,219,373,733,255
30474,15265,7071,8194,2476,3601,994,2550,3857,1787
30477,3193,1386,1807,550,628,208,647,771,389
30501,29528,15279,14249,5088,8533,1658,4823,6786,2640
30504,15582,7974,7608,2682,4445,847,2566,3855,1187
30506,31253,15612,15641,4885,8465,2262,4537,8560,2544
30507,20704,10592,10112,3734,5834,1024,3543,5361,1208
30510,6728,3983,2745,1478,2177,328,871,1509,365
30511,2739,1408,1331,408,806,194,382,689,260
30512,15948,7798,8150,1926,3726,2146,1841,3764,2545
30513,9449,4557,4892,1177,2243,1137,1077,2477,1338
30516,1617,842,775,281,449,112,183,431,161
30517,5049,2515,2534,824,1371,320,785,1426,323
30518,29217,14696,14521,4777,8550,1369,4287,8161,2073
30519,19383,10171,9212,3259,6089,823,2942,5340,930
30520,3914,1955,1959,656,1024,275,563,995,401
30521,4593,2254,2339,634,1270,350,770,1037,532
30522,592,286,306,50,155,81,25,237,44
30523,10529,5240,5289,1431,2709,1100,1309,2686,1294
30525,7100,3555,3545,1003,1839,713,820,1781,944
30527,3192,1510,1682,460,764,286,483,884,315
30528,16587,8184,8403,2577,4138,1469,2385,4347,1671
30529,9054,4266,4788,1364,2290,612,1239,2422,1127
30530,4676,2381,2295,805,1186,390,688,1217,390
30531,9925,4972,4953,1605,2609,758,1302,2489,1162
30533,19046,9430,9616,3349,4925,1156,3490,4654,1472
30534,17187,8694,8493,2765,4898,1031,2434,4944,1115
30535,6024,2751,3273,832,1488,431,1130,1439,704
30537,1369,637,732,148,319,170,162,304,266
30538,2210,1034,1176,293,556,185,367,530,279
30539,506,281,225,98,148,35,81,100,44
30540,20601,10418,10183,3147,5446,1825,2788,5271,2124
30541,1296,582,714,147,337,98,237,354,123
30542,21265,10887,10378,3847,6257,783,3343,5980,1055
30543,3236,1602,1634,534,846,222,521,837,276
30545,737,335,402,85,173,77,80,206,116
30546,6154,2948,3206,636,1283,1029,611,1437,1158
30547,2811,1408,1403,471,775,162,384,791,228
30548,6168,2994,3174,1031,1688,275,984,1781,409
30549,13112,6645,6467,2175,3768,702,2034,3468,965
30552,1546,762,784,191,394,177,152,422,210
30553,6433,2997,3436,783,1562,652,920,1581,935
30554,5994,2983,3011,972,1638,373,929,1612,470
30555,2070,944,1126,269,454,221,269,542,315
30557,4422,2234,2188,725,1148,361,605,1164,419
30558,4673,2354,2319,840,1242,272,741,1178,400
30559,3467,1748,1719,486,838,424,417,827,475
30560,3648,1759,1889,442,962,355,486,959,444
30562,824,365,459,108,189,68,120,209,130
30563,4392,2285,2107,752,1208,325,624,1223,260
30564,3586,1713,1873,534,976,203,624,1030,219
30565,3822,1934,1888,682,1071,181,618,1033,237
30566,6996,3471,3525,1210,1936,325,1095,1953,477
30567,1934,974,960,278,530,166,267,545,148
30568,1464,740,724,275,334,131,201,380,143
30571,2697,1337,1360,318,697,322,366,659,335
30572,1227,663,564,131,307,225,101,278,185
30575,1549,814,735,317,397,100,287,358,90
30576,2391,1193,1198,300,648,245,282,616,300
30577,21691,10415,11276,3162,5407,1846,3071,5513,2692
30581,17,0,17,0,0,0,11,6,0
30582,3453,1618,1835,463,674,481,589,766,480
30598,703,302,401,183,119,0,317,79,5
30601,17526,8840,8686,3415,4738,687,2988,4514,1184
30602,1420,564,856,514,50,0,762,94,0
30605,38742,18930,19812,8163,9520,1247,9255,8971,1586
30606,35462,17337,18125,5649,9753,1935,5428,9778,2919
30607,8742,4339,4403,1575,2394,370,1572,2357,474
30619,974,467,507,147,253,67,132,265,110
30620,5342,2663,2679,905,1547,211,755,1578,346
30621,3176,1526,1650,535,811,180,543,814,293
30622,7642,3573,4069,1089,1990,494,1219,2025,825
30624,2553,1206,1347,370,655,181,428,680,239
30625,1836,911,925,210,550,151,268,511,146
30627,2491,1241,1250,378,670,193,386,634,230
30628,5391,2644,2747,919,1473,252,931,1461,355
30629,4075,1971,2104,569,1030,372,481,1125,498
30630,2630,1185,1445,354,620,211,364,744,337
30631,2161,1069,1092,327,519,223,271,514,307
30633,8680,4250,4430,1414,2310,526,1381,2289,760
30634,2476,1423,1053,459,815,149,322,593,138
30635,16624,7802,8822,2569,3816,1417,2474,4235,2113
30638,52,26,26,17,9,0,10,9,7
30639,355,163,192,144,14,5,153,29,10
30641,1293,687,606,205,386,96,205,311,90
30642,9758,4694,5064,1468,2246,980,1435,2605,1024
30643,14707,6998,7709,2053,3472,1473,1932,3628,2149
30646,6230,3082,3148,970,1728,384,973,1680,495
30648,2263,1125,1138,353,626,146,396,590,152
30650,10410,4924,5486,1741,2492,691,1708,2631,1147
30655,17474,8354,9120,2850,4446,1058,2802,4746,1572
30656,10165,4888,5277,1571,2798,519,1686,2805,786
30660,1106,558,548,217,245,96,131,268,149
30662,8080,3816,4264,1308,1843,665,1245,1989,1030
30663,2424,1196,1228,375,644,177,376,646,206
30664,42,21,21,5,14,2,8,9,4
30665,339,139,200,34,79,26,46,99,55
30666,5419,2730,2689,940,1376,414,795,1451,443
30667,859,404,455,122,222,60,140,204,111
30668,2010,1011,999,292,496,223,250,517,232
30669,3515,1665,1850,601,799,265,589,876,385
30671,38,16,22,3,13,0,3,14,5
30673,8175,3759,4416,1166,1857,736,1253,2042,1121
30677,13801,6848,6953,2495,3594,759,2273,3987,693
30678,1092,547,545,182,283,82,124,258,163
30680,25800,12628,13172,4230,6892,1506,3994,6824,2354
30683,5394,2643,2751,816,1469,358,839,1470,442
30701,29532,14481,15051,4644,8096,1741,4750,7771,2530
30705,31453,15838,15615,5547,8710,1581,5000,8473,2142
30707,13797,6789,7008,2221,3538,1030,2014,3761,1233
30708,453,256,197,94,128,34,51,102,44
30710,5291,2628,2663,958,1471,199,832,1514,317
30711,3725,1829,1896,631,1032,166,634,1003,259
30720,25028,12665,12363,4366,6573,1726,3411,6498,2454
30721,40375,20446,19929,7355,10780,2311,6577,10171,3181
30724,153,74,79,9,54,11,15,47,17
30725,3451,1682,1769,520,887,275,459,943,367
30726,78,28,50,10,9,9,22,28,0
30728,17320,8413,8907,2748,4484,1181,2415,4605,1887
30730,1876,967,909,276,561,130,267,468,174
30731,2425,1276,1149,389,705,182,296,621,232
30733,1820,925,895,267,525,133,259,480,156
30734,3038,1534,1504,471,844,219,433,816,255
30735,5419,2780,2639,953,1504,323,773,1485,381
30736,33571,16488,17083,5366,8978,2144,5129,9341,2613
30738,3534,1703,1831,468,940,295,507,1003,321
30739,3526,1906,1620,390,1257,259,424,905,291
30740,6272,3055,3217,835,1720,500,905,1782,530
30741,28133,13326,14807,4310,6707,2309,3838,7313,3656
30742,5928,2730,3198,773,1417,540,792,1539,867
30746,1260,658,602,234,341,83,159,319,124
30747,16228,8517,7711,2576,4656,1285,2099,3765,1847
30750,3858,1808,2050,751,827,230,867,904,279
30752,8655,4328,4327,1492,2129,707,1124,2270,933
30753,6789,3344,3445,1041,1790,513,1051,1647,747
30755,9186,4576,4610,1521,2559,496,1383,2596,631
30757,1862,865,997,227,520,118,264,515,218
30802,5188,2503,2685,807,1347,349,858,1411,416
30803,647,323,324,94,187,42,71,178,75
30805,2142,936,1206,314,508,114,470,587,149
30807,169,74,95,24,35,15,13,47,35
30808,4526,2100,2426,670,1112,318,825,1206,395
30809,25557,12516,13041,4600,6776,1140,4446,7017,1578
30810,1839,900,939,280,436,184,209,439,291
30813,16758,8648,8110,2696,5139,813,2806,4358,946
30814,6999,3428,3571,1217,1787,424,1053,1925,593
30815,37614,18361,19253,7610,9344,1407,7013,10571,1669
30816,2175,1107,1068,381,489,237,367,466,235
30817,7955,3881,4074,1204,1946,731,1039,2124,911
30818,670,288,382,92,173,23,203,159,20
30820,1087,509,578,134,278,97,184,288,106
30821,990,492,498,167,238,87,128,261,109
30822,519,240,279,84,109,47,124,106,49
30823,1683,789,894,262,432,95,302,446,146
30824,16693,7898,8795,2906,3965,1027,2620,4498,1677
30828,4527,2059,2468,804,914,341,721,1185,562
30830,13123,6182,6941,2519,3003,660,2392,3469,1080
30833,3715,1677,2038,607,795,275,577,1028,433
30901,21941,10290,11651,3783,4754,1753,3693,5236,2722
30904,28222,13060,15162,3910,7056,2094,4150,7658,3354
30905,7754,5229,2525,3069,2160,0,1268,1242,15
30906,59452,27994,31458,10592,13862,3540,10429,16211,4818
30907,45394,22033,23361,7515,12130,2388,6847,13265,3249
30909,35052,16509,18543,5090,9115,2304,4902,10000,3641
31001,3814,2494,1320,519,1729,246,364,641,315
31002,2384,1181,1203,413,558,210,325,588,290
31003,207,82,125,17,56,9,40,59,26
31005,9462,4614,4848,1591,2594,429,1664,2695,489
31006,4991,2458,2533,891,1188,379,853,1159,521
31007,990,436,554,184,172,80,175,227,152
31008,13622,6683,6939,2337,3679,667,2314,3834,791
31009,1074,537,537,161,272,104,145,284,108
31011,818,412,406,145,220,47,115,216,75
31012,2310,1700,610,291,1279,130,181,321,108
31014,12374,5851,6523,2183,2695,973,2129,2985,1409
31015,20845,9679,11166,3551,4710,1418,3676,5325,2165
31016,1457,680,777,199,361,120,202,426,149
31017,1948,834,1114,285,398,151,326,504,284
31018,2359,666,1693,187,420,59,343,1253,97
31019,2091,1020,1071,340,539,141,334,572,165
31020,3258,1543,1715,514,862,167,552,821,342
31021,27339,13104,14235,4367,6695,2042,4227,7118,2890
31022,1076,531,545,190,222,119,125,269,151
31023,13596,6583,7013,2419,3128,1036,2127,3414,1472
31024,17596,8630,8966,2523,4455,1652,2471,4546,1949
31025,1353,685,668,275,310,100,199,366,103
31027,9679,4620,5059,1635,2376,609,1666,2558,835
31028,3762,1880,1882,507,1056,317,585,971,326
31029,13811,6844,6967,2391,3675,778,2200,3646,1121
31030,17534,8396,9138,3156,4247,993,3308,4361,1469
31031,6655,3246,3409,1151,1648,447,1051,1755,603
31032,10834,5289,5545,1827,2715,747,1678,2885,982
31033,1930,998,932,324,499,175,226,553,153
31034,5095,5095,0,283,4440,372,0,0,0
31035,1539,748,791,230,406,112,238,370,183
31036,10273,4423,5850,1513,2206,704,1430,3316,1104
31037,3383,2134,1249,471,1494,169,408,603,238
31038,838,417,421,125,260,32,114,218,89
31039,42,29,13,11,18,0,0,13,0
31041,1009,445,564,130,195,120,164,233,167
31042,2115,991,1124,333,510,148,423,521,180
31044,3607,1758,1849,573,922,263,572,942,335
31045,131,64,67,13,47,4,17,42,8
31046,2730,1346,1384,435,719,192,399,755,230
31047,5665,2931,2734,1103,1527,301,794,1565,375
31049,1556,788,768,271,396,121,219,367,182
31050,894,475,419,122,289,64,132,242,45
31051,213,106,107,55,40,11,45,42,20
31052,6731,3436,3295,1128,1857,451,903,1841,551
31054,1444,659,785,232,312,115,260,364,161
31055,4445,2024,2421,688,1021,315,641,1105,675
31057,2235,979,1256,371,469,139,392,597,267
31058,1720,868,852,314,415,139,263,477,112
31060,2318,1287,1031,324,790,173,262,544,225
31061,38959,18708,20251,6728,9519,2461,6540,10220,3491
31063,5941,2696,3245,985,1308,403,1226,1412,607
31064,7934,3873,4061,1201,2014,658,1174,2026,861
31065,895,424,471,134,228,62,172,229,70
31066,1348,673,675,207,373,93,196,363,116
31067,211,90,121,20,55,15,19,48,54
31068,4337,2520,1817,803,1508,209,595,951,271
31069,15668,7489,8179,2583,3958,948,2562,4203,1414
31070,850,415,435,95,227,93,104,218,113
31071,1476,689,787,258,285,146,259,293,235
31072,1291,634,657,208,330,96,194,325,138
31075,1838,891,947,297,498,96,337,465,145
31076,3265,1560,1705,536,807,217,467,880,358
31077,1229,596,633,163,302,131,174,273,186
31078,3449,1685,1764,555,845,285,514,901,349
31079,2812,1345,1467,498,660,187,499,717,251
31081,184,82,102,18,39,25,34,44,24
31082,10609,4962,5647,1837,2420,705,1674,2821,1152
31083,230,126,104,55,61,10,36,59,9
31085,1063,528,535,261,200,67,198,270,67
31087,9927,5317,4610,1517,3117,683,1395,2291,924
31088,37990,18871,19119,6516,10188,2167,5889,10537,2693
31089,4812,2321,2491,924,1140,257,861,1182,448
31090,1084,507,577,134,269,104,148,276,153
31091,3786,2329,1457,496,1558,275,434,700,323
31092,5630,2728,2902,1051,1363,314,959,1465,478
31093,27742,13201,14541,4490,6876,1835,4620,7349,2572
31094,1266,567,699,178,305,84,213,347,139
31096,6642,3330,3312,1419,1413,498,1026,1542,744
31097,1435,676,759,161,366,149,251,347,161
31098,5496,3080,2416,1670,1400,10,1265,1137,14
31201,10855,4376,6479,1388,2489,499,2822,2522,1135
31204,33304,14914,18390,5228,7379,2307,5024,9125,4241
31206,31410,14101,17309,5976,6335,1790,6091,8261,2957
31210,27859,12989,14870,4089,7126,1774,4372,8065,2433
31211,15953,7365,8588,2409,3875,1081,2360,4509,1719
31216,14009,7339,6670,1906,4439,994,1809,3642,1219
31217,18714,8466,10248,3009,4356,1101,3422,4942,1884
31220,11333,5658,5675,1878,3229,551,1714,3280,681
31301,4292,2151,2141,928,1123,100,1015,1014,112
31302,7176,3625,3551,1249,1892,484,1167,1897,487
31303,2172,1127,1045,421,539,167,344,554,147
31305,5246,2576,2670,1042,1206,328,887,1323,460
31307,1046,523,523,223,256,44,153,283,87
31308,6472,3245,3227,1103,1736,406,1022,1786,419
31309,1142,542,600,169,338,35,234,303,63
31312,11041,5672,5369,2153,2998,521,1786,2915,668
31313,35771,17604,18167,7369,9536,699,7424,9643,1100
31314,3902,3523,379,2058,1465,0,192,187,0
31315,9338,4891,4447,2442,2449,0,2252,2195,0
31316,6031,3038,2993,1232,1514,292,1067,1544,382
31318,324,157,167,50,77,30,84,72,11
31319,119,76,43,17,46,13,0,43,0
31320,6702,3399,3303,1042,1741,616,914,1727,662
31321,5756,2841,2915,1044,1473,324,990,1523,402
31322,6291,3047,3244,1013,1738,296,982,1821,441
31323,1799,884,915,311,453,120,311,463,141
31324,14508,7225,7283,2790,3837,598,2486,4131,666
31326,12175,5914,6261,2173,3254,487,2144,3396,721
31327,72,40,32,5,15,20,7,13,12
31328,3713,1817,1896,342,1011,464,294,1086,516
31329,6912,3296,3616,1092,1843,361,1280,1837,499
31331,5206,2607,2599,800,1287,520,719,1427,453
31333,1351,698,653,334,341,23,268,366,19
31401,21750,10561,11189,4348,5154,1059,3911,5276,2002
31404,32197,14578,17619,5450,7193,1935,5787,8615,3217
31405,32410,16039,16371,5508,8264,2267,4558,8433,3380
31406,35034,16809,18225,5657,8705,2447,5188,9515,3522
31407,3124,1551,1573,387,865,299,365,757,451
31408,11122,5985,5137,1781,3486,718,1639,2608,890
31410,22148,10917,11231,3355,6146,1416,3035,6567,1629
31411,6958,3391,3567,468,1045,1878,433,1410,1724
31415,12843,5761,7082,2369,2290,1102,2246,3058,1778
31419,41001,19605,21396,6221,11182,2202,6503,11898,2995
31501,14706,6807,7899,2242,3246,1319,2163,3656,2080
31503,20964,10702,10262,3183,6074,1445,3146,5014,2102
31510,8855,4408,4447,1449,2296,663,1268,2261,918
31512,2399,1116,1283,351,573,192,398,620,265
31513,15474,7609,7865,2678,3875,1056,2511,3958,1396
31516,12062,5850,6212,1978,3051,821,1854,3108,1250
31518,806,416,390,169,197,50,94,226,70
31519,3378,1585,1793,562,847,176,570,931,292
31520,21732,10169,11563,3649,4945,1575,3545,5406,2612
31522,14668,6838,7830,1584,3441,1813,1590,3958,2282
31523,9029,4531,4498,1498,2440,593,1367,2601,530
31525,21281,10132,11149,3498,5414,1220,3716,5815,1618
31527,858,372,486,45,85,242,26,139,321
31532,570,269,301,111,124,34,129,109,63
31533,16852,8205,8647,3213,3960,1032,2718,4242,1687
31535,8793,4349,4444,1776,2315,258,1598,2470,376
31537,8833,4720,4113,1609,2541,570,1450,1975,688
31539,12072,5957,6115,1986,3106,865,1873,3120,1122
31542,2266,1195,1071,440,585,170,309,581,181
31543,4089,2074,2015,763,1063,248,651,1103,261
31544,771,364,407,84,212,68,128,160,119
31545,13976,6680,7296,2427,3320,933,2241,3749,1306
31546,7129,4311,2818,803,3001,507,813,1390,615
31548,15082,7687,7395,3178,4137,372,2939,3982,474
31549,2020,949,1071,330,449,170,301,510,260
31550,936,499,437,197,254,48,130,260,47
31551,834,426,408,119,283,24,98,237,73
31552,717,360,357,111,176,73,97,188,72
31553,3902,1920,1982,684,944,292,567,1053,362
31554,5739,3233,2506,791,2124,318,848,1225,433
31555,2650,1458,1192,466,823,169,359,642,191
31557,2733,1372,1361,442,688,242,411,648,302
31558,20547,10806,9741,4528,5545,733,3829,5189,723
31560,2311,1175,1136,384,577,214,309,574,253
31563,1254,584,670,154,305,125,197,323,150
31565,1515,746,769,222,364,160,208,420,141
31566,2583,1368,1215,496,698,174,410,679,126
31567,673,367,306,123,199,45,69,179,58
31568,1076,491,585,180,260,51,220,285,80
31569,5018,2422,2596,888,1246,288,867,1419,310
31601,29780,14175,15605,5764,6859,1552,5589,7769,2247
31602,30379,14743,15636,4810,8374,1559,5418,7829,2389
31605,14592,7171,7421,2530,4076,565,2644,4047,730
31606,3872,1859,2013,624,974,261,653,1122,238
31620,9976,4704,5272,1723,2187,794,1649,2501,1122
31622,1804,902,902,308,470,124,238,499,165
31623,184,82,102,23,55,4,42,55,5
31624,1207,587,620,231,273,83,250,294,76
31625,1191,598,593,221,290,87,163,275,155
31626,3086,1456,1630,517,696,243,476,789,365
31627,303,147,156,47,69,31,48,71,37
31629,1081,535,546,155,282,98,157,255,134
31630,550,250,300,87,143,20,97,169,34
31631,703,360,343,169,162,29,105,180,58
31632,7338,3659,3679,1331,1888,440,1143,1930,606
31634,5495,2701,2794,849,1437,415,910,1331,553
31635,4788,2459,2329,830,1293,336,743,1087,499
31636,7829,3909,3920,1326,2035,548,1187,2001,732
31637,2824,1378,1446,484,674,220,389,712,345
31638,930,453,477,150,213,90,132,221,124
31639,9440,4501,4939,1348,2376,777,1515,2329,1095
31641,1188,586,602,198,335,53,185,338,79
31642,4359,2165,2194,787,1161,217,851,1029,314
31643,9380,4406,4974,1697,2008,701,1608,2230,1136
31645,3253,1622,1631,639,835,148,583,857,191
31646,1447,739,708,256,401,82,171,395,142
31647,2935,1390,1545,531,693,166,580,730,235
31648,981,480,501,198,242,40,163,286,52
31649,901,434,467,186,213,35,160,248,59
31650,3043,1453,1590,502,753,198,573,776,241
31699,3131,2628,503,455,2164,9,133,370,0
31701,22151,9933,12218,3699,4883,1351,3959,5526,2733
31705,38996,18565,20431,8056,8618,1891,7839,9914,2678
31707,42073,19975,22098,6325,10787,2863,6048,11867,4183
31709,26717,12504,14213,4822,6208,1474,4725,6909,2579
31711,1017,541,476,169,272,100,120,280,76
31712,945,486,459,135,268,83,114,231,114
31713,2357,1116,1241,394,505,217,410,573,258
31714,6863,3261,3602,1321,1500,440,1243,1733,626
31715,2314,1165,1149,493,494,178,342,578,229
31716,3183,1630,1553,545,856,229,478,819,256
31717,21800,10154,11646,3619,5000,1535,3700,5669,2277
31720,531,259,272,106,121,32,88,139,45
31722,328,148,180,36,82,30,54,78,48
31723,10267,4744,5523,1800,2076,868,1657,2539,1327
31724,462,223,239,75,122,26,59,117,63
31725,1439,741,698,253,380,108,210,351,137
31726,749,352,397,141,166,45,145,158,94
31728,18128,8424,9704,3058,4138,1228,3126,4693,1885
31729,67,28,39,8,16,4,8,17,14
31730,10201,4687,5514,1663,2319,705,1870,2664,980
31732,97,45,52,12,15,18,25,17,10
31733,1529,757,772,232,416,109,225,376,171
31734,2319,1141,1178,381,589,171,410,525,243
31735,919,441,478,125,226,90,109,256,113
31736,430,207,223,34,117,56,58,109,56
31737,6268,2922,3346,975,1423,524,964,1584,798
31738,1997,942,1055,330,489,123,300,538,217
31740,5710,2552,3158,974,1169,409,1007,1409,742
31741,768,407,361,104,202,101,83,190,88
31742,9939,4672,5267,1834,2077,761,1672,2509,1086
31743,660,320,340,140,161,19,98,169,73
31744,3031,1500,1531,491,772,237,415,810,306
31745,8408,4090,4318,1318,1960,812,1264,2045,1009
31746,1951,820,1131,346,377,97,335,491,305
31747,190,104,86,40,49,15,21,57,8
31749,2153,1061,1092,416,554,91,389,560,143
31750,18572,8842,9730,3081,4477,1284,3016,4662,2052
31751,2508,1082,1426,398,417,267,478,592,356
31752,173,70,103,27,38,5,59,44,0
31754,2561,1235,1326,366,574,295,327,651,348
31756,1048,521,527,215,217,89,145,265,117
31757,10087,4963,5124,1681,2660,622,1630,2713,781
31759,1357,590,767,200,300,90,250,358,159
31761,877,376,501,89,256,31,135,293,73
31762,838,372,466,101,215,56,136,244,86
31763,19191,9631,9560,3501,5397,733,3399,5201,960
31764,1653,777,876,282,422,73,334,407,135
31765,2374,1119,1255,384,589,146,397,615,243
31766,2043,1636,407,165,1367,104,114,181,112
31767,515,282,233,110,130,42,37,128,68
31768,32159,15725,16434,5550,7908,2267,5203,7888,3343
31770,2884,1370,1514,525,660,185,491,738,285
31771,4708,2423,2285,826,1264,333,796,1167,322
31772,501,257,244,85,115,57,56,123,65
31773,3460,1758,1702,498,982,278,482,985,235
31774,6880,3451,3429,1462,1505,484,1098,1589,742
31775,2968,1638,1330,561,905,172,436,667,227
31777,549,263,286,67,139,57,65,141,80
31778,2468,1157,1311,387,565,205,419,606,286
31779,9328,5117,4211,1634,2958,525,1357,2018,836
31780,2441,1175,1266,409,571,195,372,609,285
31781,1420,740,680,268,349,123,225,337,118
31783,1146,580,566,174,317,89,176,310,80
31784,755,393,362,118,207,68,111,168,83
31786,1584,717,867,277,337,103,300,390,177
31787,1899,877,1022,297,457,123,411,458,153
31789,1488,705,783,226,386,93,249,378,156
31790,2119,1055,1064,349,543,163,341,495,228
31791,13019,5999,7020,2265,2928,806,2289,3417,1314
31792,22620,10266,12354,3459,5143,1664,3542,5830,2982
31794,34045,16624,17421,6391,8174,2059,5745,8614,3062
31795,1899,955,944,294,523,138,254,486,204
31796,1175,534,641,133,296,105,223,290,128
31797,3560,1707,1853,556,803,348,540,882,431
31798,902,448,454,157,195,96,142,221,91
31801,2426,1163,1263,418,541,204,406,661,196
31803,4687,2250,2437,793,1137,320,692,1229,516
31804,4387,2087,2300,558,1237,292,744,1232,324
31805,3029,1478,1551,520,746,212,515,837,199
31806,3707,1763,1944,633,925,205,618,981,345
31807,1444,671,773,180,366,125,190,439,144
31808,4846,2412,2434,780,1365,267,690,1440,304
31810,226,123,103,17,69,37,26,50,27
31811,3783,1972,1811,594,1147,231,470,952,389
31812,469,231,238,74,88,69,55,115,68
31814,379,174,205,76,89,9,61,97,47
31815,2238,1088,1150,367,507,214,338,544,268
31816,5738,2653,3085,923,1264,466,973,1445,667
31820,5200,2558,2642,941,1378,239,831,1525,286
31821,347,177,170,37,98,42,35,74,61
31822,4820,2339,2481,753,1231,355,637,1256,588
31823,849,380,469,100,170,110,148,218,103
31824,1661,829,832,271,421,137,214,427,191
31825,2551,1245,1306,442,571,232,354,591,361
31826,2081,971,1110,313,547,111,382,563,165
31827,2348,1082,1266,327,597,158,394,627,245
31829,777,358,419,117,200,41,128,225,66
31830,2416,1230,1186,525,532,173,347,587,252
31831,2534,1249,1285,330,705,214,293,696,296
31832,162,84,78,25,47,12,28,36,14
31833,6641,3135,3506,1102,1489,544,1032,1746,728
31836,1132,512,620,163,272,77,197,308,115
31901,8204,4073,4131,1223,2380,470,1149,1962,1020
31903,22583,10254,12329,4295,4789,1170,4506,5750,2073
31904,30250,13996,16254,4513,7104,2379,4601,7976,3677
31905,23427,16023,7404,8631,7382,10,3795,3587,22
31906,23842,10756,13086,3512,5518,1726,3780,6356,2950
31907,56400,27025,29375,9509,14314,3202,9080,15496,4799
31909,27827,13482,14345,4438,7497,1547,4123,7868,2354
32008,4651,2482,2169,852,1158,472,619,1016,534
32009,2668,1360,1308,481,740,139,438,754,116
32011,11426,5525,5901,1841,2872,812,1956,2966,979
32013,34,25,9,4,13,8,0,9,0
32024,14981,7308,7673,2413,3583,1312,2352,3777,1544
32025,16192,7899,8293,2373,3620,1906,2328,3977,1988
32033,2133,985,1148,236,495,254,256,573,319
32034,24804,12075,12729,3206,6317,2552,2975,6829,2925
32038,6463,3217,3246,981,1667,569,923,1740,583
32040,6091,3035,3056,1090,1597,348,1028,1655,373
32043,19557,9652,9905,2985,5109,1558,2885,5117,1903
32044,1427,673,754,211,347,115,278,328,148
32046,8061,3927,4134,1364,2033,530,1356,2097,681
32052,8363,5278,3085,1364,3397,517,923,1503,659
32053,3280,1690,1590,573,906,211,456,856,278
32054,10002,6046,3956,1461,3966,619,1398,1935,623
32055,17085,9160,7925,2891,5034,1235,2431,3969,1525
32058,6004,4148,1856,759,3039,350,597,917,342
32059,1402,688,714,234,316,138,231,341,142
32060,24017,11511,12506,3416,5779,2316,3559,5832,3115
32061,137,62,75,16,23,23,13,44,18
32062,2114,1028,1086,388,417,223,339,501,246
32063,11024,5528,5496,1936,2847,745,1699,2950,847
32065,20265,10012,10253,3538,5486,988,3356,5737,1160
32066,5576,3409,2167,812,2221,376,699,991,477
32068,36848,18485,18363,6745,9994,1746,6170,10258,1935
32071,3253,1594,1659,394,857,343,407,931,321
32072,393,204,189,52,114,38,62,86,41
32073,50084,24219,25865,8039,13021,3159,7899,13959,4007
32079,300,111,189,1,5,105,3,4,182
32082,27821,13547,14274,3768,7043,2736,3268,7907,3099
32083,3031,2443,588,277,2015,151,226,297,65
32084,20584,9710,10874,2199,4820,2691,2331,5243,3300
32086,22948,11050,11898,3100,5345,2605,2757,5809,3332
32087,3257,1582,1675,647,778,157,673,789,213
32091,16008,8550,7458,2570,4844,1136,2166,3737,1555
32092,6595,3317,3278,1120,1699,498,939,1725,614
32094,2539,1252,1287,288,717,247,339,646,302
32095,21071,10517,10554,3065,5821,1631,2996,5651,1907
32096,2774,1341,1433,431,673,237,484,694,255
32097,10540,5355,5185,1741,3017,597,1577,2846,762
32102,2597,1313,1284,292,643,378,276,596,412
32110,5594,2767,2827,917,1365,485,887,1449,491
32112,6985,3464,3521,1041,1281,1142,981,1382,1158
32113,6410,3105,3305,841,1545,719,956,1656,693
32114,33861,17160,16701,6739,7939,2482,5172,7695,3834
32117,24844,11738,13106,3323,6224,2191,3479,6309,3318
32118,18519,9319,9200,1408,4896,3015,1319,4215,3666
32119,39857,19060,20797,4548,8842,5670,4147,9628,7022
32124,12784,7599,5185,1552,4540,1507,1201,2636,1348
32127,30277,14503,15774,3439,6907,4157,3209,7331,5234
32130,4604,2247,2357,748,1093,406,675,1229,453
32131,4944,2654,2290,659,1463,532,562,1196,532
32132,7095,3316,3779,871,1579,866,922,1670,1187
32134,8082,3965,4117,958,1684,1323,977,1888,1252
32136,6628,3198,3430,422,1529,1247,427,1571,1432
32137,22060,10601,11459,2256,4017,4328,1866,4784,4809
32138,164,86,78,25,45,16,22,32,24
32139,487,247,240,41,119,87,26,118,96
32140,1581,787,794,164,472,151,246,439,109
32141,15589,7639,7950,1884,3341,2414,1736,3503,2711
32145,3940,1909,2031,649,1032,228,721,1052,258
32147,858,478,380,200,225,53,75,242,63
32148,11056,5471,5585,1795,2434,1242,1653,2635,1297
32157,1052,517,535,101,231,185,140,212,183
32159,27782,13095,14687,1253,2791,9051,1174,4038,9475
32164,14538,7030,7508,1754,2875,2401,1642,3289,2577
32168,20068,9514,10554,2165,4419,2930,2309,4625,3620
32169,10669,5073,5596,719,2223,2131,689,2327,2580
32174,40738,19366,21372,4727,9207,5432,4516,9815,7041
32176,15758,7310,8448,1192,3258,2860,1328,3401,3719
32177,25193,12012,13181,4126,5867,2019,3988,6369,2824
32179,8241,4168,4073,1269,1883,1016,952,1962,1159
32180,4917,2842,2075,888,1628,326,675,1152,248
32181,1689,825,864,245,359,221,269,421,174
32182,173,108,65,51,48,9,6,40,19
32183,170,85,85,15,49,21,28,23,34
32185,96,50,46,21,19,10,9,22,15
32187,1966,936,1030,265,472,199,340,487,203
32189,5925,2959,2966,660,1261,1038,582,1336,1048
32190,1180,584,596,162,271,151,161,312,123
32193,871,417,454,84,159,174,86,178,190
32195,3218,1615,1603,420,860,335,453,785,365
32202,5085,3457,1628,592,2309,556,234,597,797
32204,7733,3596,4137,1165,1942,489,1074,1887,1176
32205,30128,14403,15725,4318,8186,1899,4203,8465,3057
32206,21217,10066,11151,3694,5107,1265,3877,5291,1983
32207,33773,16060,17713,4744,9000,2316,4541,9312,3860
32208,33744,15559,18185,5873,7542,2144,5534,9207,3444
32209,39739,17726,22013,7000,7634,3092,7203,9512,5298
32210,58345,27859,30486,9555,14488,3816,9819,15610,5057
32211,34597,16723,17874,5701,8969,2053,5916,9174,2784
32212,2480,1581,899,838,738,5,532,367,0
32215,865,403,462,219,174,10,288,165,9
32216,29375,14197,15178,4728,7368,2101,4115,8281,2782
32217,20218,9424,10794,2832,5058,1534,2806,5600,2388
32218,37894,18355,19539,6759,9530,2066,6103,10751,2685
32219,9573,4673,4900,1623,2431,619,1489,2509,902
32220,10583,5334,5249,1863,2888,583,1754,2787,708
32221,17657,8590,9067,2783,4766,1041,2987,4703,1377
32222,4204,2113,2091,792,1041,280,661,1161,269
32223,25424,12392,13032,3836,7235,1321,3704,7641,1687
32224,32588,15882,16706,5144,9385,1353,5429,9622,1655
32225,45745,22322,23423,7629,12554,2139,7344,13616,2463
32226,8032,3915,4117,1016,2324,575,1179,2252,686
32227,5267,3678,1589,1895,1783,0,862,727,0
32233,25384,12709,12675,4132,7188,1389,4101,6810,1764
32234,6185,2960,3225,987,1639,334,1125,1718,382
32244,46852,22695,24157,7988,12685,2022,8033,13456,2668
32246,36012,17767,18245,6133,10204,1430,5824,10561,1860
32250,23944,12262,11682,2954,7594,1714,2442,6957,2283
32254,14801,7092,7709,2836,3485,771,2603,3993,1113
32256,29254,14443,14811,3435,9574,1434,3534,9314,1963
32257,36360,17524,18836,5577,10105,1842,5316,10955,2565
32258,12480,6136,6344,2032,3662,442,1967,3740,637
32259,18087,9064,9023,3321,4943,800,2959,5117,947
32266,7233,3681,3552,916,2277,488,773,2142,637
32277,27640,13187,14453,4568,6968,1651,4404,8022,2027
32301,27316,12540,14776,4327,7144,1069,5312,7756,1708
32303,44634,21066,23568,6913,12241,1912,7331,13197,3040
32304,38549,19035,19514,8999,9222,814,11315,7075,1124
32308,44753,20805,23948,6206,11602,2997,6148,13610,4190
32310,30183,14190,15993,5017,7628,1545,5500,8548,1945
32311,25929,12235,13694,3797,7177,1261,3753,8367,1574
32312,28478,13893,14585,4683,7483,1727,4555,8138,1892
32320,3874,1982,1892,563,1061,358,504,918,470
32321,5410,3385,2025,667,2353,365,636,973,416
32322,3626,2410,1216,290,1788,332,286,628,302
32323,377,164,213,18,59,87,53,49,111
32324,5192,2653,2539,583,1554,516,666,1252,621
32327,18819,9840,8979,3119,5599,1122,2757,4907,1315
32328,2913,1548,1365,415,756,377,344,701,320
32330,954,458,496,213,203,42,176,246,74
32331,4097,2030,2067,756,931,343,596,1009,462
32332,2137,1016,1121,460,485,71,440,561,120
32333,11779,5689,6090,1770,3036,883,1634,3425,1031
32334,1526,733,793,232,407,94,259,399,135
32335,17,5,12,0,0,5,0,5,7
32336,1132,541,591,160,249,132,162,311,118
32337,18,12,6,0,6,6,0,0,6
32340,12610,6711,5899,2033,3620,1058,1589,2812,1498
32343,1330,611,719,269,270,72,288,357,74
32344,10403,5394,5009,1523,3030,841,1325,2627,1057
32346,2155,1125,1030,274,505,346,249,553,228
32347,17402,8861,8541,2715,4845,1301,2593,4271,1677
32350,1140,547,593,206,253,88,208,299,86
32351,23695,10966,12729,3903,5604,1459,3947,6489,2293
32355,277,134,143,31,73,30,43,72,28
32356,75,26,49,0,14,12,14,18,17
32357,137,75,62,23,44,8,7,42,13
32358,1857,895,962,253,429,213,297,460,205
32359,1375,675,700,130,274,271,132,336,232
32360,27,16,11,0,8,8,0,6,5
32361,525,302,223,135,155,12,44,126,53
32399,0,0,0,0,0,0,0,0,0
32401,24578,11429,13149,3480,5962,1987,3681,6241,3227
32403,2762,1541,1221,802,739,0,630,591,0
32404,34504,17470,17034,5640,9295,2535,5193,9322,2519
32405,26364,12771,13593,3951,6731,2089,3713,6829,3051
32407,5998,3157,2841,804,1655,698,587,1555,699
32408,12735,6519,6216,1588,3826,1105,1437,3539,1240
32409,7236,3574,3662,998,2009,567,1102,2003,557
32410,126,69,57,5,32,32,5,25,27
32413,9382,4669,4713,1155,2478,1036,955,2527,1231
32420,1803,865,938,236,433,196,271,450,217
32421,3789,1882,1907,650,967,265,665,966,276
32422,66,15,51,0,9,6,0,10,41
32423,1175,563,612,164,289,110,124,311,177
32424,7480,4272,3208,977,2750,545,922,1415,871
32425,11866,6468,5398,1713,3674,1081,1486,2547,1365
32426,1127,572,555,214,281,77,133,316,106
32427,2764,1360,1404,395,707,258,370,699,335
32428,14735,7625,7110,1912,4285,1428,1963,3602,1545
32430,935,434,501,122,224,88,102,266,133
32431,4344,2038,2306,704,985,349,666,1168,472
32432,127,47,80,14,26,7,47,33,0
32433,19287,10001,9286,2762,5451,1788,2698,4489,2099
32437,683,355,328,165,147,43,92,192,44
32438,3452,1722,1730,530,885,307,500,978,252
32439,6233,3093,3140,912,1560,621,895,1655,590
32440,5552,2696,2856,888,1333,475,814,1323,719
32442,3126,1479,1647,414,774,291,437,839,371
32443,4770,2783,1987,578,1882,323,438,1174,375
32444,15599,7503,8096,2367,3891,1245,2328,4301,1467
32445,2755,2111,644,260,1706,145,204,301,139
32446,9396,4388,5008,1262,2197,929,1344,2292,1372
32447,236,227,9,208,0,19,0,9,0
32448,8600,3962,4638,1278,2050,634,1483,2172,983
32449,575,276,299,55,144,77,64,160,75
32455,3787,1863,1924,563,953,347,581,991,352
32456,7742,3797,3945,1038,1800,959,847,1896,1202
32459,6078,2946,3132,711,1665,570,706,1748,678
32460,5293,3375,1918,684,2269,422,550,955,413
32462,2944,1391,1553,416,699,276,459,689,405
32463,113,51,62,11,28,12,23,24,15
32464,3802,1884,1918,508,997,379,518,981,419
32465,6481,3871,2610,851,2441,579,739,1327,544
32466,5468,2686,2782,857,1523,306,912,1516,354
32501,16372,8346,8026,2307,4665,1374,2147,3694,2185
32503,33023,15062,17961,5119,7087,2856,5922,8035,4004
32504,23220,11022,12198,3226,5946,1850,3184,6481,2533
32505,29267,13630,15637,5425,6165,2040,4995,7626,3016
32506,32782,15595,17187,5092,8104,2399,5383,8655,3149
32507,29423,14987,14436,4877,7642,2468,4220,7370,2846
32508,10389,8634,1755,3523,5105,6,789,951,15
32514,34688,16322,18366,4739,8909,2674,4626,9549,4191
32526,31641,15457,16184,4930,8126,2401,4504,8716,2964
32531,4265,2109,2156,668,1081,360,648,1144,364
32533,24076,11842,12234,4119,6083,1640,3854,6544,1836
32534,12308,5903,6405,2035,2925,943,1755,3370,1280
32535,6520,3759,2761,832,2493,434,913,1256,592
32536,13370,6462,6908,2329,3154,979,2277,3594,1037
32539,19805,10361,9444,3086,5989,1286,2892,5007,1545
32541,15482,7813,7669,1692,4069,2052,1496,4151,2022
32542,9593,5294,4299,2073,3188,33,2103,2165,31
32544,3047,1715,1332,892,823,0,657,663,12
32547,28516,14203,14313,3957,8183,2063,3876,7758,2679
32548,22233,11088,11145,2987,6171,1930,3002,5486,2657
32561,25971,12662,13309,3644,6727,2291,3355,7182,2772
32564,2479,1211,1268,337,676,198,397,622,249
32565,5188,2618,2570,727,1444,447,688,1244,638
32566,21059,10688,10371,3420,5728,1540,3247,5767,1357
32567,3693,1816,1877,522,926,368,480,924,473
32568,3312,1677,1635,528,844,305,519,793,323
32569,11332,5774,5558,1735,3424,615,1695,3142,721
32570,24817,12018,12799,4044,6132,1842,3915,6444,2440
32571,24054,11994,12060,4320,6267,1407,3859,6721,1480
32577,4651,2408,2243,845,1174,389,655,1215,373
32578,27894,13756,14138,4222,7072,2462,4014,7389,2735
32579,10041,4852,5189,1351,2607,894,1345,2519,1325
32580,4890,2649,2241,960,1286,403,771,982,488
32583,18788,10231,8557,2849,6046,1336,2363,4902,1292
32601,16795,8169,8626,2803,4854,512,3677,4079,870
32603,11565,5704,5861,3529,2078,97,4254,1475,132
32605,22624,10676,11948,3150,5833,1693,3276,6222,2450
32606,17803,8212,9591,2396,4554,1262,2561,5004,2026
32607,26113,13100,13013,4511,7642,947,4467,7289,1257
32608,37972,18331,19641,7237,9839,1255,8299,9552,1790
32609,18250,9764,8486,3019,5865,880,2547,4696,1243
32615,11272,5450,5822,1785,2913,752,1742,3151,929
32616,971,410,561,129,222,59,158,259,144
32617,3604,1868,1736,630,931,307,461,962,313
32618,6694,3241,3453,1018,1640,583,1000,1863,590
32619,3956,1968,1988,615,990,363,579,1014,395
32621,3627,1645,1982,640,725,280,541,1086,355
32622,1745,839,906,327,410,102,285,458,163
32625,1604,782,822,180,380,222,207,423,192
32626,7656,3653,4003,1131,1627,895,1057,1814,1132
32628,5093,2968,2125,742,1897,329,687,1073,365
32639,304,114,190,14,57,43,21,101,68
32640,10639,5255,5384,1648,2545,1062,1525,2719,1140
32641,13802,6431,7371,2944,2706,781,2721,3485,1165
32643,8866,4243,4623,1431,2238,574,1290,2412,921
32648,369,190,179,70,74,46,41,78,60
32653,12865,6098,6767,1958,3194,946,1778,3741,1248
32654,167,94,73,11,55,28,6,31,36
32656,11658,5652,6006,1816,2668,1168,1719,2929,1358
32658,135,77,58,10,42,25,13,30,15
32662,58,25,33,0,0,25,4,12,17
32664,622,246,376,56,124,66,73,212,91
32666,4479,2215,2264,393,1126,696,485,1106,673
32667,3093,1474,1619,385,719,370,282,927,410
32668,3735,1841,1894,510,906,425,462,972,460
32669,7503,3702,3801,1283,1915,504,1175,2061,565
32680,7495,3753,3742,1012,1678,1063,959,1717,1066
32681,481,244,237,70,114,60,100,89,48
32683,137,64,73,8,38,18,6,28,39
32686,5247,2542,2705,829,1335,378,889,1354,462
32692,454,230,224,12,73,145,11,91,122
32693,9753,5288,4465,2175,2144,969,1294,2045,1126
32694,1965,991,974,305,478,208,272,493,209
32696,10510,5161,5349,1625,2576,960,1364,2807,1178
32697,457,233,224,86,122,25,84,110,30
32701,22728,11020,11708,3061,6344,1615,2685,6332,2691
32702,2485,1370,1115,424,651,295,230,554,331
32703,43067,21313,21754,7410,11442,2461,6946,11656,3152
32706,173,100,73,47,53,0,33,35,5
32707,32953,16129,16824,4816,9003,2310,4371,9345,3108
32708,38725,18882,19843,6288,10164,2430,5661,11269,2913
32709,2249,1190,1059,375,632,183,299,587,173
32712,29368,14485,14883,4941,7536,2008,4465,8022,2396
32713,16563,8018,8545,2223,3694,2101,1706,4032,2807
32714,34690,16983,17707,4781,10327,1875,4580,10760,2367
32720,27407,12995,14412,3995,6270,2730,4207,6398,3807
32724,25245,11910,13335,3440,5460,3010,3131,6047,4157
32725,38259,18334,19925,5544,8867,3923,5553,9554,4818
32726,17936,8447,9489,2634,3643,2170,2219,4089,3181
32730,5857,2788,3069,687,1543,558,708,1478,883
32732,5093,2642,2451,819,1454,369,750,1371,330
32735,2648,1341,1307,365,460,516,205,548,554
32736,8407,4288,4119,1336,2257,695,1276,2225,618
32738,34415,16689,17726,5974,8424,2291,5908,9235,2583
32744,2814,1309,1505,326,681,302,275,788,442
32746,29271,14132,15139,4443,8154,1535,4444,8916,1779
32750,24063,11573,12490,3557,6390,1626,3481,6683,2326
32751,18434,8653,9781,2691,4373,1589,2586,5083,2112
32754,9166,4614,4552,1418,2184,1012,1296,2248,1008
32757,18619,8850,9769,2351,4049,2450,2304,4341,3124
32759,2468,1274,1194,347,572,355,282,594,318
32763,15125,7063,8062,1843,3203,2017,1698,3424,2940
32764,2221,1125,1096,295,486,344,222,497,377
32765,44081,21631,22450,7847,11794,1990,7546,12344,2560
32766,7192,3581,3611,1309,1939,333,1169,2051,391
32767,1775,849,926,229,405,215,264,453,209
32771,30459,14904,15555,4994,7746,2164,4659,8020,2876
32773,23665,12124,11541,3903,7007,1214,3696,6264,1581
32775,544,241,303,74,138,29,88,184,31
32776,6722,3336,3386,1034,1824,478,974,1821,591
32778,14191,6738,7453,1226,2689,2823,1317,2556,3580
32779,29607,14490,15117,4551,7843,2096,4350,8470,2297
32780,30996,14860,16136,3979,6823,4058,3766,7477,4893
32784,9177,4473,4704,1344,2179,950,1208,2302,1194
32789,23791,11235,12556,3074,6111,2050,3144,6456,2956
32792,51105,24902,26203,7320,14118,3464,6732,14280,5191
32796,20471,9826,10645,2791,4741,2294,3031,4939,2675
32798,1633,753,880,24,161,568,37,118,725
32801,8252,3973,4279,490,2677,806,480,1874,1925
32803,21454,10716,10738,1835,7027,1854,1800,5994,2944
32804,18001,8784,9217,1873,5557,1354,1959,5387,1871
32805,24204,11752,12452,4364,5771,1617,4272,6087,2093
32806,26723,13263,13460,3541,7576,2146,3217,7170,3073
32807,28620,14065,14555,4519,7636,1910,4070,7690,2795
32808,48864,23045,25819,9554,11293,2198,9240,13402,3177
32809,22311,11105,11206,3479,6215,1411,3377,5948,1881
32810,32998,16195,16803,5487,9261,1447,5675,8952,2176
32811,33598,16169,17429,5643,9365,1161,5763,9949,1717
32812,36237,17764,18473,5580,9942,2242,5096,10466,2911
32817,28264,14208,14056,4870,8151,1187,4953,7802,1301
32818,35186,16977,18209,6228,9075,1674,6132,9777,2300
32819,24169,11872,12297,3990,6524,1358,3751,7254,1292
32820,2973,1553,1420,559,789,205,496,703,221
32821,14117,7051,7066,1406,4362,1283,1419,4011,1636
32822,52279,25454,26825,7740,14631,3083,7472,15168,4185
32824,19314,9397,9917,3499,5003,895,3382,5495,1040
32825,43397,22496,20901,7231,13448,1817,6702,11759,2440
32826,24272,12251,12021,5211,6062,978,5381,5243,1397
32827,2187,1086,1101,410,592,84,335,668,98
32828,22425,11030,11395,3928,6389,713,3776,6792,827
32829,3581,1762,1819,558,1097,107,597,1057,165
32831,64,49,15,31,18,0,0,15,0
32832,1977,1005,972,311,559,135,266,584,122
32833,5089,2665,2424,869,1487,309,655,1425,344
32835,31397,15910,15487,4699,10190,1021,4211,10017,1259
32836,11981,5956,6025,1969,3404,583,2002,3367,656
32837,34668,16940,17728,5730,9777,1433,5661,10168,1899
32839,40549,21674,18875,6699,13378,1597,6327,10485,2063
32901,22568,10891,11677,3279,4695,2917,2616,4708,4353
32903,12708,6339,6369,1409,3267,1663,1314,3067,1988
32904,18048,8633,9415,1961,4031,2641,1737,4230,3448
32905,21919,10405,11514,2760,5183,2462,2781,5407,3326
32907,33732,16423,17309,5692,7898,2833,5116,8824,3369
32908,5782,2822,2960,1109,1384,329,1072,1560,328
32909,18299,8979,9320,3233,4659,1087,3055,4968,1297
32920,9167,4777,4390,736,2665,1376,650,2264,1476
32922,15799,7572,8227,2685,3711,1176,2478,4001,1748
32925,2018,1118,900,484,631,3,388,512,0
32926,19363,9623,9740,2803,4920,1900,2663,5129,1948
32927,27027,14428,12599,5210,7535,1683,3952,6912,1735
32931,14666,7374,7292,1121,3548,2705,1044,3188,3060
32934,14002,6631,7371,1819,3317,1495,2131,3591,1649
32935,40730,19834,20896,5338,10695,3801,5170,10899,4827
32937,27015,13067,13948,3502,6208,3357,3260,6650,4038
32940,18612,8819,9793,1900,3903,3016,2017,4335,3441
32948,5016,2814,2202,1072,1472,270,876,1059,267
32949,656,273,383,58,93,122,80,216,87
32950,4417,2260,2157,599,1222,439,512,1169,476
32951,10588,5315,5273,949,2426,1940,848,2414,2011
32952,20682,10282,10400,2782,5007,2493,2502,5072,2826
32953,21710,10532,11178,2936,5320,2276,2752,5462,2964
32955,26287,12652,13635,3676,6254,2722,3280,7068,3287
32958,20503,9853,10650,2299,4064,3490,2102,4574,3974
32960,20049,9384,10665,2276,4656,2452,2204,4644,3817
32962,20395,9651,10744,2597,4246,2808,2435,4549,3760
32963,14096,6725,7371,877,2077,3771,807,2701,3863
32966,12920,6118,6802,910,2106,3102,770,2161,3871
32967,11452,5629,5823,1867,2542,1220,1824,2795,1204
32968,8432,4381,4051,1622,2036,723,1154,2174,723
32970,84,39,45,17,15,7,0,23,22
32976,9808,4673,5135,431,1257,2985,354,1316,3465
33001,550,290,260,34,126,130,31,109,120
33004,15104,7581,7523,1772,4380,1429,1640,4017,1866
33009,34293,16087,18206,3018,7380,5689,2605,7845,7756
33010,45804,22941,22863,6542,11463,4936,5416,11101,6346
33012,74476,35064,39412,9314,17270,8480,9224,18542,11646
33013,33578,16284,17294,3922,8240,4122,3960,8514,4820
33014,38542,18274,20268,5603,9857,2814,5797,10796,3675
33015,49534,23350,26184,8028,13316,2006,8298,14983,2903
33016,42995,20187,22808,6980,10842,2365,7101,12220,3487
33018,37775,18413,19362,6588,9908,1917,6278,10716,2368
33019,17661,8529,9132,965,4478,3086,881,4197,4054
33020,40706,20099,20607,5335,11737,3027,5297,11456,3854
33021,46310,21815,24495,5312,11349,5154,5083,12039,7373
33023,60806,29201,31605,11314,14678,3209,10478,16660,4467
33024,58453,27882,30571,9646,14791,3445,8989,16585,4997
33025,46480,21541,24939,7578,11771,2192,7374,14249,3316
33026,29614,13567,16047,4464,7049,2054,4445,8481,3121
33027,25864,11369,14495,2679,4665,4025,2413,5372,6710
33028,21575,10425,11150,3983,5916,526,3858,6619,673
33029,35294,17198,18096,6684,9477,1037,6286,10420,1390
33030,27424,14454,12970,5863,7429,1162,5164,6473,1333
33031,5388,2770,2618,703,1665,402,720,1487,411
33032,21137,10497,10640,4892,4934,671,4410,5219,1011
33033,30874,15164,15710,6313,7271,1580,6258,7747,1705
33034,15345,7632,7713,2876,4090,666,2752,3881,1080
33035,2782,1229,1553,293,722,214,420,883,250
33036,3519,2028,1491,280,1248,500,253,919,319
33037,12991,6751,6240,1505,3658,1588,1314,3423,1503
33040,34238,18693,15545,3753,12230,2710,3381,9398,2766
33042,6080,3257,2823,657,1910,690,491,1791,541
33043,5168,2608,2560,366,1638,604,593,1470,497
33050,11479,6030,5449,1142,3516,1372,1088,3074,1287
33054,28231,12984,15247,5787,5570,1627,5860,6982,2405
33055,45106,21831,23275,8205,10825,2801,7536,12338,3401
33056,33225,15367,17858,6710,7182,1475,6735,9220,1903
33060,32998,16517,16481,4967,9247,2303,4645,8464,3372
33062,25883,12269,13614,1224,6032,5013,1336,5767,6511
33063,50857,23961,26896,6081,12533,5347,5286,13442,8168
33064,52776,26355,26421,7600,14462,4293,6906,13697,5818
33065,51767,24831,26936,9352,13361,2118,8758,14372,3806
33066,16797,7081,9716,1018,2313,3750,922,2789,6005
33067,23208,11119,12089,4060,6413,646,4280,6979,830
33068,47509,23268,24241,8545,12604,2119,8157,13050,3034
33069,24777,12182,12595,2670,6111,3401,2286,5704,4605
33070,5522,2628,2894,565,1467,596,632,1615,647
33071,36851,18086,18765,6453,10186,1447,6244,11156,1365
33073,20018,10076,9942,2893,6165,1018,2504,6266,1172
33076,19576,9667,9909,3814,5426,427,3594,5808,507
33109,339,188,151,10,99,79,10,103,38
33122,0,0,0,0,0,0,0,0,0
33125,48640,23768,24872,6400,12329,5039,6456,11347,7069
33126,43978,20697,23281,5827,10968,3902,5512,11864,5905
33127,27698,13892,13806,5264,6723,1905,5119,6399,2288
33128,7178,3963,3215,1028,2137,798,908,1480,827
33129,11109,5213,5896,960,3152,1101,948,3436,1512
33130,20535,10241,10294,2581,5538,2122,2667,4851,2776
33131,4786,2422,2364,277,1784,361,268,1751,345
33132,5192,3582,1610,226,2971,385,170,1032,408
33133,29763,14412,15351,3091,8653,2668,3310,8477,3564
33134,34013,15590,18423,3306,8717,3567,3412,9606,5405
33135,35659,17328,18331,4504,8958,3866,4112,8518,5701
33136,12986,6000,6986,2092,3108,800,2344,3674,968
33137,17447,9112,8335,2658,5256,1198,2264,4389,1682
33138,29572,15110,14462,4362,8589,2159,4267,7729,2466
33139,38542,20976,17566,2012,15120,3844,2176,9801,5589
33140,20198,9771,10427,2106,5448,2217,1836,5378,3213
33141,36725,17932,18793,4453,10851,2628,4005,10692,4096
33142,53499,27459,26040,9376,14248,3835,8888,12132,5020
33143,29554,13896,15658,3779,7919,2198,3889,8579,3190
33144,25416,11973,13443,2786,5863,3324,2677,6079,4687
33145,29104,13934,15170,3403,6967,3564,2821,7282,5067
33146,13242,6264,6978,2613,2719,932,2860,2968,1150
33147,50807,24061,26746,10249,10764,3048,9818,12758,4170
33149,10513,4910,5603,1401,2432,1077,1497,2966,1140
33150,26238,12695,13543,5053,6090,1552,4768,6656,2119
33154,13527,6110,7417,1193,3159,1758,1105,3545,2767
33155,43937,20551,23386,5353,10454,4744,4980,11834,6572
33156,31837,15331,16506,5146,7881,2304,5121,8690,2695
33157,61100,29483,31617,10940,15179,3364,10321,16258,5038
33158,6585,3206,3379,1072,1659,475,1117,1764,498
33160,33635,15372,18263,2795,7835,4742,2465,8570,7228
33161,53183,25233,27950,9372,13117,2744,9772,14204,3974
33162,45529,21738,23791,8354,10769,2615,8222,12013,3556
33165,56985,26726,30259,7154,13521,6051,7285,14303,8671
33166,22521,11154,11367,3161,6563,1430,3004,6287,2076
33167,18081,8468,9613,3407,4067,994,3401,4966,1246
33168,25183,12271,12912,5125,5982,1164,4782,6373,1757
33169,36358,16817,19541,6646,8444,1727,6539,10394,2608
33170,8731,4097,4634,1656,1919,522,1716,2249,669
33172,38444,18162,20282,5264,10410,2488,5222,11363,3697
33173,33734,15612,18122,4613,8500,2499,4307,9785,4030
33174,30331,14033,16298,4297,7026,2710,3944,8199,4155
33175,52600,25112,27488,7887,13055,4170,7636,14335,5517
33176,51580,24339,27241,7823,13548,2968,7709,15001,4531
33177,45481,22912,22569,8550,12319,2043,7877,12032,2660
33178,14973,7356,7617,2172,4473,711,2192,4782,643
33179,37064,16699,20365,5218,8366,3115,5019,10627,4719
33180,20745,9644,11101,1891,4624,3129,1644,5335,4122
33181,17811,8552,9259,2350,5105,1097,2603,5123,1533
33182,17259,9876,7383,2883,6344,649,2395,4036,952
33183,35403,16511,18892,5680,8878,1953,5342,10528,3022
33184,19587,9360,10227,3168,4706,1486,2416,5718,2093
33185,9804,4786,5018,1809,2464,513,1517,2842,659
33186,60128,28195,31933,9706,15923,2566,9499,18539,3895
33187,13937,7133,6804,2633,3829,671,2139,3918,747
33189,20307,9787,10520,3719,5021,1047,3540,5524,1456
33190,4882,2296,2586,1037,1162,97,919,1383,284
33193,42521,21118,21403,7165,12210,1743,6876,12085,2442
33194,0,0,0,0,0,0,0,0,0
33196,34630,16688,17942,6231,9210,1247,6108,10179,1655
33301,12019,7260,4759,1152,5089,1019,610,3133,1016
33304,18564,10236,8328,1889,6821,1526,1794,4681,1853
33305,11888,6597,5291,1032,4575,990,920,3264,1107
33306,4029,2068,1961,301,1298,469,259,1035,667
33308,28864,14109,14755,1747,7305,5057,1720,6941,6094
33309,33215,17080,16135,4692,10489,1899,4503,9040,2592
33311,65363,31454,33909,12376,15243,3835,12318,16178,5413
33312,44890,22909,21981,6592,13392,2925,6315,12248,3418
33313,57332,26445,30887,10089,13011,3345,9862,15675,5350
33314,23660,11810,11850,3440,7113,1257,3256,6901,1693
33315,13083,6808,6275,1278,4538,992,1330,3766,1179
33316,10673,5688,4985,709,3553,1426,700,2659,1626
33317,34451,16692,17759,5283,8686,2723,5022,9494,3243
33319,42619,18925,23694,4518,8606,5801,4540,10412,8742
33321,39616,17627,21989,3304,7432,6891,3016,8869,10104
33322,40776,18291,22485,4185,8461,5645,4131,9443,8911
33323,17705,8777,8928,3057,4962,758,2858,5330,740
33324,42790,20344,22446,5186,11678,3480,4643,12968,4835
33325,27529,13454,14075,4816,7481,1157,4634,8008,1433
33326,30148,14357,15791,4965,7827,1565,5197,8600,1994
33327,12981,6439,6542,2609,3378,452,2376,3808,358
33328,20445,10065,10380,3109,5695,1261,2940,5937,1503
33330,11248,5521,5727,2033,2916,572,1908,3229,590
33331,21344,10415,10929,3892,5717,806,3999,6172,758
33332,3759,1631,2128,549,900,182,437,1529,162
33334,30705,15985,14720,4500,9683,1802,3769,8376,2575
33351,32452,15293,17159,5148,8645,1500,5040,9736,2383
33388,0,0,0,0,0,0,0,0,0
33394,0,0,0,0,0,0,0,0,0
33401,20486,9703,10783,2847,4773,2083,2503,4774,3506
33403,12502,5903,6599,1614,3326,963,2030,3297,1272
33404,29985,14137,15848,4821,6057,3259,4869,7030,3949
33405,19847,10254,9593,2771,5845,1638,2409,5039,2145
33406,25621,13577,12044,3895,7980,1702,3047,6780,2217
33407,28973,14367,14606,5078,7697,1592,4862,7550,2194
33408,17024,8343,8681,1407,3873,3063,1247,3859,3575
33409,22017,11155,10862,2907,6696,1552,2786,6224,1852
33410,26847,13009,13838,3525,6890,2594,2867,7601,3370
33411,41623,20117,21506,6626,10075,3416,6105,10935,4466
33412,9127,4659,4468,1666,2527,466,1384,2711,373
33413,9355,4440,4915,1269,2324,847,1347,2610,958
33414,37168,17961,19207,6551,9254,2156,6594,10275,2338
33415,39629,18826,20803,6290,9602,2934,5903,10318,4582
33417,27817,12497,15320,2859,5260,4378,2589,5795,6936
33418,27258,13234,14024,3338,6285,3611,2989,7214,3821
33426,15425,7007,8418,1344,3327,2336,1251,3550,3617
33428,37569,17902,19667,5770,9056,3076,5625,10066,3976
33430,21307,11139,10168,4251,5731,1157,4226,4771,1171
33431,17454,8470,8984,2359,4332,1779,2533,4218,2233
33432,17955,8881,9074,1635,4654,2592,1454,4364,3256
33433,40423,18298,22125,3487,8580,6231,3596,10163,8366
33434,20620,9092,11528,1678,3143,4271,1747,3579,6202
33435,30607,14619,15988,4317,6971,3331,3979,7168,4841
33436,35622,16597,19025,3393,7433,5771,3295,8491,7239
33437,39162,18635,20527,2556,5524,10555,2695,6327,11505
33438,811,382,429,101,210,71,157,205,67
33440,18113,9465,8648,3626,4608,1231,3308,4170,1170
33441,26856,13175,13681,3446,7311,2418,3245,6891,3545
33442,28837,12450,16387,1840,5372,5238,1843,6205,8339
33444,21386,10614,10772,3371,5790,1453,3210,5853,1709
33445,28046,12865,15181,2643,5679,4543,2469,6260,6452
33446,15037,6526,8511,283,1000,5243,250,1244,7017
33455,16376,7981,8395,1485,3271,3225,1397,3354,3644
33458,33172,16634,16538,5014,9320,2300,4438,9218,2882
33460,32067,16742,15325,5077,9623,2042,4648,7972,2705
33461,35421,17610,17811,5346,9399,2865,5262,8502,4047
33462,26283,12935,13348,3219,6812,2904,3214,6397,3737
33463,40969,19713,21256,6477,9708,3528,6164,10504,4588
33467,41159,19857,21302,5173,8752,5932,4555,9079,7668
33469,14453,6885,7568,1497,2976,2412,1340,3310,2918
33470,18854,9589,9265,3605,5302,682,3130,5332,803
33471,5501,3023,2478,653,1776,594,729,1209,540
33476,8407,3969,4438,1946,1638,385,2085,1854,499
33477,11869,5603,6266,584,2192,2827,635,2643,2988
33478,11423,5839,5584,2030,3294,515,1770,3312,502
33480,11142,4994,6148,647,1457,2890,442,1961,3745
33483,12525,6037,6488,786,3178,2073,711,3162,2615
33484,24382,10609,13773,687,2067,7855,639,2523,10611
33486,22519,10969,11550,2987,6157,1825,2793,6476,2281
33487,16051,7560,8491,1163,3349,3048,1286,3622,3583
33493,3905,2523,1382,744,1593,186,575,643,164
33496,20749,9792,10957,2155,3929,3708,2203,4784,3970
33498,14516,7212,7304,2222,3285,1705,1951,3692,1661
33510,22524,10955,11569,3711,6032,1212,3414,6573,1582
33511,44627,21461,23166,7220,12064,2177,6969,13288,2909
33513,10325,5967,4358,1467,3288,1212,947,2142,1269
33514,1514,773,741,257,404,112,270,331,140
33521,502,227,275,76,116,35,84,121,70
33523,17376,8855,8521,3109,4111,1635,2518,4057,1946
33525,13975,6664,7311,2141,3065,1458,2082,3371,1858
33527,11365,5926,5439,2279,2953,694,1819,2828,792
33534,7407,3608,3799,1244,1942,422,1501,1848,450
33538,4630,2204,2426,456,886,862,500,1043,883
33540,18631,8803,9828,2180,3688,2935,2159,3849,3820
33541,23246,11340,11906,1842,3925,5573,1568,3954,6384
33543,12019,5830,6189,1710,3220,900,1670,3485,1034
33544,7335,3631,3704,1104,2062,465,1195,2047,462
33547,8379,4306,4073,1507,2278,521,1148,2352,573
33549,44289,22245,22044,6667,12921,2657,6127,12843,3074
33556,14257,7001,7256,2030,4179,792,2211,4146,899
33565,16427,7959,8468,2385,3811,1763,2524,4027,1917
33566,21611,10480,11131,3902,5266,1312,3660,5409,2062
33567,26185,13311,12874,5066,6512,1733,4218,6625,2031
33569,35900,17884,18016,6098,9560,2226,5461,9841,2714
33570,12896,6402,6494,2056,2750,1596,1731,3046,1717
33572,7498,3788,3710,840,1898,1050,723,2027,960
33573,16286,6929,9357,63,433,6433,87,844,8426
33576,2256,1031,1225,294,411,326,286,499,440
33584,20171,10042,10129,3347,5490,1205,3091,5624,1414
33585,820,422,398,143,182,97,66,224,108
33592,10144,5150,4994,1692,2645,813,1345,2697,952
33594,48086,23670,24416,8203,12798,2669,7743,13326,3347
33597,7412,3673,3739,1285,1598,790,1149,1690,900
33598,8109,4403,3706,1982,2028,393,1601,1742,363
33602,8906,4363,4543,1123,2657,583,1284,2390,869
33603,20932,10060,10872,3292,5438,1330,3456,5439,1977
33604,36625,17863,18762,6192,9492,2179,5656,10065,3041
33605,17291,8466,8825,3063,3998,1405,3016,4013,1796
33606,15011,7638,7373,1825,4893,920,1893,4346,1134
33607,23024,10774,12250,3509,5179,2086,3384,5725,3141
33609,15994,7735,8259,1801,4517,1417,1825,4396,2038
33610,32596,15029,17567,5475,7299,2255,5831,8361,3375
33611,29890,14607,15283,3333,8929,2345,3206,8582,3495
33612,42930,20633,22297,7115,10933,2585,7156,11253,3888
33613,29562,14630,14932,4496,8558,1576,4505,7860,2567
33614,43743,21685,22058,6210,12723,2752,5888,12631,3539
33615,41381,20339,21042,5952,11751,2636,5589,12009,3444
33616,11859,5851,6008,1979,3254,618,1862,3343,803
33617,42285,20211,22074,7178,10981,2052,7038,12022,3014
33618,20366,9701,10665,2948,5399,1354,2975,5872,1818
33619,28215,14674,13541,5107,7916,1651,4577,7063,1901
33620,2589,1133,1456,935,198,0,1211,245,0
33621,2692,1433,1259,701,723,9,638,621,0
33624,45043,21496,23547,6779,12336,2381,6550,13940,3057
33625,20654,10327,10327,3552,5812,963,3041,6081,1205
33626,11116,5271,5845,1553,3329,389,1744,3543,558
33629,23064,11045,12019,2811,6444,1790,2618,6537,2864
33634,19040,9266,9774,2767,5373,1126,2821,5551,1402
33635,12438,6209,6229,1920,3501,788,1531,3724,974
33637,12606,6232,6374,2140,3566,526,1840,3744,790
33647,26255,12986,13269,4439,7763,784,4169,8234,866
33701,15515,7855,7660,1370,4700,1785,1256,3916,2488
33702,30207,14998,15209,3655,8087,3256,2897,7865,4447
33703,25116,11913,13203,2937,6479,2497,3024,6637,3542
33704,16754,8061,8693,1948,4859,1254,1930,4962,1801
33705,28123,12854,15269,4196,6417,2241,4419,7367,3483
33706,17303,8469,8834,956,4497,3016,898,4568,3368
33707,26478,12035,14443,2320,5516,4199,2054,5927,6462
33708,17214,8281,8933,1028,4027,3226,1015,3917,4001
33709,25859,12149,13710,2769,5712,3668,2571,5858,5281
33710,33396,15761,17635,4182,8452,3127,3870,8939,4826
33711,19735,9053,10682,3601,3823,1629,3477,4972,2233
33712,26100,12045,14055,4541,5663,1841,4116,7123,2816
33713,31255,15495,15760,4406,8906,2183,4307,8282,3171
33714,17729,8706,9023,2171,4697,1838,2284,4360,2379
33715,7403,3638,3765,403,1653,1582,315,1820,1630
33716,9993,4913,5080,735,3674,504,880,3398,802
33755,26069,12904,13165,3919,7274,1711,3663,7232,2270
33756,29138,13452,15686,3259,6888,3305,3418,6996,5272
33759,20162,9419,10743,2776,4919,1724,2804,5161,2778
33760,16962,9475,7487,2331,6220,924,1946,4328,1213
33761,19851,9032,10819,1945,4163,2924,2039,4990,3790
33762,7294,3611,3683,488,2255,868,458,2199,1026
33763,17795,7794,10001,1147,3051,3596,1129,3525,5347
33764,23941,11453,12488,2501,5446,3506,2320,5621,4547
33765,13598,6618,6980,1605,3727,1286,1510,3694,1776
33767,9828,4809,5019,440,2176,2193,392,2319,2308
33770,24643,11780,12863,2549,6075,3156,2289,5984,4590
33771,28614,13158,15456,2492,6296,4370,2404,6748,6304
33772,23361,10682,12679,2614,5143,2925,2421,5638,4620
33773,16304,7863,8441,2102,4206,1555,2016,4206,2219
33774,18457,8629,9828,2216,3831,2582,1944,4400,3484
33776,13246,6291,6955,1765,3100,1426,1742,3313,1900
33777,17423,8061,9362,2196,4144,1721,2407,4567,2388
33778,13539,6491,7048,1694,3045,1752,1507,3358,2183
33781,25251,12391,12860,3698,6866,1827,3527,6559,2774
33782,19551,9119,10432,2227,4408,2484,2268,4792,3372
33785,5936,2963,2973,385,1798,780,318,1778,877
33786,1540,799,741,170,384,245,91,392,258
33801,31731,15481,16250,4806,7677,2998,4712,7837,3701
33803,26559,12272,14287,3371,6078,2823,3603,6483,4201
33805,20229,9625,10604,3608,4308,1709,3263,4676,2665
33809,28795,13885,14910,4007,6279,3599,3634,6873,4403
33810,28549,13970,14579,4411,7193,2366,4233,7404,2942
33811,16226,8025,8201,2552,4466,1007,2432,4494,1275
33813,35824,17440,18384,5849,8710,2881,5270,9695,3419
33815,13530,6411,7119,2114,2834,1463,2226,3074,1819
33823,26785,12995,13790,4211,6406,2378,4192,6732,2866
33825,23263,12017,11246,3087,5456,3474,2925,4277,4044
33827,2473,1188,1285,424,544,220,482,543,260
33830,25621,12787,12834,4161,6620,2006,3868,6317,2649
33834,7349,4427,2922,1099,2681,647,995,1296,631
33835,0,0,0,0,0,0,0,0,0
33837,21142,10490,10652,2435,4961,3094,2487,5126,3039
33838,2843,1317,1526,447,540,330,473,663,390
33839,1453,698,755,250,316,132,219,382,154
33841,7922,3888,4034,1393,1793,702,1297,1907,830
33843,10590,5867,4723,1933,2581,1353,1370,1906,1447
33844,26645,13105,13540,4250,5479,3376,3948,5674,3918
33847,279,183,96,100,52,31,21,32,43
33848,534,231,303,65,142,24,117,168,18
33849,419,245,174,119,88,38,41,100,33
33850,4087,1966,2121,599,920,447,572,1053,496
33851,839,407,432,92,196,119,117,220,95
33852,19671,9752,9919,2473,3586,3693,2122,3622,4175
33853,34822,16786,18036,4789,7206,4791,4437,7700,5899
33857,1696,905,791,222,338,345,172,287,332
33860,16883,8753,8130,2959,4403,1391,2520,4140,1470
33865,720,407,313,108,215,84,71,154,88
33868,11098,6389,4709,1625,3734,1030,1419,2360,930
33870,22414,10852,11562,2662,4471,3719,2518,4280,4764
33872,20714,9799,10915,1980,3405,4414,1730,4043,5142
33873,14428,7474,6954,2958,3471,1045,2471,3240,1243
33877,518,252,266,91,134,27,96,119,51
33880,34077,16814,17263,5706,8540,2568,5266,8472,3525
33881,28149,13432,14717,3696,5457,4279,3347,5850,5520
33884,19875,9315,10560,2301,3970,3044,2308,4611,3641
33890,4990,2589,2401,917,1201,471,819,1034,548
33901,21083,10380,10703,3025,5636,1719,2765,5114,2824
33903,23145,11192,11953,2190,3862,5140,1605,4209,6139
33904,32842,15847,16995,3168,6951,5728,3053,7324,6618
33905,26140,13534,12606,4277,6868,2389,3932,5990,2684
33907,21315,10272,11043,2342,5759,2171,2268,5210,3565
33908,25072,11794,13278,1660,4559,5575,1660,4985,6633
33909,8297,4149,4148,1431,2264,454,1405,2205,538
33912,33652,16859,16793,4844,8239,3776,4166,8595,4032
33913,4233,2036,2197,572,1093,371,732,1104,361
33914,25685,12671,13014,3742,6452,2477,3326,7091,2597
33916,19853,9391,10462,4001,4208,1182,4071,5038,1353
33917,28540,13726,14814,2740,5619,5367,2654,5935,6225
33919,26415,12174,14241,2320,5194,4660,2391,6105,5745
33920,4784,2370,2414,690,1115,565,707,1141,566
33921,1545,720,825,66,151,503,42,261,522
33922,4197,2202,1995,430,1011,761,323,962,710
33924,383,167,216,0,87,80,11,101,104
33928,8772,4252,4520,572,1443,2237,390,1790,2340
33930,646,315,331,137,144,34,147,159,25
33931,10502,5309,5193,504,1891,2914,322,2018,2853
33935,17991,10200,7791,3734,5096,1370,2714,3630,1447
33936,16322,7601,8721,2281,3151,2169,2123,3675,2923
33944,404,225,179,69,101,55,56,81,42
33945,77,38,39,5,21,12,3,21,15
33946,960,475,485,52,110,313,43,111,331
33947,5220,2524,2696,392,857,1275,443,945,1308
33948,14751,6972,7779,1707,3138,2127,1686,3468,2625
33950,19273,9138,10135,1034,2854,5250,1047,3520,5568
33952,30649,14340,16309,3394,5725,5221,3128,6477,6704
33953,3298,1545,1753,174,670,701,290,767,696
33954,7459,3551,3908,979,1712,860,1082,1946,880
33955,6206,3055,3151,492,1102,1461,494,1272,1385
33956,4096,2030,2066,166,705,1159,156,671,1239
33957,6051,2866,3185,326,1022,1518,358,1254,1573
33960,738,381,357,130,162,89,72,187,98
33971,8307,4306,4001,1755,2217,334,1445,2208,348
33972,7958,3825,4133,987,1719,1119,1039,1945,1149
33975,0,0,0,0,0,0,0,0,0
33980,8987,3918,5069,666,1121,2131,683,1290,3096
33981,7153,3534,3619,820,1394,1320,679,1660,1280
33982,9335,5175,4160,1089,2570,1516,773,1774,1613
33983,10967,5196,5771,1196,2020,1980,1175,2507,2089
33990,23088,11215,11873,3292,5681,2242,3071,6093,2709
33991,9113,4376,4737,1405,2157,814,1414,2346,977
33993,4210,2070,2140,578,1085,407,662,1087,391
34102,11677,5589,6088,940,2404,2245,846,2676,2566
34103,13258,6099,7159,884,2274,2941,877,2570,3712
34104,19035,9273,9762,2016,4267,2990,2078,4526,3158
34105,9971,4584,5387,766,1834,1984,866,2151,2370
34108,16563,7996,8567,1248,3221,3527,1321,3522,3724
34109,17937,8440,9497,2052,3960,2428,2011,4806,2680
34110,15755,7492,8263,1337,2926,3229,1166,3331,3766
34112,26426,13369,13057,2493,5925,4951,2094,5384,5579
34113,14296,7321,6975,1798,3226,2297,1572,2932,2471
34114,8300,4471,3829,895,1949,1627,796,1398,1635
34116,25149,13071,12078,4609,7228,1234,4250,6483,1345
34117,9908,5032,4876,1771,2761,500,1671,2748,457
34119,9674,4667,5007,1039,1972,1656,1086,2270,1651
34120,12319,6276,6043,2225,3418,633,2101,3403,539
34134,11659,5749,5910,495,2147,3107,505,2465,2940
34135,25273,13316,11957,3281,5862,4173,2337,5295,4325
34137,407,227,180,87,128,12,74,86,20
34138,515,203,312,38,97,68,73,149,90
34139,692,361,331,47,194,120,73,153,105
34141,108,91,17,52,24,15,0,12,5
34142,23697,13804,9893,6332,6755,717,4315,4778,800
34145,15236,7525,7711,1066,2770,3689,837,3083,3791
34201,1933,992,941,103,380,509,27,411,503
34202,15484,7686,7798,2488,3917,1281,2260,4346,1192
34203,25968,12549,13419,3384,5426,3739,3205,5741,4473
34205,31792,15228,16564,4307,7671,3250,4027,7534,5003
34207,30682,14468,16214,3436,6699,4333,3529,6702,5983
34208,30873,14984,15889,5483,7144,2357,5318,7674,2897
34209,33310,15402,17908,3787,6537,5078,3486,7399,7023
34210,14044,6652,7392,994,2850,2808,905,3000,3487
34215,660,324,336,36,112,176,72,119,145
34216,1870,861,1009,151,451,259,200,445,364
34217,6392,3103,3289,447,1395,1261,389,1419,1481
34219,5813,2846,2967,697,1248,901,627,1387,953
34221,31674,15895,15779,4526,7376,3993,4089,6994,4696
34222,8711,3931,4780,468,1151,2312,499,1374,2907
34223,18131,8606,9525,1299,2875,4432,1141,3345,5039
34224,15121,7210,7911,1150,2616,3444,1189,2877,3845
34228,7575,3539,4036,166,865,2508,170,1110,2756
34229,4827,2342,2485,401,1029,912,361,1070,1054
34231,31910,14855,17055,3093,7417,4345,3062,7805,6188
34232,31758,15279,16479,4312,8061,2906,3838,8410,4231
34233,14826,6840,7986,1627,3087,2126,1498,3313,3175
34234,20552,9586,10966,2974,4544,2068,3022,5035,2909
34235,13216,6233,6983,1170,2657,2406,1037,2935,3011
34236,11557,5774,5783,1009,2815,1950,805,2448,2530
34237,17176,8615,8561,2191,4875,1549,1954,4488,2119
34238,13980,6415,7565,964,2488,2963,1010,2891,3664
34239,15613,7303,8310,1610,3858,1835,1423,4084,2803
34240,6722,3319,3403,1010,1720,589,833,1938,632
34241,12090,5906,6184,1654,2676,1576,1579,3092,1513
34242,9581,4585,4996,482,1843,2260,510,2008,2478
34243,20232,9982,10250,2230,4803,2949,1876,5439,2935
34250,459,253,206,71,145,37,62,114,30
34251,4056,2118,1938,647,1261,210,741,998,199
34266,31955,18004,13951,5058,9166,3780,4273,5538,4140
34268,254,137,117,54,34,49,24,54,39
34275,15040,7231,7809,1313,2797,3121,1168,3120,3521
34285,7979,3361,4618,307,1003,2051,324,1301,2993
34286,8528,4277,4251,1476,2295,506,1242,2499,510
34287,19201,8933,10268,1743,3009,4181,1682,3149,5437
34292,17446,7887,9559,845,2044,4998,723,2613,6223
34293,30729,14514,16215,2704,5679,6131,2658,6530,7027
34420,14238,6832,7406,1967,3087,1778,1930,3389,2087
34428,9019,4507,4512,1157,2208,1142,1055,2310,1147
34429,8589,4142,4447,966,1710,1466,888,1798,1761
34431,6251,2921,3330,642,1092,1187,688,1306,1336
34432,9772,4736,5036,868,1813,2055,762,2054,2220
34433,3883,1857,2026,551,686,620,465,1021,540
34434,4451,2052,2399,419,780,853,540,867,992
34436,8623,4276,4347,1039,1688,1549,905,1807,1635
34442,10448,5211,5237,1101,2034,2076,995,2258,1984
34446,12523,6084,6439,1133,2134,2817,1063,2363,3013
34448,10145,5030,5115,1040,2099,1891,1090,2144,1881
34449,3415,1737,1678,378,803,556,378,816,484
34450,10142,4736,5406,917,1804,2015,974,2065,2367
34452,10179,4669,5510,1123,1826,1720,1151,2164,2195
34453,8078,3874,4204,962,1557,1355,790,1764,1650
34461,8214,3849,4365,773,1819,1257,752,1871,1742
34465,13209,6087,7122,942,1789,3356,825,2216,4081
34470,15463,6955,8508,1898,3280,1777,2123,3838,2547
34471,22070,10447,11623,3197,5115,2135,2954,5497,3172
34472,19162,8748,10414,2426,3709,2613,2839,4459,3116
34473,7842,3761,4081,1184,1563,1014,974,1945,1162
34474,16188,7666,8522,2378,3617,1671,2403,3871,2248
34475,12958,7273,5685,2111,4272,890,1918,2722,1045
34476,12116,5783,6333,833,1829,3121,825,2205,3303
34479,12950,6235,6715,1967,3043,1225,1803,3283,1629
34480,9469,4590,4879,1543,2216,831,1489,2334,1056
34481,14281,6584,7697,780,1402,4402,725,1817,5155
34482,16071,7387,8684,2120,3120,2147,2070,4440,2174
34484,2332,1124,1208,313,563,248,432,548,228
34488,9514,4694,4820,1119,1979,1596,987,2042,1791
34491,18931,9170,9761,2071,3494,3605,2102,3972,3687
34498,608,304,304,63,132,109,52,159,93
34601,20961,9808,11153,2699,4675,2434,2886,4951,3316
34602,5828,2773,3055,798,1260,715,840,1484,731
34606,24288,11286,13002,2320,3559,5407,2166,4222,6614
34607,6976,3370,3606,544,1426,1400,590,1669,1347
34608,23027,10933,12094,2586,4162,4185,2327,4795,4972
34609,28290,13729,14561,3736,5872,4121,3382,6908,4271
34610,10318,5009,5309,1451,2694,864,1703,2784,822
34613,13794,6489,7305,977,2026,3486,1009,2336,3960
34614,2729,1326,1403,493,571,262,438,737,228
34639,19329,9853,9476,3306,5348,1199,2800,5331,1345
34652,24671,11436,13235,2435,5207,3794,2441,5260,5534
34653,31172,14404,16768,3421,6370,4613,3653,6831,6284
34654,16346,8066,8280,2268,3728,2070,2161,3803,2316
34655,24226,11623,12603,2709,4731,4183,2547,5342,4714
34661,132,63,69,29,25,9,19,33,17
34667,29835,14247,15588,2664,5646,5937,2529,5962,7097
34668,42099,19511,22588,4501,7989,7021,4472,8640,9476
34669,10625,5355,5270,1549,2521,1285,1340,2554,1376
34677,19462,9307,10155,2711,4788,1808,2708,5217,2230
34679,372,198,174,99,83,16,44,106,24
34681,1218,591,627,198,292,101,178,342,107
34683,34226,16525,17701,4772,8635,3118,4817,9293,3591
34684,27244,12311,14933,2684,5491,4136,2508,6243,6182
34685,17560,8474,9086,2485,4388,1601,2399,4931,1756
34689,28936,14228,14708,3685,6619,3924,3056,6867,4785
34690,13059,6060,6999,1328,2680,2052,1349,2688,2962
34691,18594,8802,9792,2149,3746,2907,1869,4152,3771
34695,18119,8632,9487,2342,4482,1808,2030,5061,2396
34698,34034,15203,18831,2974,7286,4943,3014,8222,7595
34705,2145,1012,1133,326,487,199,299,597,237
34711,38467,19449,19018,5439,10754,3256,5103,10285,3630
34731,9812,4757,5055,1212,1968,1577,1109,2162,1784
34734,2743,1308,1435,387,798,123,541,772,122
34736,7755,4056,3699,1390,2112,554,973,2043,683
34737,1968,965,1003,258,498,209,301,496,206
34739,746,395,351,91,198,106,83,171,97
34741,35347,17680,17667,6097,10071,1512,5340,10147,2180
34743,26358,12744,13614,4678,6459,1607,4441,7151,2022
34744,28378,14392,13986,4924,7685,1783,4168,7782,2036
34746,18124,8929,9195,2518,4829,1582,2398,4661,2136
34747,5292,2630,2662,837,1446,347,755,1576,331
34748,30611,14160,16451,3093,4777,6290,3110,5795,7546
34753,2880,1512,1368,587,754,171,561,659,148
34756,2346,1148,1198,375,586,187,333,647,218
34758,12898,6193,6705,2318,2902,973,2179,3280,1246
34759,7579,3588,3991,1123,1869,596,1400,2027,564
34760,647,302,345,127,124,51,86,184,75
34761,27563,13660,13903,4807,7617,1236,4335,7889,1679
34762,319,142,177,46,82,14,41,109,27
34769,18134,8823,9311,2810,4323,1690,2366,4591,2354
34771,10128,5099,5029,1546,2634,919,1447,2659,923
34772,11430,5541,5889,1859,2939,743,1865,3167,857
34773,1633,850,783,300,428,122,239,412,132
34785,15681,9168,6513,1595,5492,2081,1332,2856,2325
34786,8319,4183,4136,1487,2216,480,1313,2221,602
34787,23042,11154,11888,3506,5987,1661,3433,6098,2357
34788,15211,7146,8065,1285,2343,3518,1189,2745,4131
34797,948,483,465,69,219,195,72,190,203
34945,3999,2364,1635,608,1379,377,344,804,487
34946,6840,3310,3530,1091,1507,712,1140,1607,783
34947,10541,5157,5384,2340,2209,608,2019,2563,802
34949,6618,3279,3339,274,1256,1749,301,1294,1744
34950,17621,8934,8687,3200,4351,1383,3012,4004,1671
34951,12775,6228,6547,1354,2379,2495,1149,2500,2898
34952,31325,14522,16803,3377,5785,5360,3202,6678,6923
34953,25881,12844,13037,4363,6695,1786,4060,7158,1819
34956,9005,5472,3533,1804,3014,654,1237,1654,642
34957,19434,9364,10070,1712,3817,3835,1453,4073,4544
34972,17740,9851,7889,3274,5378,1199,2938,3621,1330
34974,21893,11052,10841,2907,4764,3381,2773,4687,3381
34981,3213,1639,1574,591,894,154,528,906,140
34982,23206,11147,12059,3139,5463,2545,3317,5355,3387
34983,26985,13156,13829,3744,6482,2930,3587,6856,3386
34984,9761,4663,5098,1513,2325,825,1459,2737,902
34986,5919,2777,3142,313,918,1546,293,1108,1741
34987,1240,567,673,168,339,60,293,334,46
34990,23821,11485,12336,2851,4883,3751,2547,5522,4267
34994,14677,7240,7437,1751,3356,2133,1380,3297,2760
34996,10492,4856,5636,827,1923,2106,752,1949,2935
34997,33261,16102,17159,3729,7376,4997,3790,7577,5792
35004,6758,3230,3528,1141,1746,343,998,2025,505
35005,8807,4297,4510,1295,2225,777,1171,2343,996
35006,3009,1449,1560,454,788,207,512,783,265
35007,20101,9759,10342,3242,5704,813,3099,5981,1262
35010,21717,10321,11396,3291,5192,1838,2983,5559,2854
35014,4378,2282,2096,727,1308,247,663,1069,364
35016,15513,7566,7947,2280,4014,1272,2001,4106,1840
35019,2066,1017,1049,343,533,141,352,518,179
35020,31833,14529,17304,5342,6949,2238,5190,8164,3950
35022,14173,6693,7480,2308,3201,1184,2142,3749,1589
35023,24969,12767,12202,3447,7389,1931,3138,6134,2930
35031,7682,3892,3790,1185,2065,642,1102,1910,778
35033,3505,1755,1750,586,925,244,515,926,309
35034,5686,3340,2346,897,2104,339,827,1099,420
35035,1587,767,820,295,382,90,281,441,98
35036,372,182,190,63,87,32,71,82,37
35040,7259,3551,3708,1271,1836,444,1156,1996,556
35042,4874,2305,2569,665,1236,404,690,1198,681
35043,4318,2096,2222,674,1206,216,732,1240,250
35044,7797,3668,4129,1255,1876,537,1359,1877,893
35045,13288,6435,6853,2126,3163,1146,1853,3365,1635
35046,4521,2249,2272,629,1257,363,619,1194,459
35049,3220,1710,1510,555,864,291,436,754,320
35051,7383,3787,3596,1359,1974,454,1005,1943,648
35052,316,88,228,14,39,35,10,53,165
35053,2519,1220,1299,312,693,215,377,671,251
35054,4175,2086,2089,668,1003,415,536,1131,422
35055,18601,8852,9749,2670,4440,1742,2396,4450,2903
35057,11315,5587,5728,1664,3010,913,1735,2904,1089
35058,9735,4943,4792,1498,2586,859,1342,2511,939
35060,706,313,393,142,130,41,104,198,91
35061,1399,679,720,193,371,115,182,362,176
35062,7713,3834,3879,1140,2029,665,1089,2039,751
35063,3408,1647,1761,544,906,197,522,945,294
35064,12980,5739,7241,2266,2780,693,2230,3571,1440
35068,5506,2616,2890,749,1373,494,798,1427,665
35070,298,164,134,49,82,33,23,67,44
35071,13625,6524,7101,1916,3417,1191,1652,3668,1781
35072,5164,2556,2608,846,1234,476,734,1301,573
35073,2753,1272,1481,417,616,239,344,729,408
35074,136,67,69,11,42,14,20,25,24
35077,12790,6323,6467,2060,3194,1069,1783,3124,1560
35078,2817,1346,1471,472,681,193,416,771,284
35079,7215,3459,3756,1071,1912,476,1243,1890,623
35080,11749,5671,6078,1878,3439,354,1805,3725,548
35082,20,12,8,0,12,0,0,8,0
35083,3090,1521,1569,523,736,262,484,816,269
35085,8135,3967,4168,1306,2065,596,1292,2208,668
35087,2127,1101,1026,360,580,161,319,552,155
35089,2433,1167,1266,363,665,139,427,682,157
35091,1233,589,644,209,305,75,218,313,113
35094,12747,6185,6562,1822,3367,996,1754,3446,1362
35096,6724,3282,3442,1016,1803,463,977,1846,619
35097,1916,948,968,325,504,119,325,470,173
35098,1504,785,719,308,361,116,213,398,108
35111,10581,5063,5518,1465,2784,814,1604,2952,962
35112,535,250,285,93,121,36,108,158,19
35114,4172,2058,2114,692,1223,143,732,1223,159
35115,15184,7292,7892,2621,3861,810,2752,4061,1079
35116,3782,1916,1866,634,1005,277,512,976,378
35117,4872,2325,2547,672,1208,445,701,1281,565
35118,3592,1761,1831,546,911,304,424,926,481
35119,139,45,94,11,9,25,40,25,29
35120,7539,3702,3837,1220,2032,450,1279,2024,534
35121,14359,6977,7382,2331,3587,1059,2143,3606,1633
35124,16566,8116,8450,2609,4540,967,2182,4954,1314
35125,9426,4634,4792,1542,2439,653,1436,2441,915
35126,19792,9689,10103,3436,5193,1060,3298,5424,1381
35127,10353,4915,5438,1480,2583,852,1498,2702,1238
35128,7308,3690,3618,1139,1920,631,872,1998,748
35130,4002,1948,2054,470,1089,389,524,1059,471
35131,4012,2013,1999,757,972,284,542,1021,436
35133,4252,2176,2076,689,1200,287,604,1167,305
35135,1450,675,775,187,348,140,232,418,125
35136,1625,790,835,272,349,169,212,418,205
35139,85,39,46,9,30,0,21,13,12
35143,3293,1672,1621,416,967,289,481,872,268
35146,8211,4795,3416,1290,3008,497,914,1906,596
35147,3065,1549,1516,475,793,281,337,856,323
35148,3324,1569,1755,499,790,280,543,843,369
35149,661,277,384,61,175,41,112,192,80
35150,18414,8468,9946,2793,4177,1498,2884,4634,2428
35151,8190,4090,4100,1181,2253,656,1098,2213,789
35160,27685,13960,13725,4165,7591,2204,4003,6692,3030
35171,2843,1472,1371,471,813,188,377,743,251
35172,2011,937,1074,267,506,164,277,634,163
35173,19265,9681,9584,3154,5203,1324,2670,5282,1632
35175,4859,2466,2393,647,1390,429,669,1274,450
35176,904,479,425,169,243,67,79,255,91
35178,3369,1695,1674,553,896,246,417,977,280
35179,9203,4587,4616,1440,2479,668,1408,2480,728
35180,13130,6569,6561,2046,3463,1060,1791,3478,1292
35183,450,220,230,72,102,46,65,114,51
35184,5628,2834,2794,966,1465,403,808,1511,475
35186,3919,1940,1979,576,1000,364,566,1002,411
35188,2135,1033,1102,345,537,151,308,626,168
35203,3677,2229,1448,440,1573,216,389,794,265
35204,15408,6992,8416,2610,3064,1318,2627,3630,2159
35205,21159,10481,10678,2093,7368,1020,2646,6179,1853
35206,21744,9925,11819,3650,4961,1314,3577,5633,2609
35207,11218,5163,6055,1947,2341,875,1839,2936,1280
35208,17499,7962,9537,3149,3821,992,3006,5203,1328
35209,30559,14220,16339,4508,8384,1328,4737,9227,2375
35210,13489,6116,7373,1743,3208,1165,1573,3823,1977
35211,30462,13423,17039,5192,6169,2062,5425,8298,3316
35212,15829,7237,8592,2810,3647,780,2989,4337,1266
35213,14090,6439,7651,1811,3335,1293,1886,3750,2015
35214,21634,9865,11769,3306,4935,1624,3110,6048,2611
35215,46439,21807,24632,7776,11128,2903,7682,12752,4198
35216,31741,14830,16911,4211,8401,2218,4182,8999,3730
35217,15652,7245,8407,2492,3576,1177,2373,4114,1920
35218,9969,4450,5519,1796,2185,469,1842,2832,845
35221,6336,2840,3496,956,1388,496,1015,1577,904
35222,8681,4116,4565,1118,2413,585,1026,2623,916
35223,11089,5288,5801,1654,2652,982,1616,3008,1177
35224,7100,3230,3870,1159,1579,492,1216,1820,834
35226,27070,12869,14201,3755,6861,2253,3811,7580,2810
35228,11176,5003,6173,1814,2497,692,1834,3058,1281
35233,116,82,34,12,55,15,0,34,0
35234,7775,3588,4187,1210,1812,566,1154,2013,1020
35235,18530,8719,9811,2630,4766,1323,2564,5285,1962
35242,31821,15813,16008,4936,9656,1221,4672,9814,1522
35243,16472,8108,8364,2311,4688,1109,1919,5031,1414
35244,26485,13121,13364,4129,7747,1245,3661,8072,1631
35401,37785,17837,19948,7108,8873,1856,8650,7858,3440
35403,0,0,0,0,0,0,0,0,0
35404,19303,9556,9747,3205,5035,1316,2937,5018,1792
35405,30862,14583,16279,5287,7587,1709,5095,9026,2158
35406,10699,5195,5504,1668,2728,799,1401,3059,1044
35441,1449,689,760,198,358,133,220,396,144
35442,5968,2671,3297,1125,1110,436,1092,1465,740
35443,2123,983,1140,346,434,203,364,562,214
35444,3143,1519,1624,492,862,165,525,855,244
35446,1622,770,852,178,423,169,250,498,104
35447,3618,1719,1899,654,800,265,629,870,400
35452,2971,1568,1403,521,839,208,336,817,250
35453,8584,4177,4407,1406,2248,523,1268,2459,680
35456,4241,2213,2028,866,1122,225,694,1061,273
35457,68,53,15,10,26,17,0,10,5
35458,247,100,147,22,60,18,27,91,29
35459,971,494,477,176,221,97,127,234,116
35460,611,302,309,95,171,36,87,174,48
35461,2012,1011,1001,290,536,185,229,562,210
35462,5743,2644,3099,1062,1119,463,923,1472,704
35463,1394,708,686,286,310,112,172,380,134
35464,584,265,319,128,110,27,140,134,45
35466,5550,2649,2901,804,1358,487,799,1435,667
35469,525,265,260,89,129,47,69,127,64
35470,5045,2354,2691,986,1069,299,921,1286,484
35471,32,14,18,0,0,14,0,0,18
35473,12852,6338,6514,2018,3407,913,1743,3556,1215
35474,5051,2489,2562,962,1255,272,658,1377,527
35475,11143,5499,5644,1787,3129,583,1826,3181,637
35476,7451,3192,4259,1069,1504,619,1286,1926,1047
35477,400,183,217,85,75,23,87,87,43
35480,1182,606,576,242,278,86,189,284,103
35481,3844,1739,2105,614,806,319,648,984,473
35490,2855,1434,1421,497,792,145,494,713,214
35501,11926,5799,6127,1839,2905,1055,1508,2849,1770
35503,8585,4219,4366,1194,2282,743,1106,2329,931
35504,13273,6421,6852,1835,3426,1160,1772,3595,1485
35540,2140,1045,1095,348,530,167,311,578,206
35541,3482,1722,1760,518,959,245,471,969,320
35542,1184,612,572,174,335,103,139,340,93
35543,1105,570,535,185,315,70,168,262,105
35544,796,364,432,121,164,79,122,196,114
35545,175,91,84,35,44,12,15,47,22
35546,3876,1975,1901,678,1015,282,501,1013,387
35548,1862,917,945,276,469,172,227,514,204
35549,4486,2068,2418,602,1041,425,635,1167,616
35550,6107,2870,3237,903,1439,528,880,1658,699
35552,989,506,483,143,283,80,137,233,113
35553,5010,2523,2487,748,1363,412,649,1280,558
35554,1384,709,675,189,387,133,195,319,161
35555,10719,4998,5721,1465,2495,1038,1392,2677,1652
35559,103,43,60,16,27,0,23,34,3
35563,4691,2227,2464,700,1114,413,679,1170,615
35564,2368,1129,1239,314,601,214,315,665,259
35565,14479,7119,7360,2230,3702,1187,1972,3720,1668
35570,11053,5674,5379,1504,3125,1045,1388,2648,1343
35571,1036,502,534,152,262,88,142,269,123
35572,1155,620,535,148,338,134,139,273,123
35574,1787,855,932,266,455,134,277,442,213
35575,1150,557,593,172,289,96,149,301,143
35576,3521,1714,1807,474,848,392,490,906,411
35578,5788,2878,2910,892,1601,385,853,1529,528
35579,3017,1492,1525,466,745,281,399,812,314
35580,4721,2284,2437,699,1211,374,649,1261,527
35581,6060,3003,3057,1014,1500,489,936,1563,558
35582,4399,2099,2300,649,1054,396,570,1152,578
35584,447,255,192,122,110,23,47,100,45
35585,1475,710,765,210,407,93,223,396,146
35586,5042,2448,2594,775,1269,404,661,1311,622
35587,1008,504,504,140,281,83,133,264,107
35592,4994,2398,2596,724,1227,447,692,1237,667
35593,2071,990,1081,248,540,202,293,543,245
35594,7637,3630,4007,1109,1819,702,1067,1898,1042
35601,34835,17097,17738,5569,8846,2682,4891,8697,4150
35603,26101,12515,13586,3956,6983,1576,4115,7527,1944
35610,2155,1013,1142,276,550,187,331,579,232
35611,23059,10821,12238,3305,5883,1633,3493,6095,2650
35613,12370,6205,6165,1886,3404,915,1735,3421,1009
35614,6825,3431,3394,1015,1928,488,929,1885,580
35616,4819,2334,2485,646,1196,492,662,1294,529
35618,2247,1032,1215,388,513,131,363,647,205
35619,5212,2603,2609,868,1352,383,769,1418,422
35620,7100,3618,3482,1264,1890,464,1060,1900,522
35621,2180,1110,1070,442,531,137,372,537,161
35622,7232,3523,3709,1107,1912,504,1049,1785,875
35630,30894,13998,16896,4395,7052,2551,4758,7502,4636
35633,19566,9511,10055,2881,5199,1431,2948,5346,1761
35634,9445,4775,4670,1396,2484,895,1153,2648,869
35640,21168,10390,10778,3229,5612,1549,3000,5653,2125
35643,3305,1576,1729,520,865,191,508,952,269
35645,12898,6292,6606,1995,3404,893,1875,3496,1235
35646,5177,2434,2743,722,1292,420,899,1339,505
35647,1092,558,534,207,301,50,171,293,70
35648,3886,1886,2000,568,1039,279,561,1024,415
35649,67,30,37,7,17,6,13,20,4
35650,13649,6640,7009,1993,3613,1034,1938,3642,1429
35651,1252,655,597,265,315,75,174,318,105
35652,7844,3905,3939,1116,2017,772,956,2112,871
35653,11439,5582,5857,1749,2791,1042,1494,2879,1484
35654,6697,3439,3258,1110,1802,527,905,1700,653
35660,9440,4336,5104,1393,2065,878,1309,2410,1385
35661,15947,7620,8327,2367,4064,1189,2366,4297,1664
35670,7204,3633,3571,1163,1972,498,1093,1954,524
35671,2240,1145,1095,402,592,151,407,505,183
35672,6680,3282,3398,1084,1672,526,967,1680,751
35673,7647,3872,3775,1325,1990,557,1134,2032,609
35674,18258,8815,9443,2624,4491,1700,2489,4695,2259
35677,1767,897,870,246,429,222,217,460,193
35739,4148,2054,2094,722,1084,248,635,1145,314
35740,3851,1823,2028,542,944,337,600,968,460
35741,2469,1167,1302,337,596,234,370,660,272
35742,1992,1992,0,114,1873,5,0,0,0
35744,2454,1204,1250,365,676,163,338,669,243
35745,302,162,140,39,69,54,19,48,73
35746,789,405,384,103,235,67,88,219,77
35747,5505,2672,2833,792,1463,417,826,1473,534
35748,5307,2629,2678,829,1387,413,757,1423,498
35749,13105,6166,6939,2065,3499,602,2561,3669,709
35750,11900,5928,5972,2060,3205,663,2081,3141,750
35751,277,152,125,42,83,27,26,86,13
35752,2205,1084,1121,338,604,142,324,619,178
35754,5079,2574,2505,840,1399,335,756,1412,337
35755,526,237,289,47,105,85,70,137,82
35756,4290,2144,2146,741,1165,238,659,1199,288
35757,7769,3898,3871,1370,2197,331,1258,2260,353
35758,30733,15393,15340,5531,8762,1100,4846,9105,1389
35759,4359,2108,2251,600,1168,340,692,1220,339
35760,4803,2320,2483,675,1297,348,745,1238,500
35761,8404,4171,4233,1425,2260,486,1363,2188,682
35763,7293,3629,3664,1252,1963,414,1154,2064,446
35764,565,280,285,78,187,15,105,151,29
35765,3911,1888,2023,578,981,329,585,1002,436
35766,73,38,35,8,20,10,9,19,7
35768,11691,5571,6120,1800,2798,973,1563,3111,1446
35769,9151,4459,4692,1186,2501,772,1269,2565,858
35771,3683,1792,1891,598,915,279,546,984,361
35772,5261,2568,2693,835,1336,397,702,1438,553
35773,9461,4776,4685,1728,2532,516,1461,2654,570
35774,226,106,120,76,23,7,90,25,5
35775,596,293,303,95,142,56,53,160,90
35776,3932,1941,1991,524,1051,366,541,1030,420
35801,22191,10571,11620,2613,5689,2269,2489,5799,3332
35802,20480,9754,10726,2441,4850,2463,2139,5360,3227
35803,25784,12747,13037,4166,6835,1746,3809,7336,1892
35805,21139,10266,10873,3444,5666,1156,3247,5783,1843
35806,10635,5278,5357,1416,3194,668,1432,3139,786
35808,2344,1404,940,676,728,0,462,478,0
35810,28208,13152,15056,4542,6632,1978,4378,7704,2974
35811,23989,12080,11909,4374,6221,1485,3812,6196,1901
35816,15509,7425,8084,2675,3938,812,3028,3769,1287
35824,3023,1412,1611,333,991,88,445,1039,127
35901,20669,9589,11080,3179,4724,1686,2962,5070,3048
35903,18590,8854,9736,2784,4565,1505,2625,4920,2191
35904,15350,7288,8062,2252,3447,1589,2023,3712,2327
35905,5665,2722,2943,803,1378,541,749,1494,700
35906,8987,4260,4727,1268,2253,739,1273,2426,1028
35907,6851,3346,3505,945,1879,522,970,1957,578
35950,17853,8583,9270,2964,4423,1196,2661,4694,1915
35951,7204,3680,3524,1186,1948,546,1057,1800,667
35952,7780,3770,4010,1153,1934,683,1154,2053,803
35953,7239,3732,3507,1177,2031,524,1136,1813,558
35954,12941,6263,6678,1966,3332,965,1817,3264,1597
35956,8077,4007,4070,1205,2176,626,1138,2187,745
35957,14729,7082,7647,2222,3674,1186,2093,3952,1602
35958,3317,1621,1696,470,924,227,546,891,259
35959,4180,2084,2096,590,1047,447,456,1099,541
35960,9467,4561,4906,1156,2463,942,1115,2460,1331
35961,6043,2998,3045,944,1547,507,893,1490,662
35962,7989,3965,4024,1390,2010,565,1209,2008,807
35963,1665,829,836,234,503,92,256,471,109
35966,3808,1858,1950,625,967,266,536,1058,356
35967,17042,8129,8913,2508,4406,1215,2535,4388,1990
35968,1328,668,660,203,375,90,213,372,75
35971,4760,2293,2467,703,1247,343,688,1269,510
35972,847,414,433,124,217,73,152,203,78
35973,3355,1644,1711,515,857,272,458,865,388
35974,1540,726,814,225,343,158,240,340,234
35975,1203,607,596,136,316,155,139,340,117
35976,16162,7845,8317,2406,3998,1441,2173,4174,1970
35978,5611,2735,2876,786,1476,473,755,1489,632
35979,1148,597,551,218,299,80,187,293,71
35980,4424,2205,2219,740,1125,340,647,1146,426
35981,2061,1088,973,333,536,219,228,519,226
35983,3032,1478,1554,403,790,285,394,779,381
35984,1730,833,897,242,432,159,239,456,202
35986,7616,3631,3985,1103,1940,588,1079,2046,860
35987,2838,1396,1442,437,735,224,369,748,325
35988,1680,840,840,282,431,127,245,466,129
35989,3413,1645,1768,487,959,199,576,891,301
35990,42,23,19,8,12,3,3,13,3
36003,1773,803,970,339,359,105,326,469,175
36005,1715,824,891,235,418,171,273,404,214
36006,1241,663,578,226,263,174,168,271,139
36009,2676,1213,1463,349,645,219,371,692,400
36010,4680,2212,2468,726,1057,429,595,1212,661
36013,137,92,45,32,60,0,23,22,0
36016,5217,3174,2043,850,2048,276,615,1010,418
36017,2950,2057,893,398,1479,180,255,422,216
36020,1036,515,521,193,239,83,185,241,95
36022,9967,5024,4943,1573,2904,547,1749,2637,557
36024,5272,2554,2718,771,1279,504,784,1314,620
36025,5910,4527,1383,910,3370,247,406,675,302
36026,1142,610,532,144,306,160,124,271,137
36027,17502,8195,9307,2989,3939,1267,2870,4514,1923
36028,1888,889,999,266,459,164,259,508,232
36029,1112,535,577,156,291,88,162,311,104
36030,541,261,280,90,99,72,83,123,74
36031,297,123,174,69,44,10,70,86,18
36032,2681,1222,1459,469,605,148,543,653,263
36033,4547,2121,2426,612,1017,492,640,1108,678
36034,638,293,345,80,158,55,82,128,135
36035,1580,756,824,178,415,163,204,396,224
36036,2372,1140,1232,339,591,210,384,586,262
36037,14186,6658,7528,2514,3071,1073,2306,3562,1660
36039,186,68,118,20,7,41,37,38,43
36040,4560,2049,2511,878,896,275,914,1097,500
36041,1277,626,651,195,313,118,153,302,196
36042,1405,658,747,206,365,87,223,392,132
36043,4178,1932,2246,562,1028,342,727,1177,342
36046,1653,838,815,231,444,163,206,426,183
36047,1592,799,793,308,358,133,268,420,105
36048,1946,886,1060,295,412,179,307,514,239
36049,5244,2486,2758,831,1174,481,656,1380,722
36051,1879,850,1029,272,432,146,290,506,233
36052,481,251,230,47,142,62,34,143,53
36053,2599,1193,1406,435,556,202,442,663,301
36054,11206,5509,5697,2196,2760,553,1996,3108,593
36064,4986,2467,2519,932,1271,264,793,1408,318
36065,104,66,38,9,57,0,0,38,0
36066,12651,6208,6443,2200,3168,840,1967,3439,1037
36067,22773,10956,11817,3700,5829,1427,3775,6076,1966
36069,2133,1022,1111,315,441,266,277,497,337
36071,638,314,324,123,160,31,119,159,46
36075,2105,976,1129,375,481,120,379,546,204
36078,12335,5793,6542,1939,2900,954,2128,2995,1419
36079,7702,3761,3941,1174,2122,465,1483,1956,502
36080,2218,1125,1093,293,598,234,300,575,218
36081,14594,6802,7792,2540,3471,791,2837,3473,1482
36083,11306,5072,6234,1965,2279,828,2005,2894,1335
36088,5597,2559,3038,1140,937,482,1559,1053,426
36089,9345,5151,4194,1615,2989,547,1414,1926,854
36091,3341,1702,1639,590,825,287,517,867,255
36092,17351,7950,9401,2787,4038,1125,2343,5326,1732
36093,6702,3416,3286,1056,1851,509,878,1954,454
36104,18930,10592,8338,3070,6706,816,2765,4034,1539
36105,14693,6792,7901,2638,3139,1015,2548,3904,1449
36106,15353,7075,8278,2472,3600,1003,2810,3916,1552
36107,9392,4195,5197,1340,2312,543,1361,2599,1237
36108,24735,11208,13527,4779,4796,1633,4542,6467,2518
36109,24886,11641,13245,3429,5906,2306,3172,6536,3537
36110,13125,6149,6976,2164,3134,851,2223,3363,1390
36111,12226,5572,6654,1667,2664,1241,1776,2975,1903
36113,585,252,333,114,138,0,191,134,8
36115,881,537,344,322,199,16,128,216,0
36116,38613,17557,21056,6911,9231,1415,7018,11832,2206
36117,37175,18556,18619,5284,11532,1740,5221,10931,2467
36201,22106,10213,11893,3411,5201,1601,3535,5642,2716
36203,16512,7909,8603,2466,4336,1107,2417,4472,1714
36205,19,13,6,3,10,0,3,3,0
36206,11757,5536,6221,1792,2845,899,1725,3183,1313
36207,17605,8239,9366,2227,4401,1611,2164,4708,2494
36250,4035,1901,2134,537,1120,244,647,1209,278
36251,5258,2493,2765,754,1253,486,710,1307,748
36255,776,381,395,93,189,99,94,213,88
36256,981,455,526,116,295,44,155,288,83
36258,1384,681,703,218,323,140,171,349,183
36260,4649,2306,2343,744,1236,326,667,1272,404
36262,1249,651,598,204,378,69,168,325,105
36263,561,254,307,55,162,37,95,153,59
36264,8829,4362,4467,1312,2319,731,1227,2217,1023
36265,16054,7769,8285,2767,3956,1046,2812,4061,1412
36266,5538,2695,2843,774,1368,553,779,1438,626
36267,74,40,34,0,34,6,13,21,0
36268,5406,2660,2746,760,1477,423,735,1508,503
36269,1224,568,656,171,330,67,215,318,123
36270,1152,556,596,155,291,110,180,306,110
36271,5880,2955,2925,925,1596,434,913,1494,518
36272,13984,6957,7027,2065,3746,1146,1919,3674,1434
36273,2808,1428,1380,445,769,214,449,685,246
36274,11581,5555,6026,1801,2722,1032,1688,2874,1464
36276,2493,1194,1299,387,597,210,382,571,346
36277,5146,2561,2585,851,1307,403,712,1343,530
36278,3514,1842,1672,651,867,324,410,836,426
36279,2480,1184,1296,288,724,172,391,695,210
36280,2995,1460,1535,444,704,312,419,737,379
36301,32319,15334,16985,5178,7727,2429,4770,8629,3586
36303,27698,13285,14413,4559,6781,1945,4205,7461,2747
36305,9805,4580,5225,1337,2660,583,1331,2850,1044
36310,6976,3391,3585,1053,1651,687,954,1661,970
36311,3108,1498,1610,498,772,228,434,803,373
36312,5704,2673,3031,822,1391,460,828,1536,667
36313,202,114,88,46,46,22,5,62,21
36314,626,277,349,88,151,38,133,174,42
36316,2032,979,1053,276,525,178,301,548,204
36317,545,290,255,114,129,47,76,123,56
36318,1205,536,669,148,251,137,182,298,189
36319,2345,1134,1211,388,550,196,369,584,258
36320,3270,1564,1706,473,841,250,517,858,331
36322,7739,3871,3868,1281,2046,544,1171,2096,601
36323,8582,4259,4323,1276,2228,755,1156,2125,1042
36330,28629,13824,14805,4391,7368,2065,4310,7569,2926
36340,5453,2604,2849,794,1314,496,744,1360,745
36343,1489,738,751,211,372,155,215,385,151
36344,5172,2545,2627,742,1247,556,576,1303,748
36345,6755,3218,3537,1072,1745,401,987,1828,722
36346,2045,1000,1045,338,519,143,312,553,180
36350,5264,2583,2681,889,1311,383,736,1499,446
36351,3195,1639,1556,593,814,232,403,789,364
36352,4292,2181,2111,710,1056,415,596,1083,432
36353,1738,807,931,257,393,157,226,438,267
36360,20621,9728,10893,3120,4909,1699,2910,5463,2520
36362,6090,3496,2594,1440,2052,4,1249,1331,14
36370,923,517,406,219,231,67,92,254,60
36371,710,347,363,105,187,55,91,198,74
36373,561,251,310,51,152,48,60,167,83
36374,960,459,501,131,257,71,131,250,120
36375,7390,3649,3741,1201,1842,606,1063,1941,737
36376,3173,1552,1621,515,829,208,438,856,327
36401,8583,3846,4737,1365,1810,671,1486,2278,973
36420,19954,9555,10399,3017,4659,1879,2799,4886,2714
36425,1335,658,677,290,250,118,204,321,152
36426,16074,7701,8373,2560,3817,1324,2267,4143,1963
36432,2831,1404,1427,447,692,265,439,685,303
36435,811,414,397,162,219,33,140,193,64
36436,445,167,278,45,109,13,98,139,41
36441,3586,1721,1865,544,898,279,472,989,404
36442,3327,1617,1710,459,765,393,429,802,479
36444,887,435,452,81,230,124,118,271,63
36445,5150,2456,2694,866,1243,347,940,1308,446
36446,769,353,416,153,149,51,142,205,69
36451,5651,2772,2879,970,1347,455,914,1362,603
36453,2517,1279,1238,365,722,192,267,676,295
36455,486,229,257,74,122,33,68,121,68
36456,2005,966,1039,287,470,209,240,492,307
36460,11874,5692,6182,2120,2656,916,1887,3009,1286
36467,9599,4436,5163,1323,2225,888,1428,2348,1387
36470,167,113,54,51,30,32,7,16,31
36471,1277,642,635,204,358,80,162,329,144
36473,77,46,31,12,26,8,0,22,9
36474,3106,1525,1581,472,775,278,479,705,397
36475,2535,1245,1290,395,654,196,355,638,297
36476,224,112,112,35,60,17,24,61,27
36477,4527,2184,2343,697,1048,439,644,1089,610
36480,1599,738,861,239,368,131,284,421,156
36481,591,248,343,151,63,34,149,131,63
36482,1074,472,602,184,204,84,195,273,134
36483,425,208,217,56,125,27,74,107,36
36501,571,300,271,153,115,32,82,166,23
36502,18754,9993,8761,2836,5833,1324,2678,4321,1762
36505,1074,561,513,217,264,80,165,300,48
36507,19184,9492,9692,3325,4802,1365,3056,4895,1741
36509,2638,1306,1332,519,620,167,516,570,246
36511,343,139,204,33,70,36,79,110,15
36513,503,243,260,99,125,19,133,98,29
36515,288,150,138,34,88,28,37,72,29
36518,3011,1449,1562,508,673,268,469,756,337
36521,4886,2416,2470,883,1242,291,841,1286,343
36522,6748,3322,3426,1308,1609,405,1101,1830,495
36523,3103,1614,1489,436,858,320,366,829,294
36524,1309,588,721,194,238,156,196,310,215
36525,2375,1174,1201,416,628,130,431,624,146
36526,19776,9729,10047,3064,5335,1330,2891,5690,1466
36527,7503,3607,3896,1168,1791,648,1115,1904,877
36528,1365,689,676,145,399,145,155,383,138
36529,639,305,334,120,129,56,104,141,89
36530,6368,3177,3191,1016,1618,543,908,1625,658
36532,22003,10284,11719,2956,5045,2283,2964,5720,3035
36535,17702,8494,9208,2449,4163,1882,2219,4588,2401
36538,562,286,276,134,121,31,85,150,41
36539,601,300,301,142,145,13,128,147,26
36540,522,232,290,94,119,19,131,109,50
36541,12798,6318,6480,2195,3305,818,2125,3369,986
36542,7787,3796,3991,838,1967,991,869,2028,1094
36544,11233,5606,5627,2195,2844,567,2094,2932,601
36545,8951,4162,4789,1452,2048,662,1538,2310,941
36548,1040,525,515,211,258,56,136,289,90
36549,4372,2134,2238,338,635,1161,303,801,1134
36550,273,125,148,19,88,18,25,80,43
36551,6203,3316,2887,1008,1828,480,860,1519,508
36553,3622,1747,1875,702,845,200,719,909,247
36556,276,122,154,39,26,57,37,77,40
36558,3862,1934,1928,660,996,278,523,1005,400
36559,404,151,253,32,63,56,56,107,90
36560,4822,2283,2539,729,1254,300,821,1230,488
36561,4414,2372,2042,521,1213,638,283,1178,581
36562,1654,805,849,267,449,89,305,446,98
36564,82,27,55,0,27,0,0,35,20
36567,10549,5170,5379,1833,2644,693,1804,2803,772
36569,1167,590,577,185,330,75,181,300,96
36570,463,215,248,57,141,17,61,119,68
36571,13436,6568,6868,1998,3493,1077,1905,3625,1338
36572,5809,2836,2973,909,1486,441,870,1584,519
36574,1156,607,549,161,355,91,145,335,69
36575,15139,7385,7754,2497,4105,783,2561,4263,930
36576,3369,1652,1717,521,832,299,536,902,279
36577,0,0,0,0,0,0,0,0,0
36578,491,268,223,87,133,48,26,112,85
36579,1924,930,994,326,405,199,276,563,155
36580,4711,2350,2361,825,1174,351,843,1138,380
36581,56,14,42,0,7,7,21,7,14
36582,20345,10006,10339,3409,5198,1399,3194,5468,1677
36583,485,244,241,94,106,44,65,116,60
36584,966,486,480,162,198,126,141,272,67
36585,1064,506,558,155,229,122,191,242,125
36587,8632,4449,4183,1532,2395,522,1318,2304,561
36602,917,501,416,112,251,138,91,157,168
36603,12686,5978,6708,2473,2773,732,2453,2949,1306
36604,11578,5505,6073,1777,3045,683,1943,3081,1049
36605,33578,15508,18070,6265,7141,2102,6266,8813,2991
36606,19012,8546,10466,2752,4696,1098,2971,5197,2298
36607,7743,3421,4322,1090,1738,593,1089,1996,1237
36608,37176,17365,19811,5794,8951,2620,6673,9353,3785
36609,23611,11120,12491,3518,6150,1452,3727,6829,1935
36610,19451,8657,10794,3762,3791,1104,3998,4793,2003
36611,6305,2897,3408,985,1312,600,853,1497,1058
36612,5153,2291,2862,908,1084,299,974,1430,458
36613,11767,5561,6206,1921,2928,712,2213,3159,834
36617,16168,7299,8869,2785,2986,1528,2674,3757,2438
36618,15611,7452,8159,2520,3823,1109,2436,4239,1484
36619,13309,6671,6638,2017,3647,1007,2012,3525,1101
36693,18287,8650,9637,2412,4374,1864,2610,4513,2514
36695,33474,16217,17257,5606,9120,1491,5648,9744,1865
36701,25626,11602,14024,4189,5525,1888,4524,6769,2731
36703,13646,6210,7436,2428,2953,829,2467,3481,1488
36720,839,393,446,186,146,61,184,181,81
36722,660,274,386,113,137,24,159,157,70
36723,381,176,205,91,61,24,40,105,60
36726,5755,2701,3054,993,1297,411,992,1357,705
36727,131,57,74,5,44,8,22,25,27
36728,446,198,248,81,69,48,83,118,47
36732,8895,4131,4764,1494,1960,677,1450,2335,979
36736,1437,699,738,273,334,92,192,364,182
36738,908,445,463,167,220,58,149,231,83
36740,1380,692,688,276,329,87,201,366,121
36742,2600,1242,1358,496,610,136,468,673,217
36744,8014,3863,4151,1571,1694,598,1308,1935,908
36748,4023,1854,2169,630,857,367,590,1003,576
36749,1185,574,611,207,222,145,139,340,132
36750,3159,1603,1556,571,795,237,478,794,284
36751,835,351,484,114,187,50,225,166,93
36752,1767,871,896,250,444,177,247,452,197
36754,476,221,255,110,97,14,112,110,33
36756,5832,2687,3145,1134,1046,507,1058,1366,721
36758,1653,794,859,277,430,87,286,427,146
36759,1826,809,1017,253,410,146,373,477,167
36761,1377,687,690,227,294,166,214,335,141
36763,122,60,62,0,38,22,7,17,38
36765,1461,683,778,280,282,121,351,342,85
36767,2181,1012,1169,415,431,166,377,548,244
36768,650,268,382,121,79,68,123,142,117
36769,3106,1529,1577,600,724,205,525,776,276
36773,672,302,370,150,103,49,138,154,78
36775,1338,606,732,243,270,93,210,352,170
36776,1864,799,1065,346,379,74,459,490,116
36779,590,293,297,71,161,61,65,155,77
36782,2530,1212,1318,402,553,257,374,628,316
36783,1146,493,653,188,198,107,191,301,161
36784,8505,4029,4476,1416,2021,592,1359,2234,883
36785,1494,672,822,243,296,133,275,407,140
36786,3817,1653,2164,734,679,240,805,940,419
36790,162,75,87,28,34,13,14,21,52
36792,784,389,395,69,239,81,92,200,103
36793,804,374,430,69,234,71,127,211,92
36801,20660,9488,11172,3260,4996,1232,3313,5710,2149
36804,15464,7721,7743,2712,4093,916,2626,4057,1060
36830,26695,13156,13539,4552,7336,1268,5064,6839,1636
36832,18887,10318,8569,5507,4404,407,4103,3750,716
36849,1982,259,1723,253,6,0,1700,23,0
36850,2958,1332,1626,378,741,213,448,788,390
36852,1978,958,1020,298,515,145,349,525,146
36853,8042,3999,4043,1206,1946,847,926,1994,1123
36854,14281,6781,7500,2097,3636,1048,2081,3743,1676
36855,1418,681,737,217,322,142,182,364,191
36856,1359,687,672,265,346,76,267,325,80
36858,391,187,204,85,79,23,58,100,46
36860,2075,966,1109,315,431,220,310,510,289
36861,3585,1775,1810,486,930,359,467,990,353
36862,7239,3460,3779,1173,1738,549,1104,1745,930
36863,13722,6362,7360,2095,3206,1061,2076,3655,1629
36866,3551,1670,1881,499,885,286,504,955,422
36867,19197,8753,10444,2942,4460,1351,3056,5243,2145
36869,19045,9234,9811,3125,4826,1283,3030,5086,1695
36870,11505,5675,5830,2056,3173,446,2003,3245,582
36871,1661,817,844,317,383,117,237,425,182
36874,6653,3189,3464,1001,1711,477,1088,1771,605
36875,5158,2539,2619,838,1327,374,796,1389,434
36877,10420,5041,5379,1558,2814,669,1718,2893,768
36879,1058,542,516,184,296,62,116,272,128
36901,582,289,293,139,105,45,111,101,81
36904,4747,2201,2546,702,1066,433,719,1227,600
36907,2324,1036,1288,402,474,160,409,635,244
36908,3094,1468,1626,419,769,280,401,860,365
36910,26,15,11,0,7,8,0,0,11
36912,2376,1079,1297,442,464,173,391,671,235
36915,894,453,441,156,222,75,121,234,86
36916,676,315,361,76,149,90,119,140,102
36919,2294,1059,1235,366,525,168,386,634,215
36921,632,295,337,61,187,47,90,192,55
36922,932,429,503,148,222,59,143,251,109
36925,3954,1701,2253,653,755,293,777,988,488
37010,2819,1421,1398,336,866,219,321,791,286
37012,1974,976,998,312,495,169,307,513,178
37013,51659,25515,26144,7622,16322,1571,7247,16808,2089
37014,1591,887,704,269,487,131,168,389,147
37015,16679,8343,8336,2636,4644,1063,2490,4518,1328
37016,550,245,305,54,142,49,77,166,62
37018,1632,809,823,250,390,169,198,433,192
37019,980,501,479,173,295,33,154,269,56
37020,3550,1724,1826,477,1041,206,557,993,276
37022,4428,2170,2258,696,1182,292,616,1267,375
37023,1589,757,832,251,426,80,309,402,121
37025,5173,2708,2465,841,1432,435,778,1274,413
37026,2028,977,1051,299,523,155,350,543,158
37027,35608,17478,18130,5876,9506,2096,5324,10337,2469
37028,625,276,349,84,143,49,111,177,61
37029,4203,1971,2232,614,1092,265,707,1191,334
37030,7067,3325,3742,1024,1809,492,1006,1880,856
37031,2645,1400,1245,424,789,187,323,732,190
37032,3430,1765,1665,605,867,293,480,865,320
37033,7346,3617,3729,1178,1764,675,903,1883,943
37034,4842,2436,2406,825,1321,290,739,1282,385
37035,3006,1460,1546,491,838,131,565,796,185
37036,5410,2731,2679,919,1396,416,778,1421,480
37037,4149,2059,2090,615,1251,193,671,1118,301
37040,30952,15156,15796,5422,8233,1501,5289,8329,2178
37042,53757,26909,26848,10305,15032,1572,10020,14809,2019
37043,31945,15617,16328,5098,8402,2117,4519,8682,3127
37046,3179,1569,1610,491,861,217,475,871,264
37047,2361,1223,1138,471,572,180,307,619,212
37048,5100,2547,2553,758,1462,327,763,1330,460
37049,2759,1376,1383,444,756,176,431,775,177
37050,1737,840,897,242,447,151,281,425,191
37051,3100,1560,1540,492,802,266,417,868,255
37052,2476,1330,1146,483,694,153,332,625,189
37055,24427,11742,12685,4007,6177,1558,3803,6518,2364
37057,1072,576,496,227,280,69,182,237,77
37058,6545,3197,3348,878,1676,643,821,1688,839
37059,1524,728,796,184,433,111,221,400,175
37060,1765,805,960,262,389,154,282,516,162
37061,4905,2442,2463,804,1158,480,650,1191,622
37062,9103,4420,4683,1529,2290,601,1484,2571,628
37064,37226,18123,19103,6139,10152,1832,5819,10612,2672
37066,34412,16696,17716,5509,8751,2436,4993,9349,3374
37067,15424,7639,7785,2398,4690,551,2135,4989,661
37069,16372,7932,8440,2937,4262,733,2890,4680,870
37072,26207,12618,13589,3792,6865,1961,3554,7501,2534
37073,11471,5734,5737,1967,3107,660,1667,3236,834
37074,6245,3134,3111,1057,1601,476,837,1582,692
37075,48687,23781,24906,7875,13030,2876,7266,13803,3837
37076,29559,14054,15505,4028,8489,1537,4095,9068,2342
37078,762,371,391,132,219,20,149,219,23
37079,2550,1318,1232,362,746,210,340,668,224
37080,7370,3612,3758,1147,1909,556,1206,2008,544
37082,5789,2851,2938,932,1669,250,885,1747,306
37083,12471,6140,6331,1954,3231,955,1805,3254,1272
37085,2760,1295,1465,335,795,165,497,799,169
37086,18977,9337,9640,3340,5361,636,3391,5561,688
37087,31874,15436,16438,4983,8349,2104,4803,8327,3308
37090,11755,5745,6010,1665,3327,753,1726,3342,942
37091,18951,9233,9718,2806,5060,1367,2707,5127,1884
37095,2070,1018,1052,326,567,125,296,560,196
37096,5537,2697,2840,714,1446,537,773,1380,687
37097,2015,1042,973,389,480,173,250,549,174
37098,4555,2289,2266,807,1215,267,724,1147,395
37101,5897,2919,2978,928,1565,426,839,1559,580
37110,31288,15235,16053,4436,8326,2473,4398,8137,3518
37115,35063,16671,18392,5125,9154,2392,4653,9619,4120
37118,1238,524,714,197,256,71,303,346,65
37122,32505,16113,16392,5413,9019,1681,5087,9395,1910
37127,11883,5822,6061,1881,3332,609,1941,3373,747
37128,17989,8973,9016,3155,5209,609,3061,5224,731
37129,38394,19356,19038,6297,10894,2165,6010,10628,2400
37130,43607,22008,21599,8217,11752,2039,7793,10427,3379
37134,3016,1496,1520,462,787,247,421,790,309
37135,4467,2310,2157,920,1173,217,771,1207,179
37137,2189,1167,1022,396,622,149,366,494,162
37138,22007,10819,11188,3190,6183,1446,3008,6382,1798
37140,1247,1168,79,64,1083,21,11,54,14
37141,914,429,485,130,240,59,134,264,87
37142,1589,774,815,204,417,153,258,380,177
37143,4150,2071,2079,675,1168,228,573,1234,272
37144,3402,1635,1767,467,901,267,547,863,357
37145,1835,864,971,249,410,205,287,449,235
37146,4309,2178,2131,764,1256,158,664,1303,164
37147,690,342,348,125,175,42,132,132,84
37148,17105,8347,8758,2819,4444,1084,2758,4527,1473
37149,2042,962,1080,344,526,92,365,524,191
37150,4744,2251,2493,711,1187,353,738,1179,576
37151,533,301,232,86,171,44,53,137,42
37152,33,22,11,13,9,0,4,7,0
37153,4782,2386,2396,858,1289,239,934,1239,223
37160,27328,13519,13809,4502,7007,2010,4121,6844,2844
37166,12424,6108,6316,1917,3093,1098,1733,3200,1383
37167,34775,17261,17514,6107,9787,1367,5777,9910,1827
37171,910,453,457,111,233,109,121,239,97
37172,24864,12157,12707,4029,6393,1735,3869,6324,2514
37174,7778,3943,3835,1366,2256,321,1252,2260,323
37175,1095,551,544,168,233,150,134,289,121
37178,1769,845,924,226,460,159,258,482,184
37179,6553,3238,3315,1102,1859,277,1083,1924,308
37180,2410,1273,1137,501,594,178,351,608,178
37181,1639,771,868,228,405,138,240,447,181
37183,2663,1341,1322,418,748,175,393,659,270
37184,5584,2837,2747,938,1495,404,767,1522,458
37185,8353,4131,4222,1217,2042,872,956,2175,1091
37186,8968,4437,4531,1542,2300,595,1458,2341,732
37187,5684,2877,2807,991,1499,387,787,1572,448
37188,10454,5358,5096,2094,2859,405,1647,2923,526
37189,2303,1109,1194,351,556,202,293,613,288
37190,7982,3977,4005,1227,2072,678,1065,1955,985
37191,3911,1998,1913,734,1085,179,634,1069,210
37201,1052,890,162,139,735,16,14,141,7
37203,12770,5978,6792,2061,3177,740,2541,3033,1218
37204,10400,4725,5675,974,2995,756,1174,3106,1395
37205,21630,9891,11739,2259,5451,2181,2347,6350,3042
37206,27805,13393,14412,4970,6936,1487,4479,7543,2390
37207,35994,16801,19193,6851,8113,1837,6302,10147,2744
37208,15241,7008,8233,2606,3360,1042,2466,4106,1661
37209,35192,18098,17094,5463,10784,1851,5799,8578,2717
37210,16409,8020,8389,2811,4304,905,2746,4139,1504
37211,64622,32251,32371,9242,20031,2978,8449,18869,5053
37212,18881,9267,9614,3575,5053,639,3983,4590,1041
37213,123,111,12,45,66,0,12,0,0
37214,26474,12794,13680,3182,7828,1784,2959,8105,2616
37215,22319,10386,11933,2776,5711,1899,2823,6256,2854
37216,18962,8854,10108,2704,4834,1316,2857,5172,2079
37217,28208,14755,13453,4179,9259,1317,3437,8287,1729
37218,15045,6663,8382,2202,3309,1152,1955,4472,1955
37219,900,673,227,72,592,9,17,191,19
37220,6241,3008,3233,851,1485,672,763,1635,835
37221,34932,16632,18300,4653,9979,2000,4439,11092,2769
37228,308,58,250,0,0,58,5,68,177
37301,1664,837,827,275,431,131,287,433,107
37302,2515,1181,1334,316,664,201,334,731,269
37303,23686,11150,12536,3510,5872,1768,3714,6059,2763
37305,753,383,370,122,184,77,109,170,91
37306,2385,1211,1174,421,616,174,348,632,194
37307,4922,2405,2517,673,1297,435,672,1355,490
37308,2490,1250,1240,451,652,147,427,634,179
37309,2133,1094,1039,368,529,197,296,548,195
37310,3385,1679,1706,431,1000,248,514,900,292
37311,24513,11778,12735,4131,6088,1559,3951,6305,2479
37312,28111,13563,14548,4243,7120,2200,3819,7734,2995
37313,1409,661,748,191,384,86,242,364,142
37316,145,72,73,21,30,21,6,57,10
37317,2482,1222,1260,355,623,244,273,629,358
37318,1916,885,1031,269,448,168,326,461,244
37321,16151,7777,8374,2508,4112,1157,2619,4195,1560
37322,7758,3924,3834,1207,2097,620,987,2134,713
37323,26309,12908,13401,4247,6959,1702,3877,7511,2013
37324,5055,2456,2599,703,1309,444,731,1291,577
37325,1718,844,874,237,521,86,240,431,203
37326,636,253,383,31,105,117,53,131,199
37327,8904,4478,4426,1420,2353,705,1166,2398,862
37328,1291,614,677,156,342,116,167,363,147
37329,5108,2515,2593,768,1279,468,669,1326,598
37330,6525,3283,3242,982,1737,564,913,1723,606
37331,8132,3846,4286,1095,2028,723,1049,2112,1125
37332,2252,1094,1158,324,594,176,342,618,198
37333,679,337,342,108,155,74,112,144,86
37334,19876,9412,10464,2759,4758,1895,2716,5076,2672
37335,2854,1408,1446,488,768,152,462,765,219
37336,3398,1690,1708,433,1025,232,593,911,204
37337,1494,821,673,291,413,117,191,394,88
37338,2491,1271,1220,384,716,171,338,672,210
37339,2010,990,1020,313,516,161,336,510,174
37340,726,363,363,76,224,63,78,191,94
37341,11714,5788,5926,1735,3392,661,1724,3407,795
37342,3023,1536,1487,486,807,243,427,801,259
37343,37305,18213,19092,5655,9869,2689,5334,10480,3278
37345,2149,1056,1093,299,566,191,281,520,292
37347,7664,3666,3998,1069,2003,594,1194,2007,797
37348,974,523,451,166,284,73,138,243,70
37350,2087,1023,1064,348,477,198,284,497,283
37351,293,120,173,46,64,10,63,98,12
37352,2948,1327,1621,383,648,296,403,782,436
37353,3747,2016,1731,581,1118,317,390,1018,323
37354,14023,7048,6975,2311,3730,1007,1989,3598,1388
37355,22387,10876,11511,3237,5799,1840,3335,5791,2385
37356,2401,1149,1252,340,572,237,357,585,310
37357,4997,2507,2490,767,1355,385,743,1330,417
37359,605,290,315,68,150,72,86,145,84
37360,1680,785,895,192,426,167,306,428,161
37361,1445,725,720,241,392,92,205,420,95
37362,2878,1502,1376,406,912,184,373,788,215
37363,24208,11936,12272,4045,6248,1643,3792,6528,1952
37365,1530,742,788,217,393,132,212,391,185
37366,813,417,396,127,202,88,91,205,100
37367,10029,5512,4517,1497,3246,769,1210,2399,908
37369,919,468,451,86,266,116,122,255,74
37370,3801,1978,1823,594,1090,294,427,1135,261
37373,2563,1249,1314,352,696,201,335,766,213
37374,1762,865,897,324,449,92,256,508,133
37375,3710,1763,1947,775,751,237,976,624,347
37376,501,255,246,36,164,55,47,139,60
37377,14569,6989,7580,2164,3542,1283,2041,3851,1688
37379,23441,11285,12156,3265,6355,1665,3514,6590,2052
37380,6227,3009,3218,971,1550,488,793,1679,746
37381,7819,3805,4014,1006,1931,868,916,2030,1068
37385,7738,3880,3858,1266,2075,539,1074,2059,725
37387,4018,1941,2077,615,984,342,565,1057,455
37388,23989,11693,12296,3866,5686,2141,3454,6030,2812
37391,1328,710,618,168,412,130,159,303,156
37394,56,25,31,4,15,6,7,18,6
37396,361,186,175,76,96,14,50,93,32
37397,9838,4835,5003,1549,2585,701,1413,2664,926
37398,14018,6650,7368,1901,3434,1315,2045,3537,1786
37402,4206,2009,2197,558,1120,331,467,949,781
37403,4096,1938,2158,839,889,210,1121,792,245
37404,13861,6723,7138,2342,3526,855,2153,3336,1649
37405,12977,6304,6673,1531,3884,889,1519,3695,1459
37406,14850,6597,8253,2631,3031,935,2714,4116,1423
37407,7737,3583,4154,1166,1870,547,1293,1956,905
37408,1974,1011,963,480,406,125,389,437,137
37409,2788,1343,1445,444,722,177,384,787,274
37410,4738,2069,2669,939,827,303,1042,1123,504
37411,17329,7932,9397,2508,4259,1165,2297,5006,2094
37412,20603,9677,10926,2582,5252,1843,2480,5482,2964
37415,23179,10973,12206,2747,6245,1981,2632,6290,3284
37416,14701,6984,7717,2083,3839,1062,2036,4082,1599
37419,5486,2703,2783,708,1445,550,643,1419,721
37421,40714,19737,20977,5554,11010,3173,5030,11246,4701
37601,33458,15853,17605,4594,8697,2562,4597,9147,3861
37604,31603,15250,16353,4192,8415,2643,4092,8289,3972
37614,2056,966,1090,675,285,6,882,203,5
37615,16309,8059,8250,2229,4815,1015,2122,4809,1319
37616,4350,2258,2092,619,1244,395,441,1248,403
37617,13184,6740,6444,1776,3975,989,1495,3678,1271
37618,12473,6174,6299,1830,3461,883,1823,3367,1109
37620,39138,18892,20246,5131,10172,3589,5120,10166,4960
37640,3709,1820,1889,500,987,333,475,936,478
37641,7114,3492,3622,1013,1909,570,914,1954,754
37642,13932,6780,7152,1918,3768,1094,1865,4010,1277
37643,33540,16077,17463,4567,8565,2945,4226,8953,4284
37645,4887,2424,2463,611,1391,422,609,1367,487
37650,12546,5996,6550,1528,3177,1291,1461,3268,1821
37656,3654,1807,1847,464,1034,309,470,1001,376
37657,832,399,433,92,226,81,99,214,120
37658,4388,2131,2257,537,1227,367,528,1269,460
37659,22354,11139,11215,3176,6176,1787,2844,6397,1974
37660,40790,19171,21619,5370,10126,3675,5353,10815,5451
37663,13991,6797,7194,1846,3670,1281,1823,3873,1498
37664,26285,12166,14119,3314,6619,2233,3423,6984,3712
37665,4381,2046,2335,481,1090,475,488,1136,711
37680,638,331,307,81,165,85,99,151,57
37681,5782,2850,2932,807,1646,397,686,1644,602
37683,12217,6747,5470,1455,4189,1103,1175,2998,1297
37684,401,393,8,0,187,206,0,0,8
37686,6304,3127,3177,806,1686,635,803,1830,544
37687,5266,2695,2571,645,1557,493,734,1274,563
37688,1043,527,516,105,226,196,51,267,198
37690,3017,1587,1430,463,944,180,417,840,173
37691,1045,468,577,147,276,45,203,282,92
37692,4419,2204,2215,615,1229,360,544,1235,436
37694,1464,742,722,205,433,104,163,415,144
37701,6194,2867,3327,736,1488,643,785,1647,895
37705,4071,1975,2096,576,1053,346,576,1052,468
37708,6440,3235,3205,925,1805,505,907,1757,541
37709,3278,1685,1593,523,929,233,444,860,289
37710,1480,790,690,235,458,97,202,400,88
37711,4299,2164,2135,666,1191,307,572,1169,394
37713,1420,713,707,203,372,138,191,331,185
37714,4244,2113,2131,575,1179,359,613,1159,359
37715,1096,545,551,182,291,72,165,289,97
37716,24314,11782,12532,3450,6419,1913,3261,6499,2772
37719,103,63,40,15,48,0,22,18,0
37721,10142,4862,5280,1402,2698,762,1532,2877,871
37722,5178,2483,2695,732,1314,437,843,1401,451
37723,799,379,420,102,208,69,126,199,95
37724,3153,1528,1625,491,776,261,405,877,343
37725,12585,6278,6307,1866,3211,1201,1526,3487,1294
37726,1613,798,815,223,404,171,219,425,171
37727,2178,1109,1069,306,637,166,256,600,213
37729,1666,818,848,320,412,86,255,434,159
37730,31,17,14,5,9,3,0,6,8
37731,875,442,433,133,218,91,118,211,104
37732,201,120,81,19,88,13,5,57,19
37737,4782,2387,2395,692,1297,398,614,1356,425
37738,5208,2520,2688,488,1461,571,548,1434,706
37742,4568,2236,2332,648,1243,345,713,1248,371
37743,23782,11472,12310,3244,6027,2201,2993,6256,3061
37744,409,215,194,7,183,25,0,135,59
37745,16759,8112,8647,2477,4111,1524,2247,4391,2009
37748,17891,8659,9232,2479,4506,1674,2181,4743,2308
37752,5213,2556,2657,765,1369,422,730,1404,523
37753,875,465,410,162,242,61,75,265,70
37754,4545,2238,2307,701,1244,293,675,1312,320
37755,3413,1727,1686,625,873,229,544,904,238
37756,2828,1433,1395,437,779,217,410,699,286
37757,8977,4365,4612,1253,2381,731,1271,2377,964
37760,12279,5770,6509,1926,2868,976,2083,3046,1380
37762,3391,1616,1775,497,835,284,414,888,473
37763,14990,7467,7523,2185,3963,1319,1666,4105,1752
37764,8225,3926,4299,1135,2171,620,1290,2305,704
37765,524,281,243,110,117,54,47,131,65
37766,18059,8527,9532,2386,4443,1698,2452,4675,2405
37769,6085,2904,3181,787,1510,607,811,1563,807
37770,2686,1324,1362,414,697,213,438,676,248
37771,12735,6040,6695,1857,3259,924,1914,3434,1347
37772,8839,4416,4423,1225,2448,743,1017,2452,954
37774,14503,7044,7459,1609,3544,1891,1535,3660,2264
37777,11104,5641,5463,1599,3355,687,1341,3329,793
37779,3364,1633,1731,589,855,189,519,957,255
37801,19495,9237,10258,2782,4973,1482,2855,5313,2090
37803,27362,13225,14137,3932,7080,2213,3616,7450,3071
37804,22033,10520,11513,3309,5429,1782,3142,5733,2638
37806,2789,1375,1414,446,699,230,399,696,319
37807,9625,4762,4863,1588,2626,548,1480,2602,781
37809,2048,970,1078,287,458,225,303,476,299
37810,1818,897,921,263,537,97,301,476,144
37811,2748,1378,1370,385,756,237,325,802,243
37813,16780,8115,8665,2567,4387,1161,2411,4423,1831
37814,30490,15219,15271,4549,8147,2523,3967,7991,3313
37818,4604,2301,2303,682,1282,337,648,1222,433
37819,803,413,390,148,184,81,138,175,77
37820,6669,3360,3309,1033,1813,514,897,1813,599
37821,21903,10471,11432,2904,5762,1805,3054,5934,2444
37825,7807,3873,3934,1251,1956,666,1001,2042,891
37826,3647,1795,1852,480,1017,298,536,1003,313
37828,1411,654,757,162,329,163,175,367,215
37829,1559,819,740,264,429,126,183,429,128
37830,27236,12707,14529,3703,6063,2941,3477,6855,4197
37840,11020,5382,5638,1621,2840,921,1683,2934,1021
37841,8785,4274,4511,1421,2256,597,1285,2353,873
37843,2917,1442,1475,438,723,281,402,758,315
37845,632,310,322,88,152,70,59,156,107
37846,4514,2301,2213,769,1234,298,786,1162,265
37847,2696,1256,1440,372,730,154,435,735,270
37848,228,93,135,11,50,32,7,92,36
37849,21739,10568,11171,3420,5699,1449,3081,6052,2038
37852,2695,1400,1295,505,740,155,421,670,204
37853,3533,1731,1802,466,989,276,461,1029,312
37854,11855,5575,6280,1620,2867,1088,1491,3227,1562
37857,19957,9642,10315,2826,5186,1630,2691,5243,2381
37860,3401,1814,1587,642,919,253,425,925,237
37861,7010,3496,3514,968,1875,653,792,1986,736
37862,17865,8573,9292,2589,4516,1468,2345,4897,2050
37863,5375,2464,2911,749,1321,394,744,1585,582
37865,16851,8284,8567,2520,4562,1202,2337,4704,1526
37866,1519,794,725,205,364,225,145,376,204
37869,4763,2280,2483,614,1247,419,692,1224,567
37870,4596,2292,2304,624,1199,469,633,1153,518
37871,8432,4270,4162,1312,2347,611,1135,2279,748
37872,2080,1057,1023,351,569,137,320,570,133
37873,4201,2091,2110,537,1201,353,557,1138,415
37874,12739,6074,6665,1860,3124,1090,1712,3489,1464
37876,19738,9995,9743,3034,5456,1505,2556,5660,1527
37877,8148,4087,4061,1203,2228,656,1096,2121,844
37878,478,252,226,50,146,56,43,165,18
37879,9943,4736,5207,1322,2616,798,1461,2697,1049
37880,3085,1489,1596,434,787,268,458,810,328
37881,2005,1038,967,302,569,167,244,554,169
37882,2438,1182,1256,329,580,273,288,612,356
37885,3938,1994,1944,541,1064,389,531,1072,341
37886,3738,1939,1799,571,1044,324,409,1059,331
37887,6727,3962,2765,921,2646,395,824,1359,582
37888,2707,1317,1390,354,743,220,396,726,268
37890,5686,2833,2853,887,1458,488,742,1534,577
37891,3211,1620,1591,462,863,295,392,889,310
37892,1817,896,921,276,514,106,313,479,129
37902,1168,672,496,83,487,102,32,279,185
37909,13086,6181,6905,1590,3661,930,1716,3595,1594
37912,18482,8865,9617,2415,5041,1409,2249,5196,2172
37914,20188,9512,10676,3108,4701,1703,2581,5344,2751
37915,5290,2247,3043,954,1045,248,1039,1550,454
37916,11703,6103,5600,3820,2113,170,4388,1066,146
37917,24892,11988,12904,3348,6825,1815,2680,6643,3581
37918,36689,17504,19185,5241,9624,2639,4904,10094,4187
37919,27531,13177,14354,3482,7775,1920,3281,7804,3269
37920,37641,18406,19235,5434,10075,2897,5031,10012,4192
37921,26625,12505,14120,4368,6615,1522,4173,7687,2260
37922,45667,22450,23217,7467,12323,2660,6942,13212,3063
37923,25837,12540,13297,3439,7534,1567,3424,7972,1901
37924,9081,4410,4671,1080,2508,822,1065,2511,1095
37931,18200,8863,9337,2572,5154,1137,2567,5297,1473
37932,11113,5548,5565,1774,3166,608,1558,3390,617
37938,13846,6762,7084,2005,3592,1165,1945,3980,1159
38001,4515,2034,2481,594,1043,397,782,1057,642
38002,17217,8515,8702,2713,4789,1013,2520,5092,1090
38004,11892,5949,5943,2176,3194,579,1901,3327,715
38006,5008,2503,2505,843,1253,407,620,1280,605
38008,10659,5010,5649,1920,2346,744,1671,2805,1173
38011,8484,4076,4408,1351,2169,556,1359,2328,721
38012,15064,6896,8168,2477,3388,1031,2525,3993,1650
38015,2729,1354,1375,450,720,184,414,718,243
38017,36098,17842,18256,6619,9701,1522,6222,9981,2053
38018,52785,25592,27193,7971,15372,2249,7379,16508,3306
38019,15527,7281,8246,2738,3489,1054,2599,3991,1656
38021,57,26,31,4,16,6,7,18,6
38023,2554,1279,1275,505,611,163,498,587,190
38024,28060,13397,14663,4380,7033,1984,4294,7378,2991
38028,4826,2415,2411,720,1355,340,635,1368,408
38030,159,69,90,6,43,20,12,61,17
38034,3305,1697,1608,536,861,300,444,805,359
38036,350,163,187,62,56,45,56,81,50
38037,1920,857,1063,299,419,139,294,495,274
38039,2038,980,1058,426,413,141,374,529,155
38040,5393,2633,2760,835,1405,393,787,1465,508
38041,4910,3562,1348,589,2768,205,453,648,247
38042,1036,482,554,171,237,74,191,266,97
38044,830,404,426,48,249,107,141,225,60
38046,133,71,62,19,31,21,11,32,19
38047,38,18,20,0,18,0,0,10,10
38049,4859,2662,2197,896,1500,266,674,1134,389
38050,416,190,226,48,99,43,63,99,64
38052,3651,1775,1876,592,859,324,610,878,388
38053,28183,13938,14245,4670,7428,1840,4467,7630,2148
38057,3719,1710,2009,582,870,258,735,960,314
38058,3944,1917,2027,835,860,222,714,1144,169
38059,6586,3117,3469,997,1641,479,1018,1739,712
38060,3999,1928,2071,574,1051,303,595,1118,358
38061,1045,533,512,112,306,115,123,284,105
38063,16792,7927,8865,2786,3994,1147,2699,4595,1571
38066,2096,976,1120,285,537,154,323,581,216
38067,1268,616,652,139,299,178,169,316,167
38068,9866,4855,5011,1645,2410,800,1407,2534,1070
38069,2514,1242,1272,431,574,237,333,664,275
38075,6727,4984,1743,831,3898,255,570,862,311
38076,483,184,299,43,99,42,117,112,70
38079,5701,3748,1953,815,2565,368,531,943,479
38080,2816,1337,1479,471,643,223,387,669,423
38103,7563,4674,2889,556,3824,294,309,2019,561
38104,24743,12174,12569,2664,8249,1261,2771,7425,2373
38105,9007,4248,4759,1558,2329,361,1545,2502,712
38106,33958,15346,18612,6006,6827,2513,6097,8094,4421
38107,22260,10385,11875,4118,4903,1364,3982,5714,2179
38108,22366,10724,11642,3882,5283,1559,3567,5478,2597
38109,52306,23864,28442,9559,11220,3085,9383,13944,5115
38111,45105,20929,24176,7282,11334,2313,7073,12229,4874
38112,19216,8907,10309,3316,4725,866,3682,5036,1591
38114,34064,15288,18776,6049,7172,2067,6263,9044,3469
38115,40281,19241,21040,6485,11417,1339,6332,12210,2498
38116,51040,23399,27641,10279,11474,1646,10235,14742,2664
38117,25155,11529,13626,2970,5932,2627,2748,6279,4599
38118,47459,22754,24705,10240,10893,1621,9182,13235,2288
38119,22091,10449,11642,2730,5979,1740,2612,6238,2792
38120,13693,6478,7215,1560,3383,1535,1679,3617,1919
38122,24720,12072,12648,3629,6690,1753,3424,6397,2827
38125,24083,11626,12457,4014,6771,841,4000,7487,970
38126,8031,3766,4265,2015,1455,296,1904,1851,510
38127,51174,23555,27619,10751,10663,2141,10900,13577,3142
38128,43852,20446,23406,8298,10180,1968,8114,12108,3184
38131,0,0,0,0,0,0,0,0,0
38132,111,85,26,6,73,6,0,26,0
38133,18911,9173,9738,3242,5271,660,3402,5503,833
38134,41866,21734,20132,6235,13419,2080,5614,11706,2812
38135,24695,12055,12640,4511,6345,1199,3988,7051,1601
38138,23048,11181,11867,3464,6022,1695,3301,6605,1961
38139,14452,7085,7367,2621,3765,699,2504,4134,729
38141,21869,10557,11312,4134,5938,485,3944,6738,630
38157,95,90,5,78,7,5,0,5,0
38201,9794,4610,5184,1302,2394,914,1463,2548,1173
38220,2135,984,1151,340,498,146,321,604,226
38221,3297,1628,1669,416,851,361,402,833,434
38222,2221,1129,1092,299,551,279,214,619,259
38224,1108,566,542,215,262,89,205,275,62
38225,6372,3048,3324,849,1608,591,795,1625,904
38226,398,192,206,40,119,33,50,119,37
38229,2962,1462,1500,528,709,225,438,769,293
38230,3976,1897,2079,604,973,320,604,986,489
38231,2112,1037,1075,354,520,163,374,535,166
38232,2219,1135,1084,330,593,212,300,578,206
38233,2967,1446,1521,404,735,307,390,795,336
38235,188,92,96,23,43,26,17,39,40
38236,649,319,330,61,214,44,94,176,60
38237,15824,7733,8091,2904,3770,1059,2823,3742,1526
38240,2383,1189,1194,362,582,245,308,601,285
38241,927,465,462,132,250,83,158,195,109
38242,18938,8969,9969,2594,4475,1900,2382,4766,2821
38251,2756,1417,1339,438,709,270,317,700,322
38253,1133,552,581,130,317,105,148,283,150
38255,2315,1164,1151,356,563,245,245,557,349
38256,3064,1522,1542,317,748,457,314,747,481
38257,4904,2370,2534,676,1203,491,645,1348,541
38258,1649,771,878,253,373,145,206,419,253
38259,972,489,483,150,282,57,136,273,74
38260,3734,1847,1887,564,995,288,540,977,370
38261,16997,8125,8872,2555,4256,1314,2399,4361,2112
38301,39751,18652,21099,6710,9034,2908,6593,10001,4505
38305,40792,19558,21234,6594,10610,2354,6511,11481,3242
38310,5557,2664,2893,737,1376,551,759,1376,758
38311,952,512,440,130,303,79,95,258,87
38313,3005,1532,1473,457,897,178,370,856,247
38315,3659,1829,1830,594,958,277,527,952,351
38316,2937,1416,1521,435,741,240,409,759,353
38317,2681,1260,1421,328,585,347,330,664,427
38318,555,266,289,80,149,37,96,114,79
38320,10783,5126,5657,1376,2606,1144,1415,2658,1584
38321,2019,964,1055,192,572,200,253,516,286
38326,2423,1215,1208,283,666,266,277,647,284
38327,468,221,247,60,105,56,51,113,83
38328,745,338,407,85,185,68,94,187,126
38329,3140,1534,1606,441,703,390,415,778,413
38330,4465,2059,2406,612,1027,420,603,1144,659
38332,1318,687,631,225,341,121,185,311,135
38333,565,263,302,60,175,28,70,168,64
38334,1939,904,1035,302,464,138,380,540,115
38337,1505,734,771,164,406,164,231,392,148
38339,612,298,314,90,155,53,67,185,62
38340,11623,5524,6099,2069,2638,817,2082,2739,1278
38341,2267,1161,1106,337,594,230,350,543,213
38342,1656,824,832,247,426,151,232,429,171
38343,16317,7856,8461,2570,3848,1438,2328,4098,2035
38344,9266,4399,4867,1338,2258,803,1355,2371,1141
38345,1866,957,909,271,510,176,251,456,202
38347,368,195,173,58,105,32,33,105,35
38348,1328,684,644,219,371,94,169,379,96
38351,16237,7758,8479,2483,4072,1203,2248,4529,1702
38352,427,220,207,70,100,50,62,95,50
38355,2497,1257,1240,382,650,225,369,671,200
38356,2410,1194,1216,383,637,174,394,631,191
38357,2651,1322,1329,373,726,223,351,669,309
38358,11950,5513,6437,1744,2755,1014,1738,3042,1657
38359,272,140,132,30,67,43,36,54,42
38361,959,462,497,171,232,59,172,234,91
38362,864,449,415,158,260,31,136,243,36
38363,5935,2838,3097,766,1448,624,701,1474,922
38366,2143,1098,1045,372,546,180,259,598,188
38367,2662,1300,1362,357,728,215,405,705,252
38368,1850,895,955,256,468,171,291,434,230
38369,1987,901,1086,231,477,193,319,498,269
38370,624,283,341,47,162,74,46,198,97
38371,1553,751,802,233,369,149,231,379,192
38372,17182,8308,8874,2535,4324,1449,2277,4537,2060
38374,1553,728,825,158,398,172,226,372,227
38375,8836,4368,4468,1369,2163,836,1164,2149,1155
38376,485,289,196,85,149,55,37,125,34
38378,93,37,56,0,15,22,12,39,5
38379,1032,497,535,148,246,103,126,273,136
38380,436,251,185,73,134,44,44,90,51
38381,1496,743,753,243,395,105,185,404,164
38382,9772,4754,5018,1437,2432,885,1246,2493,1279
38387,375,198,177,60,116,22,56,95,26
38388,1797,887,910,287,454,146,250,496,164
38390,904,416,488,134,214,68,126,257,105
38391,1222,573,649,209,276,88,224,258,167
38392,852,384,468,127,175,82,179,198,91
38401,50469,24349,26120,8200,12837,3312,7726,13464,4930
38425,3597,2750,847,370,2109,271,209,440,198
38449,2658,1335,1323,354,703,278,284,663,376
38450,2854,1372,1482,409,743,220,475,728,279
38451,4228,2121,2107,760,1164,197,746,1136,225
38452,968,452,516,128,257,67,149,279,88
38453,237,126,111,45,63,18,24,70,17
38454,1145,540,605,132,312,96,169,301,135
38456,4187,2081,2106,855,927,299,807,991,308
38457,842,413,429,118,258,37,123,226,80
38459,442,227,215,85,128,14,76,105,34
38460,1335,681,654,237,319,125,160,341,153
38461,1124,523,601,166,290,67,164,337,100
38462,9815,4838,4977,1598,2460,780,1427,2444,1106
38463,2794,1447,1347,533,692,222,400,706,241
38464,22070,10563,11507,3301,5383,1879,3074,5480,2953
38468,4402,2185,2217,686,1131,368,658,1117,442
38469,4035,1970,2065,631,1013,326,642,949,474
38471,642,291,351,47,165,79,71,190,90
38472,2761,1416,1345,420,764,232,374,721,250
38473,1123,541,582,166,284,91,183,285,114
38474,6792,3184,3608,937,1780,467,1034,1766,808
38475,604,288,316,84,167,37,136,130,50
38476,1102,561,541,152,340,69,157,337,47
38477,3017,1499,1518,494,790,215,435,832,251
38478,17901,8481,9420,2595,4486,1400,2699,4519,2202
38481,1029,481,548,157,254,70,163,287,98
38482,1360,679,681,207,369,103,240,347,94
38483,4585,2280,2305,794,1189,297,745,1188,372
38485,6546,3141,3405,949,1536,656,877,1605,923
38486,843,468,375,143,261,64,96,216,63
38487,960,439,521,98,243,98,183,246,92
38488,2294,1159,1135,375,646,138,390,599,146
38501,32895,16419,16476,5490,8741,2188,5205,7996,3275
38504,863,454,409,185,208,61,80,236,93
38506,22496,11040,11456,3371,6072,1597,3105,6181,2170
38541,1364,694,670,174,371,149,204,283,183
38542,53,29,24,13,7,9,0,7,17
38543,540,286,254,58,168,60,56,125,73
38544,5857,2882,2975,826,1559,497,841,1494,640
38545,1225,596,629,187,328,81,207,325,97
38547,1414,701,713,258,344,99,188,370,155
38548,596,296,300,80,144,72,60,161,79
38549,3648,1804,1844,534,845,425,451,871,522
38551,4121,1879,2242,431,1061,387,575,1128,539
38552,557,295,262,85,163,47,62,156,44
38553,2065,976,1089,293,546,137,307,604,178
38554,989,462,527,132,271,59,193,276,58
38555,32252,15527,16725,4509,7537,3481,4373,8203,4149
38556,11974,5815,6159,1732,3063,1020,1658,3109,1392
38558,9664,4746,4918,909,1651,2186,776,1934,2208
38559,1197,615,582,169,309,137,132,322,128
38560,1346,685,661,240,317,128,184,330,147
38562,6477,3182,3295,912,1693,577,920,1624,751
38563,2043,1019,1024,393,487,139,314,551,159
38564,433,195,238,28,94,73,16,102,120
38565,479,254,225,104,113,37,83,121,21
38567,716,399,317,77,241,81,56,169,92
38568,1754,901,853,256,458,187,188,476,189
38569,439,231,208,88,116,27,57,102,49
38570,9724,4734,4990,1433,2387,914,1290,2530,1170
38573,2036,1011,1025,293,515,203,306,498,221
38574,7557,3829,3728,1257,1909,663,1135,1819,774
38575,1125,540,585,124,296,120,207,253,125
38577,1192,579,613,153,287,139,171,323,119
38579,1012,558,454,187,260,111,122,239,93
38580,901,429,472,118,259,52,102,254,116
38581,4076,2104,1972,649,1188,267,593,1089,290
38582,1321,695,626,207,386,102,114,365,147
38583,21251,10218,11033,2995,5333,1890,3037,5434,2562
38585,4277,2132,2145,616,1109,407,578,1117,450
38587,1271,639,632,178,316,145,157,343,132
38588,1084,617,467,245,258,114,103,252,112
38589,147,104,43,15,45,44,5,9,29
38601,2405,1166,1239,455,575,136,364,701,174
38603,2898,1396,1502,395,691,310,402,687,413
38606,15266,7334,7932,2663,3631,1040,2513,3927,1492
38609,105,56,49,25,28,3,12,28,9
38610,3433,1651,1782,566,879,206,612,888,282
38611,14848,7327,7521,2520,3837,970,2383,3901,1237
38614,23289,10589,12700,4574,4600,1415,4516,5815,2369
38617,1190,546,644,274,221,51,264,285,95
38618,10703,5214,5489,1902,2569,743,1742,2787,960
38619,5184,2513,2671,943,1209,361,870,1279,522
38620,3634,1751,1883,793,804,154,771,906,206
38621,2566,1200,1366,560,484,156,489,692,185
38622,644,304,340,101,131,72,114,156,70
38623,374,186,188,73,89,24,57,96,35
38625,1184,574,610,196,280,98,208,276,126
38626,1351,609,742,243,263,103,292,312,138
38627,864,442,422,138,235,69,89,221,112
38629,1748,867,881,243,481,143,296,396,189
38630,119,59,60,28,23,8,19,30,11
38631,1589,691,898,333,276,82,385,390,123
38632,15959,8015,7944,2439,4277,1299,2287,4156,1501
38633,1953,995,958,359,468,168,257,466,235
38635,16346,8040,8306,2811,4165,1064,3026,3768,1512
38637,15290,7496,7794,3005,3975,516,2930,4189,675
38639,1307,591,716,324,227,40,330,294,92
38641,2118,1009,1109,336,526,147,335,576,198
38642,2413,1166,1247,553,497,116,490,601,156
38643,3105,1487,1618,663,644,180,579,760,279
38644,236,129,107,62,41,26,25,44,38
38645,1828,876,952,366,383,127,355,454,143
38646,3756,1725,2031,672,758,295,654,891,486
38647,443,238,205,60,116,62,47,101,57
38649,93,32,61,11,10,11,12,35,14
38650,3571,1655,1916,529,854,272,651,889,376
38651,6875,3301,3574,1079,1759,463,1131,1850,593
38652,15504,7487,8017,2603,3673,1211,2185,4020,1812
38654,27537,13487,14050,4569,7291,1627,4388,7700,1962
38655,29922,15296,14626,5456,8068,1772,4357,7710,2559
38658,2110,1040,1070,335,539,166,365,510,195
38659,3466,1749,1717,547,957,245,502,892,323
38661,2129,1028,1101,281,575,172,356,565,180
38663,11381,5588,5793,1826,2783,979,1500,2938,1355
38664,1416,725,691,218,421,86,238,394,59
38665,1606,783,823,195,414,174,224,400,199
38666,6854,3156,3698,1189,1457,510,1249,1652,797
38668,13224,6270,6954,2425,3000,845,2544,3326,1084
38669,70,36,34,9,11,16,9,22,3
38670,1156,527,629,209,255,63,222,306,101
38671,27584,13453,14131,4530,7440,1483,4235,7859,2037
38672,1446,642,804,161,383,98,294,415,95
38673,486,266,220,85,167,14,56,129,35
38674,1043,496,547,155,266,75,149,283,115
38676,6608,3178,3430,1378,1459,341,1132,1713,585
38677,3441,1143,2298,932,211,0,1875,423,0
38680,8489,4420,4069,1563,2368,489,1159,2370,540
38683,4688,2254,2434,681,1174,399,664,1246,524
38685,30,9,21,0,9,0,0,12,9
38701,29984,14060,15924,5748,6702,1610,5431,7805,2688
38703,18061,8438,9623,3471,3788,1179,3258,4635,1730
38720,411,193,218,72,89,32,80,106,32
38721,1649,831,818,384,363,84,257,437,124
38722,894,408,486,186,160,62,177,221,88
38723,149,48,101,13,21,14,28,57,16
38725,1248,615,633,274,255,86,207,319,107
38726,1337,667,670,265,337,65,232,360,78
38730,1426,700,726,246,348,106,214,392,120
38732,19520,9132,10388,3631,4500,1001,3690,5025,1673
38736,1451,1224,227,230,962,32,70,110,47
38737,3502,1605,1897,653,712,240,733,819,345
38738,4883,4744,139,672,4004,68,44,89,6
38739,136,68,68,14,28,26,27,29,12
38740,841,416,425,182,177,57,147,206,72
38744,1099,535,564,231,236,68,189,268,107
38745,177,86,91,30,50,6,39,39,13
38746,1229,612,617,257,255,100,220,284,113
38748,5327,2398,2929,962,1075,361,1118,1317,494
38751,13589,6237,7352,2683,2895,659,2773,3465,1114
38753,1757,850,907,297,438,115,305,373,229
38754,2843,1305,1538,602,521,182,585,686,267
38756,7388,3645,3743,1466,1702,477,1203,1868,672
38758,38,19,19,7,9,3,5,14,0
38759,1305,642,663,213,347,82,206,350,107
38760,820,348,472,176,149,23,195,217,60
38761,3118,1476,1642,832,531,113,770,693,179
38762,3323,1473,1850,696,625,152,697,834,319
38763,169,88,81,65,20,3,32,40,9
38764,408,183,225,84,81,18,64,121,40
38765,219,95,124,32,38,25,60,50,14
38767,105,49,56,14,23,12,15,29,12
38768,290,140,150,77,52,11,75,64,11
38769,2393,1068,1325,508,416,144,543,590,192
38771,3616,1677,1939,753,717,207,646,880,413
38772,169,79,90,34,34,11,33,45,12
38773,4745,2216,2529,866,1027,323,926,1241,362
38774,3351,1516,1835,671,610,235,698,752,385
38778,2128,1013,1115,437,451,125,414,503,198
38801,28381,13189,15192,4831,6743,1615,4853,7893,2446
38804,17138,8356,8782,2786,4417,1153,2456,4461,1865
38821,12845,6051,6794,2116,2923,1012,1887,3300,1607
38824,8455,4007,4448,1362,2046,599,1363,2255,830
38826,3541,1660,1881,541,861,258,554,1018,309
38827,2917,1346,1571,424,682,240,488,754,329
38828,3248,1602,1646,489,806,307,449,829,368
38829,18372,8893,9479,3185,4178,1530,2895,4463,2121
38833,2511,1259,1252,427,644,188,370,644,238
38834,26786,12799,13987,3939,6676,2184,3825,6931,3231
38838,1308,695,613,240,331,124,166,301,146
38841,2714,1377,1337,475,723,179,456,662,219
38843,11642,5524,6118,1876,2620,1028,1903,2775,1440
38844,336,172,164,71,88,13,48,91,25
38846,2344,1162,1182,370,644,148,386,622,174
38847,3477,1777,1700,547,931,299,484,935,281
38848,717,406,311,115,199,92,56,154,101
38849,4159,2124,2035,760,1097,267,703,1019,313
38850,2841,1403,1438,487,702,214,441,701,296
38851,9184,4501,4683,1639,2184,678,1385,2291,1007
38852,9118,4369,4749,1176,2149,1044,1064,2276,1409
38855,4445,2181,2264,684,1155,342,636,1205,423
38856,1771,887,884,317,398,172,254,414,216
38857,2565,1323,1242,476,686,161,346,725,171
38858,7138,3349,3789,1092,1747,510,1219,1936,634
38859,798,437,361,178,237,22,101,198,62
38860,5857,2785,3072,1027,1413,345,1043,1436,593
38862,3100,1521,1579,529,786,206,456,857,266
38863,17645,8426,9219,2871,4360,1195,2891,4490,1838
38864,2050,1054,996,366,527,161,328,513,155
38865,4882,2444,2438,795,1268,381,686,1255,497
38866,8659,4185,4474,1305,2333,547,1407,2338,729
38868,5243,2619,2624,1011,1300,308,873,1375,376
38869,469,222,247,88,120,14,98,113,36
38870,3024,1446,1578,496,738,212,456,751,371
38871,1658,875,783,298,431,146,201,440,142
38873,2470,1225,1245,360,647,218,307,658,280
38874,81,40,41,6,16,18,11,19,11
38876,1293,622,671,192,299,131,185,350,136
38878,2729,1387,1342,496,703,188,408,681,253
38879,816,444,372,152,250,42,120,201,51
38880,53,21,32,7,14,0,5,20,7
38901,20286,9379,10907,3383,4510,1486,3354,5221,2332
38913,433,260,173,96,132,32,27,86,60
38914,409,203,206,67,112,24,54,126,26
38915,4098,1897,2201,600,937,360,628,1015,558
38916,5295,2403,2892,808,1166,429,798,1397,697
38917,3285,1641,1644,521,894,226,407,928,309
38920,670,350,320,107,186,57,92,176,52
38921,5472,2506,2966,968,1188,350,1022,1363,581
38922,3289,1542,1747,517,737,288,490,822,435
38923,1286,645,641,243,278,124,213,309,119
38924,1016,471,545,166,232,73,191,255,99
38925,2377,1105,1272,346,572,187,337,612,323
38927,968,469,499,158,205,106,124,208,167
38928,876,413,463,209,164,40,234,193,36
38929,1259,604,655,167,320,117,164,353,138
38930,28327,13013,15314,5278,6024,1711,5006,7231,3077
38940,1972,1019,953,314,543,162,262,514,177
38941,5660,2668,2992,1342,1096,230,1331,1309,352
38943,443,256,187,86,117,53,45,93,49
38944,733,377,356,107,194,76,98,160,98
38946,455,200,255,81,87,32,101,105,49
38947,829,511,318,157,294,60,72,137,109
38948,2256,1107,1149,342,546,219,341,555,253
38949,189,84,105,19,58,7,36,53,16
38950,514,253,261,49,150,54,59,121,81
38951,1349,629,720,167,321,141,221,281,218
38952,845,394,451,202,166,26,213,190,48
38953,607,297,310,111,161,25,120,139,51
38954,1832,897,935,376,392,129,338,448,149
38957,970,437,533,183,165,89,168,249,116
38959,160,65,95,13,36,16,48,44,3
38961,1255,601,654,191,312,98,157,372,125
38962,455,211,244,132,44,35,100,81,63
38963,2081,937,1144,378,449,110,428,522,194
38964,167,82,85,37,31,14,30,39,16
38965,8918,4306,4612,1512,2095,699,1327,2220,1065
38966,1350,646,704,271,278,97,219,312,173
38967,7964,3643,4321,1324,1688,631,1281,1970,1070
39038,5848,2799,3049,1257,1224,318,1037,1482,530
39039,2147,1020,1127,385,516,119,361,544,222
39040,3539,1753,1786,661,817,275,536,886,364
39041,3224,1490,1734,533,741,216,525,903,306
39042,30975,15541,15434,4678,9026,1837,4326,8917,2191
39044,3758,1871,1887,701,914,256,636,936,315
39045,1171,481,690,229,227,25,310,263,117
39046,22947,10790,12157,4266,5115,1409,4451,5673,2033
39047,24893,12345,12548,3991,7094,1260,3524,7546,1478
39051,15591,7637,7954,2610,3898,1129,2479,3739,1736
39054,1091,499,592,204,230,65,223,282,87
39056,25259,12123,13136,4376,6200,1547,4112,6719,2305
39057,1840,876,964,292,452,132,356,469,139
39059,12559,6024,6535,2321,2834,869,2209,3187,1139
39060,78,64,14,55,9,0,14,0,0
39061,148,59,89,20,32,7,36,43,10
39062,388,174,214,53,74,47,58,97,59
39063,4067,1895,2172,799,797,299,772,951,449
39066,4912,2367,2545,1004,1074,289,860,1260,425
39067,1541,774,767,282,353,139,241,386,140
39069,6430,3261,3169,1168,1757,336,1146,1553,470
39071,4568,2146,2422,813,1114,219,808,1295,319
39073,17705,8657,9048,3037,4608,1012,2822,4797,1429
39074,16191,7838,8353,2790,3920,1128,2768,3894,1691
39078,802,347,455,120,179,48,148,193,114
39079,1865,1027,838,632,307,88,264,426,148
39082,1283,637,646,167,356,114,214,330,102
39083,10166,4885,5281,1715,2405,765,1647,2568,1066
39086,2295,1103,1192,473,485,145,435,534,223
39088,88,49,39,23,13,13,11,19,9
39090,13496,6295,7201,2102,2975,1218,2222,3212,1767
39092,2400,1147,1253,431,551,165,424,602,227
39094,3548,1748,1800,650,794,304,485,929,386
39095,7743,3652,4091,1519,1581,552,1320,1947,824
39096,3998,1844,2154,885,746,213,1180,702,272
39097,1141,501,640,206,258,37,259,272,109
39098,253,130,123,70,45,15,56,40,27
39107,156,87,69,28,52,7,15,47,7
39108,2059,1061,998,301,472,288,293,415,290
39109,78,43,35,28,15,0,12,16,7
39110,23600,11402,12198,4061,6098,1243,3729,6752,1717
39111,10454,5119,5335,1888,2542,689,1624,2570,1141
39112,216,111,105,0,105,6,22,64,19
39113,1108,630,478,183,389,58,208,204,66
39114,9804,4830,4974,1809,2261,760,1554,2441,979
39115,170,81,89,40,30,11,39,26,24
39116,2362,1145,1217,344,624,177,361,593,263
39117,10162,5107,5055,1819,2556,732,1489,2545,1021
39119,5679,2742,2937,1004,1312,426,935,1416,586
39120,34699,16102,18597,5625,7629,2848,5542,8936,4119
39140,2274,1033,1241,318,534,181,437,552,252
39144,1229,612,617,279,220,113,221,330,66
39145,4995,2485,2510,883,1288,314,787,1330,393
39146,3479,1538,1941,678,665,195,757,929,255
39148,42,13,29,7,6,0,10,19,0
39149,1789,898,891,304,456,138,297,402,192
39150,6290,2862,3428,1089,1355,418,1108,1626,694
39151,17,5,12,0,3,2,5,4,3
39152,1300,586,714,136,362,88,260,337,117
39153,3601,1696,1905,590,830,276,580,914,411
39154,9511,4880,4631,1992,2234,654,1593,2185,853
39156,369,193,176,60,88,45,46,89,41
39157,20531,9717,10814,2840,6066,811,2879,6479,1456
39159,3516,1681,1835,666,736,279,621,869,345
39160,2865,1404,1461,523,687,194,492,719,250
39161,70,44,26,8,27,9,7,19,0
39162,235,136,99,59,60,17,29,55,15
39166,934,445,489,190,173,82,163,220,106
39168,6381,3161,3220,1303,1420,438,997,1580,643
39169,3864,1711,2153,848,682,181,844,1005,304
39170,7471,3561,3910,1117,1876,568,1136,2104,670
39174,1003,379,624,292,70,17,429,174,21
39175,4759,2314,2445,963,1059,292,810,1140,495
39176,2233,1126,1107,386,534,206,326,516,265
39177,202,90,112,20,61,9,38,57,17
39179,1341,690,651,248,299,143,271,227,153
39180,33065,15260,17805,5354,7803,2103,5763,8757,3285
39183,16210,7827,8383,2947,3851,1029,2723,4405,1255
39189,3356,1695,1661,585,893,217,511,834,316
39191,7388,3645,3743,1495,1645,505,1315,1833,595
39192,2106,935,1171,340,429,166,321,556,294
39194,20760,10630,10130,3486,5892,1252,3557,4562,2011
39201,1169,851,318,193,602,56,55,223,40
39202,8827,4266,4561,1360,2518,388,1419,2417,725
39203,9824,4862,4962,2027,2391,444,2246,2070,646
39204,19612,9055,10557,3800,4297,958,3703,5085,1769
39206,28344,12689,15655,4782,6831,1076,5329,8371,1955
39208,29144,13764,15380,4581,7647,1536,4595,8344,2441
39209,34751,15829,18922,7377,7127,1325,7533,9421,1968
39210,742,410,332,304,75,31,289,11,32
39211,23894,11230,12664,2994,6087,2149,2953,6794,2917
39212,38505,18300,20205,6921,9455,1924,6698,10851,2656
39213,26650,12182,14468,4620,5660,1902,4502,6761,3205
39216,3881,1820,2061,424,932,464,418,990,653
39218,6200,3104,3096,1043,1706,355,943,1678,475
39269,0,0,0,0,0,0,0,0,0
39301,29025,13582,15443,5028,6423,2131,4680,7658,3105
39305,18992,8944,10048,2891,4491,1562,2606,4923,2519
39307,18057,8720,9337,3045,4347,1328,2836,4394,2107
39320,2087,1062,1025,323,522,217,331,505,189
39322,1947,915,1032,266,485,164,392,452,188
39323,1053,537,516,166,290,81,149,276,91
39325,5173,2561,2612,898,1303,360,841,1319,452
39326,849,394,455,148,224,22,162,219,74
39327,4165,2092,2073,914,881,297,805,919,349
39328,4669,2135,2534,725,996,414,837,1066,631
39330,2691,1363,1328,497,605,261,353,663,312
39332,1690,808,882,279,368,161,254,416,212
39335,3923,2021,1902,784,1084,153,638,932,332
39336,1304,643,661,208,354,81,206,334,121
39337,1985,947,1038,284,481,182,335,459,244
39338,3370,1621,1749,595,807,219,560,854,335
39339,16714,7953,8761,2818,3906,1229,2687,4181,1893
39341,8243,3891,4352,1531,1815,545,1427,2054,871
39345,6666,2969,3697,998,1439,532,1164,1673,860
39346,2642,1281,1361,468,616,197,335,667,359
39347,1285,624,661,254,294,76,144,330,187
39348,359,174,185,50,79,45,62,62,61
39350,22352,10474,11878,3916,4916,1642,3924,5716,2238
39352,929,471,458,193,183,95,159,214,85
39354,1953,908,1045,292,383,233,277,466,302
39355,7484,3545,3939,1214,1721,610,1135,1924,880
39356,915,455,460,167,211,77,144,227,89
39358,1870,940,930,455,385,100,405,396,129
39359,304,136,168,49,70,17,34,96,38
39360,4219,1992,2227,761,895,336,769,1062,396
39361,1736,844,892,339,394,111,296,424,172
39362,2899,1415,1484,546,689,180,549,675,260
39363,1999,952,1047,338,449,165,339,481,227
39364,3021,1439,1582,553,725,161,563,762,257
39365,8071,3859,4212,1172,1914,773,1272,1881,1059
39366,1886,943,943,369,457,117,313,468,162
39367,15927,7553,8374,2812,3608,1133,2787,4048,1539
39401,42040,19616,22424,7601,10094,1921,8579,10469,3376
39402,30925,14840,16085,4884,8100,1856,4995,8419,2671
39421,3550,1601,1949,670,701,230,709,904,336
39422,6140,2845,3295,1015,1366,464,1092,1469,734
39423,2851,1460,1391,629,697,134,477,714,200
39425,995,511,484,185,263,63,120,300,64
39426,13036,6347,6689,2002,3444,901,1867,3739,1083
39427,1360,686,674,246,330,110,213,322,139
39428,9458,4507,4951,1635,2128,744,1719,2275,957
39429,17286,8302,8984,2921,4069,1312,2708,4343,1933
39436,60,30,30,0,21,9,6,15,9
39437,12046,5904,6142,2008,3073,823,1988,3009,1145
39439,4893,2208,2685,809,1080,319,1010,1234,441
39440,21512,10016,11496,3718,4745,1553,3560,5233,2703
39443,20393,10015,10378,3222,5162,1631,3026,5257,2095
39451,6011,3882,2129,958,2566,358,604,1003,522
39452,22887,11486,11401,4094,5953,1439,3800,5845,1756
39455,6993,3298,3695,1139,1618,541,1144,1861,690
39456,1526,731,795,303,355,73,315,382,98
39459,3216,1594,1622,472,764,358,423,842,357
39461,431,199,232,75,99,25,87,108,37
39462,1236,637,599,223,336,78,181,336,82
39464,2412,1274,1138,466,689,119,325,577,236
39465,17389,8417,8972,3103,4169,1145,2753,4641,1578
39466,24429,11743,12686,4129,5737,1877,4027,6131,2528
39470,11433,5598,5835,2013,2726,859,1895,2823,1117
39474,6916,3302,3614,1189,1557,556,1154,1733,727
39475,9500,4611,4889,1593,2472,546,1606,2520,763
39476,7246,3518,3728,1292,1651,575,1194,1862,672
39477,978,499,479,192,237,70,128,246,105
39478,1793,844,949,297,443,104,322,467,160
39479,5737,2812,2925,947,1475,390,1000,1404,521
39480,2413,1142,1271,340,598,204,399,582,290
39481,2323,1209,1114,357,659,193,261,608,245
39482,7710,3882,3828,1460,1981,441,1282,2002,544
39483,5515,2773,2742,1018,1420,335,805,1406,531
39501,26100,12819,13281,4716,6442,1661,4476,6386,2419
39503,36260,18087,18173,6075,9990,2022,5764,10085,2324
39507,19180,9412,9768,2628,5075,1709,2489,5068,2211
39520,16981,8499,8482,2617,4322,1560,2358,4441,1683
39525,5904,2872,3032,653,1311,908,589,1424,1019
39530,17208,8893,8315,3489,4197,1207,2713,3873,1729
39531,20357,10017,10340,3401,5211,1405,3196,5493,1651
39532,33310,16775,16535,5526,9000,2249,5035,9046,2454
39553,16498,8127,8371,2938,4252,937,2769,4546,1056
39556,4424,2294,2130,834,1130,330,699,1180,251
39560,19757,9534,10223,3329,4891,1314,3215,5365,1643
39561,1281,604,677,218,320,66,259,354,64
39562,16524,8288,8236,2736,4379,1173,2776,4363,1097
39563,15902,7663,8239,2657,3802,1204,2419,4075,1745
39564,31821,15415,16406,4915,8356,2144,5072,8626,2708
39565,14132,7186,6946,2583,3799,804,2381,3716,849
39567,13739,7150,6589,2358,3720,1072,1825,3165,1599
39571,16515,8181,8334,2592,4285,1304,2313,4347,1674
39572,2036,1008,1028,321,505,182,343,538,147
39573,6807,3378,3429,1266,1694,418,1316,1576,537
39574,11141,5814,5327,2112,3097,605,1848,2992,487
39576,7001,3317,3684,1161,1607,549,1038,1872,774
39577,10612,5244,5368,1853,2572,819,1712,2646,1010
39581,12461,6054,6407,2298,3198,558,2419,3213,775
39601,22593,10632,11961,3738,5178,1716,3584,5775,2602
39629,5914,2943,2971,976,1505,462,940,1477,554
39630,998,500,498,197,246,57,171,231,96
39631,3749,1784,1965,669,824,291,631,930,404
39632,70,0,70,0,0,0,0,4,66
39633,1117,483,634,164,224,95,258,268,108
39635,97,48,49,0,26,22,0,28,21
39638,3683,1652,2031,559,787,306,651,912,468
39641,4086,2000,2086,697,934,369,667,937,482
39643,1328,639,689,225,338,76,227,353,109
39645,5000,2405,2595,814,1137,454,681,1297,617
39647,1358,648,710,195,302,151,217,334,159
39648,21241,9685,11556,3696,4505,1484,3632,5385,2539
39652,8014,3954,4060,1395,1963,596,1293,2012,755
39653,2934,1342,1592,455,621,266,451,679,462
39654,5605,2635,2970,996,1185,454,838,1505,627
39656,886,420,466,149,185,86,132,240,94
39657,2611,1267,1344,438,630,199,499,596,249
39661,3172,1535,1637,584,747,204,559,808,270
39662,906,467,439,140,232,95,96,224,119
39663,3298,1606,1692,598,762,246,565,815,312
39664,2258,1133,1125,310,607,216,298,565,262
39665,1105,502,603,135,300,67,229,281,93
39666,9663,4632,5031,1647,2182,803,1484,2502,1045
39667,12186,5833,6353,2164,2683,986,2077,2959,1317
39668,711,359,352,105,204,50,105,170,77
39669,6503,3568,2935,1097,1990,481,848,1453,634
39701,19043,8627,10416,3381,4139,1107,3720,4828,1868
39702,22149,10245,11904,3801,5161,1283,3998,5733,2173
39704,160,64,96,21,37,6,37,45,14
39705,14852,7459,7393,2431,4263,765,2245,4115,1033
39730,13101,6092,7009,2375,2809,908,2241,3288,1480
39735,5383,2494,2889,855,1272,367,871,1338,680
39736,221,105,116,44,48,13,31,62,23
39739,2613,1214,1399,518,520,176,559,580,260
39740,1389,665,724,243,383,39,212,377,135
39741,1626,809,817,245,437,127,225,417,175
39743,2045,1001,1044,386,505,110,437,464,143
39744,6812,3296,3516,1041,1620,635,1040,1583,893
39745,812,404,408,214,138,52,211,146,51
39746,3156,1525,1631,457,828,240,466,818,347
39747,2465,1190,1275,409,553,228,439,583,253
39750,2552,1296,1256,487,643,166,378,639,239
39751,799,361,438,125,168,68,147,195,96
39752,1804,851,953,266,425,160,264,450,239
39755,1405,662,743,240,309,113,238,329,176
39756,1702,780,922,320,370,90,317,424,181
39759,38502,19391,19111,7650,9917,1824,7172,9444,2495
39762,966,429,537,407,22,0,450,87,0
39766,2569,1285,1284,381,689,215,327,677,280
39767,414,189,225,45,104,40,57,92,76
39769,2117,1000,1117,277,498,225,300,564,253
39771,28,18,10,8,7,3,2,6,2
39772,2527,1219,1308,428,592,199,403,620,285
39773,17574,8250,9324,3184,3865,1201,2882,4634,1808
39776,2085,1015,1070,337,548,130,351,527,192
40003,1979,994,985,318,513,163,274,507,204
40004,23749,11470,12279,4026,6194,1250,3858,6514,1907
40006,4871,2400,2471,811,1269,320,762,1292,417
40007,311,165,146,57,84,24,48,81,17
40008,3541,1752,1789,572,880,300,500,916,373
40009,1223,606,617,198,319,89,181,296,140
40010,336,132,204,43,78,11,87,89,28
40011,3738,1930,1808,571,1035,324,535,922,351
40012,601,304,297,85,146,73,70,135,92
40013,4442,2217,2225,621,1185,411,671,1135,419
40014,14985,7442,7543,2645,4170,627,2540,4332,671
40019,3401,1635,1766,530,837,268,499,936,331
40020,7,2,5,0,0,2,0,0,5
40022,707,371,336,133,211,27,89,193,54
40023,1840,951,889,305,552,94,252,536,101
40026,4640,2373,2267,895,1314,164,786,1351,130
40031,18173,10620,7553,2459,7149,1012,2221,4275,1057
40033,11871,6207,5664,1948,3479,780,1690,2772,1202
40036,315,174,141,75,90,9,36,100,5
40037,2832,1343,1489,438,716,189,482,693,314
40040,616,276,340,64,152,60,119,147,74
40045,3045,1482,1563,447,799,236,452,798,313
40046,1408,701,707,198,417,86,204,397,106
40047,13725,6766,6959,2290,3754,722,2102,3920,937
40050,1493,660,833,238,300,122,250,403,180
40051,4360,2264,2096,743,1189,332,748,1064,284
40052,445,221,224,68,108,45,66,121,37
40055,914,428,486,105,230,93,129,231,126
40056,3315,1592,1723,534,847,211,512,884,327
40057,3312,1687,1625,526,896,265,504,802,319
40058,111,41,70,16,18,7,31,25,14
40059,10885,5375,5510,1726,2829,820,1633,3009,868
40060,973,506,467,141,316,49,139,270,58
40062,370,163,207,33,120,10,88,94,25
40065,21473,10506,10967,3299,5904,1303,3202,5955,1810
40067,4335,1877,2458,693,954,230,681,1540,237
40068,2129,1082,1047,350,596,136,359,560,128
40069,7443,3560,3883,1262,1770,528,1138,1802,943
40070,697,399,298,98,244,57,55,174,69
40071,9774,4897,4877,1649,2649,599,1516,2693,668
40076,2408,1154,1254,330,669,155,379,673,202
40077,558,284,274,121,139,24,86,154,34
40078,2280,1191,1089,421,617,153,308,600,181
40104,992,445,547,107,253,85,183,264,100
40107,2023,1048,975,348,543,157,309,523,143
40108,10168,4954,5214,1700,2589,665,1573,2799,842
40109,2371,1219,1152,399,699,121,336,658,158
40111,1795,894,901,275,443,176,210,477,214
40115,1213,648,565,215,318,115,141,315,109
40117,2138,1139,999,381,634,124,316,578,105
40118,9350,4586,4764,1561,2424,601,1461,2523,780
40119,1857,970,887,292,520,158,217,479,191
40121,12479,7607,4872,3822,3785,0,2427,2429,16
40140,184,89,95,21,41,27,15,62,18
40142,1789,889,900,271,490,128,280,501,119
40143,5302,2588,2714,797,1309,482,766,1309,639
40144,1673,772,901,229,431,112,246,524,131
40145,726,361,365,128,188,45,110,166,89
40146,3488,1710,1778,509,841,360,533,884,361
40150,5334,2699,2635,920,1443,336,833,1402,400
40152,492,257,235,66,126,65,31,146,58
40155,1298,670,628,243,381,46,217,344,67
40157,1387,752,635,282,369,101,187,325,123
40160,23607,11519,12088,4137,6277,1105,3886,6540,1662
40162,4178,2093,2085,721,1084,288,648,1145,292
40164,113,48,65,14,19,15,23,21,21
40165,26890,13434,13456,4482,7592,1360,4158,7585,1713
40170,472,229,243,102,116,11,133,97,13
40171,281,137,144,54,73,10,36,86,22
40175,9803,4915,4888,1797,2551,567,1628,2557,703
40176,949,498,451,164,253,81,162,230,59
40177,1633,842,791,303,417,122,225,446,120
40178,454,216,238,75,74,67,62,113,63
40202,5160,2822,2338,864,1638,320,764,1145,429
40203,20821,9522,11299,3538,4838,1146,3758,5141,2400
40204,15123,7485,7638,1718,4948,819,1456,4741,1441
40205,24075,11232,12843,2958,6350,1924,2814,6860,3169
40206,19762,9490,10272,2280,5997,1213,1922,6143,2207
40207,30165,13949,16216,3449,7542,2958,3372,8210,4634
40208,13117,6456,6661,2271,3640,545,2338,3472,851
40209,406,167,239,59,51,57,61,102,76
40210,16276,7390,8886,2921,3452,1017,2963,4267,1656
40211,23600,10599,13001,4359,4435,1805,4353,5995,2653
40212,20118,9495,10623,3762,4647,1086,3424,5366,1833
40213,17977,8653,9324,2737,4555,1361,2513,4664,2147
40214,44343,21471,22872,6632,11719,3120,6456,11997,4419
40215,24752,11447,13305,4227,5733,1487,4242,6609,2454
40216,40181,19092,21089,5703,10001,3388,5422,10655,5012
40217,13630,6485,7145,1772,3682,1031,1616,3546,1983
40218,28997,13499,15498,4590,6957,1952,4195,8129,3174
40219,36875,17987,18888,5725,9487,2775,5294,9906,3688
40220,32879,15599,17280,4359,8655,2585,4060,9027,4193
40222,20870,9757,11113,2411,5419,1927,2360,5888,2865
40223,21732,10353,11379,3135,5806,1412,2904,6343,2132
40228,11091,5434,5657,1712,2948,774,1371,3182,1104
40229,30360,15444,14916,5341,8696,1407,4702,8572,1642
40241,24546,11993,12553,3837,6623,1533,3636,6980,1937
40242,10295,4927,5368,1334,2709,884,1296,2828,1244
40243,9052,4308,4744,1353,2185,770,1238,2528,978
40245,16011,7904,8107,2661,4752,491,2609,4915,583
40258,24269,11902,12367,3848,6277,1777,3411,6526,2430
40272,34538,16548,17990,5315,8596,2637,5222,9178,3590
40291,27806,13439,14367,4078,7713,1648,4185,8171,2011
40299,31421,15222,16199,4731,8417,2074,4467,9030,2702
40310,347,166,181,67,69,30,58,84,39
40311,6824,3355,3469,1043,1709,603,887,1711,871
40312,5748,2855,2893,964,1489,402,956,1557,380
40313,2182,1066,1116,334,583,149,268,613,235
40316,423,224,199,55,151,18,39,141,19
40322,3273,1627,1646,586,779,262,511,781,354
40324,28419,13886,14533,5073,7550,1263,4718,7858,1957
40328,1333,649,684,197,354,98,205,376,103
40330,18954,9159,9795,2804,4839,1516,2524,5110,2161
40334,62,40,22,4,29,7,5,17,0
40336,13983,6731,7252,2131,3538,1062,2122,3666,1464
40337,4655,2360,2295,767,1257,336,705,1283,307
40339,86,26,60,0,20,6,9,24,27
40342,18829,9239,9590,2986,5038,1215,2853,5125,1612
40346,1109,546,563,177,274,95,170,327,66
40347,2533,1197,1336,304,723,170,435,676,225
40348,921,451,470,118,235,98,157,214,99
40350,317,146,171,48,66,32,76,84,11
40351,20314,9871,10443,3625,4900,1346,3926,4847,1670
40353,17773,8529,9244,2567,4690,1272,2519,4851,1874
40355,91,54,37,29,10,15,11,14,12
40356,31178,15165,16013,5192,8255,1718,4878,8846,2289
40358,707,320,387,76,176,68,112,204,71
40359,6973,3467,3506,1100,1781,586,933,1786,787
40360,6152,2972,3180,952,1511,509,918,1548,714
40361,17466,8418,9048,2673,4538,1207,2384,4848,1816
40363,209,112,97,21,71,20,37,43,17
40370,2847,1502,1345,421,876,205,369,812,164
40371,2588,1356,1232,390,732,234,340,647,245
40372,1958,968,990,264,559,145,236,593,161
40374,1786,885,901,258,464,163,209,510,182
40376,71,37,34,8,18,11,10,24,0
40379,2796,1388,1408,447,757,184,412,747,249
40380,7361,3684,3677,1223,1968,493,1027,1952,698
40383,20377,9907,10470,3013,5577,1317,3092,5854,1524
40385,2882,1416,1466,393,739,284,358,829,279
40387,1816,929,887,322,463,144,257,470,160
40390,7324,3718,3606,1402,1759,557,1466,1745,395
40391,32956,15993,16963,4908,8820,2265,4797,8998,3168
40402,2867,1435,1432,476,705,254,399,735,298
40403,20885,9929,10956,3386,5400,1143,3586,5597,1773
40409,3520,1754,1766,503,909,342,410,956,400
40419,4657,2211,2446,733,1181,297,812,1225,409
40422,23168,11703,11465,3720,6282,1701,3171,5737,2557
40437,3865,1951,1914,525,1096,330,473,998,443
40440,2145,999,1146,348,514,137,397,588,161
40442,1121,557,564,196,263,98,181,227,156
40444,12439,6102,6337,1961,3180,961,1740,3314,1283
40445,1159,624,535,173,344,107,127,321,87
40447,8332,4101,4231,1356,2143,602,1416,2173,642
40448,87,43,44,14,24,5,12,26,6
40456,9293,4534,4759,1408,2355,771,1287,2559,913
40460,667,350,317,137,155,58,89,159,69
40461,2149,1104,1045,282,670,152,239,579,227
40464,1033,512,521,125,309,78,99,303,119
40468,1444,666,778,200,323,143,214,351,213
40472,1351,651,700,156,356,139,173,372,155
40475,47974,23185,24789,8116,12491,2578,8485,12852,3452
40481,202,101,101,31,57,13,36,43,22
40484,11302,5422,5880,1667,2946,809,1795,3042,1043
40486,2175,1052,1123,320,545,187,322,565,236
40488,217,104,113,30,65,9,36,77,0
40489,4705,2366,2339,779,1201,386,654,1187,498
40502,26783,12805,13978,3243,7367,2195,3047,7776,3155
40503,27294,13246,14048,3543,7849,1854,3750,7658,2640
40504,24328,11835,12493,3438,6595,1802,3194,6361,2938
40505,26401,12874,13527,3760,7154,1960,3586,7322,2619
40507,2038,1254,784,196,999,59,68,430,286
40508,27379,13767,13612,5656,7158,953,6149,6042,1421
40509,20218,9847,10371,2815,6229,803,2499,6671,1201
40510,1267,831,436,154,530,147,59,269,108
40511,18091,9876,8215,2349,6082,1445,2045,4737,1433
40513,8292,4012,4280,1298,2281,433,1290,2530,460
40514,11291,5578,5713,2109,3164,305,1841,3435,437
40515,29645,14441,15204,4843,8849,749,4616,9456,1132
40516,2538,1231,1307,381,659,191,396,674,237
40517,35787,17008,18779,5472,10147,1389,5176,11257,2346
40601,48507,23555,24952,7029,13110,3416,6669,13638,4645
40701,27003,12718,14285,4179,6354,2185,3952,7306,3027
40729,5350,2644,2706,870,1393,381,853,1379,474
40730,273,96,177,9,67,20,63,83,31
40734,4251,2178,2073,864,1037,277,584,1154,335
40737,955,469,486,171,245,53,146,289,51
40740,2243,1093,1150,393,611,89,420,580,150
40741,19753,9642,10111,2896,5353,1393,2715,5421,1975
40744,16522,8258,8264,2716,4463,1079,2473,4546,1245
40759,2638,1331,1307,450,728,153,464,616,227
40763,654,331,323,140,134,57,115,149,59
40769,18406,8884,9522,3196,4406,1282,3153,4668,1701
40771,1881,963,918,348,504,111,299,447,172
40801,173,76,97,13,29,34,47,27,23
40803,183,100,83,28,62,10,23,42,18
40806,3624,1753,1871,511,967,275,580,982,309
40807,293,134,159,31,69,34,20,75,64
40808,217,129,88,56,41,32,22,55,11
40810,1523,718,805,274,324,120,248,403,154
40813,599,284,315,44,177,63,94,170,51
40815,1523,669,854,206,377,86,318,400,136
40816,34,6,28,0,6,0,12,7,9
40818,445,252,193,110,130,12,52,104,37
40819,704,340,364,121,196,23,80,213,71
40820,721,408,313,172,168,68,82,177,54
40823,4525,2108,2417,678,1052,378,687,1170,560
40824,430,189,241,63,107,19,67,134,40
40826,1145,580,565,194,324,62,175,295,95
40827,1227,615,612,188,338,89,194,329,89
40828,5275,2569,2706,940,1251,378,842,1435,429
40830,288,140,148,32,56,52,47,64,37
40831,5632,2602,3030,792,1366,444,809,1401,820
40840,667,341,326,95,199,47,83,202,41
40843,259,155,104,42,93,20,4,61,39
40844,178,90,88,22,52,16,0,40,48
40845,612,288,324,81,155,52,40,215,69
40847,331,119,212,35,68,16,102,98,12
40849,73,44,29,10,34,0,0,29,0
40854,1024,479,545,147,254,78,104,299,142
40855,951,400,551,114,206,80,163,266,122
40856,708,372,336,109,205,58,84,191,61
40858,243,101,142,21,71,9,76,58,8
40862,512,259,253,77,140,42,71,153,29
40863,536,251,285,74,141,36,59,169,57
40865,248,117,131,48,63,6,44,65,22
40867,391,212,179,56,144,12,42,99,38
40868,905,401,504,137,220,44,176,234,94
40870,443,238,205,50,166,22,48,122,35
40873,3072,1487,1585,458,785,244,494,810,281
40874,472,249,223,108,119,22,77,125,21
40902,1143,522,621,142,312,68,189,334,98
40903,1009,480,529,177,231,72,210,250,69
40906,10146,4865,5281,1640,2482,743,1574,2645,1062
40913,364,183,181,49,86,48,49,97,35
40914,610,302,308,96,183,23,86,194,28
40915,937,441,496,155,250,36,147,261,88
40921,203,108,95,47,49,12,23,51,21
40923,853,404,449,122,239,43,118,244,87
40927,659,333,326,108,181,44,93,151,82
40930,77,36,41,7,23,6,7,34,0
40935,2740,1311,1429,392,694,225,509,682,238
40940,572,254,318,49,167,38,103,136,79
40941,279,157,122,79,68,10,44,62,16
40943,1421,681,740,194,374,113,222,394,124
40946,95,33,62,8,18,7,15,47,0
40949,307,164,143,58,72,34,11,97,35
40953,656,401,255,141,214,46,64,150,41
40958,422,216,206,86,98,32,106,88,12
40962,20886,11060,9826,3201,6420,1439,2971,5206,1649
40965,14033,6479,7554,2018,3417,1044,2128,3674,1752
40972,2391,1271,1120,536,570,165,380,569,171
40977,11410,5663,5747,1815,3174,674,1596,2992,1159
40979,121,65,56,22,34,9,15,31,10
40982,750,358,392,131,196,31,164,179,49
40983,226,97,129,6,55,36,35,49,45
40988,692,345,347,92,173,80,95,167,85
40995,333,167,166,51,99,17,61,93,12
40997,376,127,249,15,102,10,120,99,30
40999,690,354,336,137,168,49,135,160,41
41001,16367,8095,8272,2743,4295,1057,2640,4506,1126
41002,2349,1147,1202,348,583,216,357,600,245
41003,2670,1397,1273,487,728,182,370,675,228
41004,4217,2110,2107,692,1049,369,619,1078,410
41005,16116,8281,7835,2913,4736,632,2656,4465,714
41006,5102,2440,2662,810,1301,329,957,1321,384
41007,2704,1319,1385,456,700,163,514,689,182
41008,7158,3477,3681,934,1957,586,1129,1828,724
41010,3055,1470,1585,406,843,221,545,800,240
41011,28769,14345,14424,4187,8170,1988,3706,7613,3105
41014,7445,3575,3870,1103,2075,397,1116,2076,678
41015,20591,9877,10714,3304,5315,1258,3138,5435,2141
41016,6054,2973,3081,1081,1513,379,988,1567,526
41017,39186,19117,20069,6533,10400,2184,5955,11099,3015
41018,26563,12840,13723,4241,7183,1416,4064,7439,2220
41030,6052,2965,3087,1168,1601,196,1145,1726,216
41031,14794,7180,7614,2203,3873,1104,2123,3847,1644
41033,2062,1108,954,433,561,114,300,522,132
41034,1006,511,495,175,261,75,141,280,74
41035,9592,4852,4740,1772,2500,580,1544,2558,638
41039,2530,1314,1216,458,681,175,350,654,212
41040,7094,3552,3542,1260,1847,445,1082,1863,597
41041,6960,3283,3677,1026,1690,567,1025,1844,808
41042,41200,19788,21412,6520,11118,2150,6598,11543,3271
41043,1486,748,738,251,399,98,205,424,109
41044,683,311,372,65,174,72,128,154,90
41045,1229,637,592,267,321,49,218,307,67
41046,1227,632,595,234,316,82,182,335,78
41048,7905,3967,3938,1528,2126,313,1332,2268,338
41049,2059,1066,993,368,532,166,294,516,183
41051,17701,8930,8771,3245,4799,886,2805,4932,1034
41052,110,49,61,18,31,0,15,46,0
41055,1654,868,786,289,393,186,219,388,179
41056,13880,6682,7198,2091,3513,1078,1878,3610,1710
41059,2402,1256,1146,355,730,171,269,611,266
41063,3906,2016,1890,705,1077,234,586,1048,256
41064,2234,1079,1155,321,543,215,318,559,278
41071,21761,10529,11232,3505,5737,1287,3171,6007,2054
41073,6316,3095,3221,1062,1638,395,910,1618,693
41074,5729,2756,2973,1003,1407,346,1036,1476,461
41075,17397,8209,9188,2605,4355,1249,2468,4701,2019
41076,14601,6798,7803,2128,3558,1112,2276,3859,1668
41080,1568,817,751,268,453,96,261,379,111
41083,1052,558,494,150,307,101,174,258,62
41085,812,430,382,162,200,68,121,197,64
41086,2412,1298,1114,488,680,130,322,648,144
41091,11293,5688,5605,2066,3105,517,1920,3143,542
41092,1964,1051,913,327,563,161,238,489,186
41093,2264,1130,1134,368,625,137,311,663,160
41094,6621,3329,3292,1196,1769,364,1067,1823,402
41095,4229,2026,2203,638,1043,345,666,1044,493
41097,6004,2948,3056,982,1493,473,880,1462,714
41098,1798,886,912,262,465,159,323,433,156
41101,19634,9078,10556,2794,4516,1768,2558,5213,2785
41102,21288,10931,10357,2877,6312,1742,2563,5453,2341
41121,1439,714,725,253,361,100,206,379,140
41124,1147,542,605,144,305,93,159,330,116
41129,9808,4853,4955,1412,2654,787,1373,2653,929
41132,341,147,194,52,80,15,70,94,30
41135,356,169,187,44,100,25,96,67,24
41137,323,181,142,63,89,29,42,73,27
41139,9016,4268,4748,1344,2169,755,1177,2439,1132
41141,2865,1445,1420,526,699,220,488,727,205
41142,106,58,48,9,49,0,19,29,0
41143,13988,6899,7089,2371,3521,1007,2100,3650,1339
41144,10209,4913,5296,1371,2681,861,1376,2824,1096
41146,540,276,264,81,122,73,73,134,57
41149,618,308,310,111,139,58,105,144,61
41159,710,373,337,161,171,41,126,160,51
41164,12880,6306,6574,2062,3186,1058,1900,3386,1288
41166,664,300,364,86,173,41,83,203,78
41168,2741,1355,1386,443,718,194,471,664,251
41169,4622,2188,2434,589,1163,436,634,1221,579
41170,179,96,83,33,49,14,27,38,18
41171,3628,1715,1913,507,900,308,565,929,419
41174,751,395,356,116,210,69,87,172,97
41175,6107,2883,3224,886,1521,476,920,1630,674
41179,8240,4121,4119,1303,2212,606,1210,2160,749
41180,1178,596,582,160,319,117,176,289,117
41183,1719,837,882,265,433,139,197,498,187
41189,2047,1006,1041,280,558,168,287,518,236
41201,135,78,57,18,35,25,9,20,28
41203,564,319,245,110,183,26,76,153,16
41204,828,424,404,143,217,64,90,243,71
41214,546,270,276,73,134,63,85,141,50
41216,1174,526,648,141,300,85,210,330,108
41219,1910,978,932,300,528,150,245,507,180
41222,1813,853,960,248,448,157,295,544,121
41224,5310,2613,2697,939,1297,377,777,1501,419
41226,342,167,175,82,69,16,54,86,35
41228,780,405,375,143,222,40,133,192,50
41230,11382,5544,5838,1762,2935,847,1693,3035,1110
41231,1958,994,964,355,518,121,310,524,130
41232,470,228,242,45,124,59,78,117,47
41234,88,43,45,6,32,5,10,28,7
41238,882,435,447,127,223,85,109,272,66
41240,7239,3418,3821,1076,1763,579,860,1944,1017
41250,967,432,535,170,208,54,187,292,56
41254,714,339,375,105,192,42,129,207,39
41255,914,483,431,164,273,46,143,230,58
41256,2426,1129,1297,337,600,192,400,685,212
41257,184,81,103,21,47,13,23,61,19
41260,866,422,444,136,228,58,159,230,55
41262,1489,737,752,290,395,52,289,392,71
41263,417,184,233,58,96,30,81,128,24
41264,688,352,336,122,172,58,109,169,58
41265,2078,983,1095,270,558,155,297,633,165
41267,1316,586,730,194,317,75,269,344,117
41268,429,189,240,60,91,38,85,106,49
41274,654,297,357,108,157,32,98,232,27
41301,5668,2745,2923,925,1403,417,932,1437,554
41310,52,20,32,0,20,0,14,11,7
41311,7283,3822,3461,1030,2220,572,984,1710,767
41314,4672,2300,2372,763,1074,463,651,1190,531
41317,466,261,205,75,143,43,55,116,34
41332,2396,1202,1194,385,606,211,387,630,177
41339,12594,6166,6428,2098,3172,896,1847,3415,1166
41344,324,165,159,38,100,27,49,84,26
41348,1420,700,720,208,405,87,202,394,124
41360,586,336,250,144,162,30,105,117,28
41364,361,211,150,95,91,25,33,105,12
41365,607,310,297,97,167,46,78,181,38
41367,208,105,103,12,59,34,43,43,17
41377,142,85,57,37,39,9,12,40,5
41385,385,229,156,69,110,50,50,78,28
41386,67,30,37,12,18,0,17,20,0
41390,86,46,40,20,22,4,9,20,11
41397,229,99,130,24,49,26,37,93,0
41408,137,81,56,13,57,11,17,24,15
41421,126,69,57,26,43,0,20,37,0
41425,1467,749,718,261,404,84,253,360,105
41426,118,75,43,42,24,9,17,15,11
41464,119,34,85,5,21,8,47,25,13
41465,12631,6229,6402,2089,3285,855,1962,3400,1040
41472,10786,6110,4676,1636,3685,789,1299,2386,991
41501,24155,11483,12672,3505,6277,1701,3398,6766,2508
41503,705,275,430,52,164,59,89,175,166
41512,1147,620,527,207,329,84,153,281,93
41513,767,383,384,87,206,90,81,203,100
41514,3448,1683,1765,469,952,262,531,952,282
41519,443,194,249,80,98,16,74,133,42
41522,6248,3027,3221,898,1691,438,876,1733,612
41524,280,144,136,65,64,15,44,69,23
41527,848,410,438,98,227,85,82,256,100
41528,806,393,413,123,203,67,121,200,92
41531,1456,721,735,230,406,85,225,393,117
41534,119,55,64,15,40,0,0,36,28
41535,741,367,374,107,181,79,68,244,62
41537,4834,2376,2458,705,1254,417,656,1260,542
41538,231,127,104,31,79,17,7,80,17
41539,2203,1103,1100,363,627,113,292,662,146
41540,265,150,115,34,100,16,44,65,6
41543,426,210,216,47,127,36,34,108,74
41544,670,311,359,104,172,35,111,163,85
41546,455,264,191,80,129,55,53,98,40
41547,242,129,113,48,63,18,21,60,32
41548,1437,699,738,212,399,88,237,426,75
41549,44,12,32,12,0,0,13,13,6
41553,3400,1724,1676,490,971,263,438,956,282
41554,1169,634,535,205,350,79,92,353,90
41555,215,106,109,53,33,20,35,58,16
41557,1341,602,739,134,365,103,202,419,118
41558,1176,542,634,198,298,46,196,334,104
41559,651,291,360,79,153,59,118,207,35
41560,212,116,96,50,54,12,26,55,15
41562,2853,1526,1327,559,788,179,331,787,209
41563,586,284,302,89,176,19,119,155,28
41564,1528,795,733,275,414,106,205,395,133
41566,619,332,287,123,139,70,69,140,78
41567,682,301,381,84,154,63,109,203,69
41568,858,392,466,167,202,23,197,220,49
41569,55,15,40,0,8,7,7,21,12
41571,574,279,295,95,146,38,92,148,55
41572,3967,1991,1976,610,1120,261,541,1057,378
41601,814,360,454,79,193,88,114,223,117
41602,804,394,410,145,149,100,109,166,135
41603,243,119,124,28,63,28,15,80,29
41604,332,166,166,56,72,38,46,114,6
41605,801,327,474,52,219,56,161,198,115
41606,699,329,370,93,193,43,115,190,65
41607,401,188,213,67,108,13,57,132,24
41612,182,59,123,18,22,19,55,54,14
41615,1308,648,660,214,386,48,291,318,51
41616,409,213,196,59,129,25,54,114,28
41619,556,263,293,66,162,35,92,118,83
41621,277,155,122,75,74,6,24,68,30
41622,63,16,47,0,0,16,0,8,39
41630,1845,923,922,252,486,185,220,488,214
41631,1128,554,574,193,315,46,183,319,72
41632,495,230,265,102,84,44,113,93,59
41635,3488,1759,1729,496,1017,246,436,1029,264
41636,1533,719,814,246,358,115,227,477,110
41640,1475,755,720,241,455,59,174,420,126
41642,597,280,317,90,138,52,94,153,70
41645,2149,1010,1139,307,502,201,337,628,174
41647,1243,631,612,206,320,105,138,334,140
41649,2779,1372,1407,427,745,200,326,850,231
41650,771,356,415,109,187,60,112,189,114
41651,317,115,202,43,47,25,88,71,43
41653,12550,5975,6575,1693,3406,876,1879,3591,1105
41655,1203,597,606,162,353,82,176,321,109
41659,342,194,148,83,86,25,9,97,42
41660,982,517,465,149,318,50,102,309,54
41663,783,356,427,137,196,23,163,247,17
41666,813,411,402,142,205,64,101,209,92
41667,618,316,302,122,155,39,78,183,41
41669,1228,854,374,197,609,48,119,160,95
41701,17385,8396,8989,2646,4617,1133,2535,4868,1586
41712,126,69,57,6,40,23,19,38,0
41714,426,194,232,82,96,16,71,136,25
41719,974,502,472,152,318,32,129,286,57
41721,621,322,299,128,150,44,100,156,43
41722,2116,1110,1006,366,626,118,253,542,211
41723,1702,840,862,267,451,122,212,504,146
41725,19,10,9,0,5,5,0,9,0
41727,403,192,211,37,127,28,38,135,38
41729,52,23,29,7,16,0,0,15,14
41730,220,105,115,24,59,22,24,68,23
41731,900,417,483,136,224,57,146,254,83
41735,288,129,159,43,86,0,48,95,16
41736,317,159,158,37,89,33,62,63,33
41739,113,59,54,20,27,12,8,46,0
41740,631,306,325,114,168,24,96,169,60
41745,311,165,146,59,85,21,25,76,45
41746,501,261,240,83,136,42,83,131,26
41749,3391,1605,1786,465,885,255,455,947,384
41751,218,82,136,25,29,28,20,76,40
41754,313,161,152,92,51,18,34,83,35
41759,650,344,306,110,186,48,114,146,46
41760,99,46,53,16,29,1,6,29,18
41762,165,84,81,35,44,5,13,55,13
41763,616,301,315,72,172,57,83,153,79
41764,700,344,356,98,176,70,93,193,70
41766,231,103,128,31,64,8,49,79,0
41772,355,180,175,29,114,37,40,93,42
41773,2147,1007,1140,313,524,170,321,594,225
41774,3210,1563,1647,473,874,216,427,946,274
41775,157,88,69,39,29,20,5,31,33
41776,1782,960,822,321,522,117,233,483,106
41777,1009,502,507,171,282,49,132,310,65
41778,247,129,118,61,61,7,31,81,6
41804,601,300,301,97,162,41,96,169,36
41810,684,315,369,67,199,49,111,180,78
41812,259,127,132,31,74,22,44,71,17
41815,672,325,347,124,159,42,148,150,49
41817,247,132,115,71,49,12,52,56,7
41819,436,203,233,45,112,46,82,124,27
41821,1051,505,546,113,326,66,164,294,88
41822,2460,1132,1328,376,590,166,398,706,224
41824,1079,542,537,159,311,72,131,340,66
41825,608,327,281,108,169,50,112,161,8
41826,1015,524,491,147,286,91,106,265,120
41828,933,454,479,99,293,62,148,256,75
41831,1137,597,540,222,294,81,136,311,93
41832,419,225,194,93,106,26,48,108,38
41833,248,160,88,66,72,22,16,55,17
41834,592,277,315,60,170,47,84,159,72
41835,926,475,451,160,252,63,136,211,104
41836,447,229,218,84,125,20,53,130,35
41837,1493,742,751,253,432,57,227,430,94
41838,769,360,409,103,196,61,81,210,118
41839,989,468,521,120,248,100,152,254,115
41840,1524,750,774,241,407,102,225,380,169
41843,1173,540,633,144,325,71,165,378,90
41844,1216,600,616,289,262,49,281,268,67
41845,364,174,190,41,79,54,44,88,58
41847,638,314,324,114,143,57,87,176,61
41849,69,33,36,4,18,11,3,15,18
41855,58,23,35,9,14,0,11,24,0
41858,8317,3923,4394,1198,2157,568,1181,2262,951
41859,453,208,245,40,132,36,57,136,52
41861,505,235,270,89,120,26,69,146,55
41862,1056,576,480,185,336,55,156,239,85
42001,28222,13221,15001,3956,6983,2282,3741,7638,3622
42003,29859,14225,15634,4230,7702,2293,4126,7846,3662
42020,1745,787,958,228,435,124,289,508,161
42021,1811,917,894,301,440,176,226,456,212
42022,183,99,84,38,47,14,18,34,32
42023,2403,1196,1207,298,650,248,293,570,344
42024,1590,796,794,263,419,114,212,401,181
42025,18505,9045,9460,2519,4538,1988,2399,4516,2545
42027,2659,1278,1381,331,693,254,361,800,220
42028,644,305,339,88,169,48,61,164,114
42029,6229,3075,3154,907,1607,561,756,1597,801
42031,3608,1712,1896,474,850,388,470,872,554
42032,308,149,159,54,69,26,37,78,44
42035,981,503,478,152,218,133,117,216,145
42036,1334,675,659,231,329,115,265,313,81
42038,5228,3264,1964,515,2265,484,414,1011,539
42039,1644,748,896,244,382,122,291,413,192
42040,977,497,480,155,267,75,125,272,83
42041,5149,2257,2892,676,1088,493,885,1266,741
42044,3086,1580,1506,417,779,384,298,841,367
42045,2076,1054,1022,256,587,211,204,583,235
42047,267,151,116,36,75,40,28,73,15
42048,2026,982,1044,329,456,197,311,500,233
42049,1830,824,1006,190,480,154,379,425,202
42050,3636,1745,1891,568,925,252,547,976,368
42051,2995,1536,1459,511,761,264,392,802,265
42053,4752,2350,2402,649,1332,369,703,1209,490
42054,1184,678,506,207,401,70,142,318,46
42055,2513,1262,1251,327,616,319,210,629,412
42056,1901,912,989,303,450,159,244,443,302
42058,2340,1130,1210,333,656,141,404,626,180
42060,137,53,84,0,34,19,30,35,19
42061,32,16,16,0,8,8,5,11,0
42064,8555,4091,4464,1209,2057,825,1208,2198,1058
42066,23000,10959,12041,3362,5603,1994,3264,5644,3133
42069,897,470,427,146,262,62,147,233,47
42071,26845,12827,14018,4164,6485,2178,4427,6393,3198
42076,975,486,489,121,248,117,119,251,119
42078,1863,840,1023,212,383,245,258,472,293
42079,1571,800,771,232,470,98,280,365,126
42081,2365,1172,1193,333,630,209,316,616,261
42082,1785,896,889,247,482,167,182,468,239
42083,434,265,169,83,148,34,61,108,0
42084,67,47,20,5,15,27,5,15,0
42085,1095,540,555,154,253,133,134,275,146
42086,3430,1665,1765,449,850,366,459,977,329
42087,2513,1278,1235,333,693,252,298,655,282
42088,2577,1206,1371,360,628,218,372,696,303
42101,49311,24137,25174,8902,12691,2544,9104,12443,3627
42103,15001,7665,7336,2374,4156,1135,1840,4042,1454
42104,20607,9761,10846,3082,5318,1361,2941,5961,1944
42120,2233,1105,1128,387,552,166,386,569,173
42122,3251,1557,1694,523,861,173,521,924,249
42123,995,434,561,121,277,36,185,285,91
42127,5366,2615,2751,771,1369,475,712,1475,564
42129,7212,3490,3722,1116,1756,618,1081,1773,868
42131,39,20,19,11,4,5,0,5,14
42133,1463,767,696,215,418,134,174,358,164
42134,15889,7773,8116,2453,4053,1267,2400,4091,1625
42140,1382,675,707,220,362,93,193,376,138
42141,27707,13207,14500,4014,6970,2223,3841,7390,3269
42151,218,109,109,45,47,17,37,63,9
42153,348,169,179,42,89,38,63,79,37
42154,409,199,210,57,82,60,67,84,59
42157,351,177,174,48,93,36,48,83,43
42159,868,431,437,115,195,121,133,231,73
42160,1742,892,850,236,481,175,199,397,254
42164,14496,7082,7414,2299,3619,1164,2168,3709,1537
42166,2603,1263,1340,312,760,191,367,683,290
42167,8817,4300,4517,1452,2070,778,1187,2250,1080
42170,1221,589,632,170,320,99,241,296,95
42171,6399,3124,3275,1100,1629,395,1034,1646,595
42202,2451,1166,1285,373,608,185,393,651,241
42204,587,275,312,82,120,73,109,133,70
42206,4874,2360,2514,830,1201,329,751,1241,522
42207,1302,686,616,171,378,137,150,318,148
42210,4558,2075,2483,670,1069,336,638,1313,532
42211,11871,5878,5993,1620,3040,1218,1550,2993,1450
42214,329,149,180,44,64,41,44,77,59
42215,1110,531,579,108,267,156,113,318,148
42217,3659,1786,1873,599,887,300,548,964,361
42220,6236,2973,3263,952,1605,416,962,1540,761
42223,21528,13394,8134,6828,6566,0,4408,3717,9
42232,755,413,342,115,202,96,63,187,92
42234,2681,1312,1369,509,642,161,481,648,240
42236,831,407,424,112,241,54,131,240,53
42240,40163,18983,21180,6407,9486,3090,6278,10467,4435
42254,252,121,131,42,71,8,48,75,8
42256,4959,2393,2566,696,1282,415,752,1292,522
42259,1177,606,571,149,320,137,188,247,136
42261,10454,5183,5271,1663,2827,693,1492,2753,1026
42262,7765,4120,3645,1637,2354,129,1682,1859,104
42265,1202,639,563,213,318,108,173,288,102
42266,2536,1254,1282,521,569,164,413,555,314
42273,491,271,220,55,121,95,30,93,97
42274,1752,925,827,359,497,69,265,465,97
42275,944,485,459,158,243,84,136,225,98
42276,14663,6932,7731,2190,3612,1130,2292,3837,1602
42280,408,184,224,53,105,26,65,124,35
42285,180,93,87,32,57,4,16,59,12
42286,1180,577,603,187,287,103,192,268,143
42287,231,99,132,17,45,37,47,48,37
42301,40885,19306,21579,6319,9835,3152,6301,10447,4831
42303,35490,17111,18379,5809,8744,2558,5219,9226,3934
42320,8011,3818,4193,1174,2012,632,1239,2088,866
42321,501,245,256,75,130,40,85,129,42
42323,827,438,389,157,233,48,98,224,67
42324,1217,581,636,201,279,101,183,318,135
42325,1938,948,990,282,538,128,321,501,168
42326,279,127,152,24,66,37,39,60,53
42327,3567,1666,1901,460,901,305,507,958,436
42328,1493,764,729,251,404,109,209,382,138
42330,10836,5738,5098,1698,3094,946,1289,2550,1259
42332,314,136,178,38,88,10,78,74,26
42333,777,423,354,161,145,117,101,148,105
42337,2208,1104,1104,377,536,191,343,538,223
42338,219,107,112,53,46,8,55,57,0
42339,977,519,458,176,264,79,111,250,97
42343,1864,926,938,267,498,161,236,448,254
42344,1130,575,555,166,347,62,137,319,99
42345,10838,4919,5919,1426,2503,990,1574,2869,1476
42347,5762,2790,2972,888,1409,493,790,1494,688
42348,4605,2339,2266,837,1193,309,697,1217,352
42349,1556,786,770,195,424,167,225,407,138
42350,1557,740,817,207,383,150,250,438,129
42351,3616,1764,1852,565,973,226,556,986,310
42352,2170,1049,1121,382,498,169,349,540,232
42354,340,166,174,52,91,23,56,86,32
42355,1957,1031,926,360,560,111,256,535,135
42361,411,229,182,74,96,59,32,91,59
42365,43,28,15,0,20,8,7,8,0
42366,5736,2930,2806,886,1657,387,828,1574,404
42368,1248,606,642,207,295,104,199,367,76
42369,351,170,181,69,87,14,49,98,34
42370,22,8,14,0,8,0,0,7,7
42371,425,237,188,71,115,51,54,106,28
42372,1944,954,990,281,504,169,235,564,191
42374,187,87,100,26,51,10,39,42,19
42376,6055,3176,2879,1034,1687,455,857,1571,451
42378,3525,1678,1847,639,828,211,674,887,286
42403,28,7,21,7,0,0,8,4,9
42404,2714,1364,1350,375,749,240,354,721,275
42406,2811,1356,1455,451,693,212,524,714,217
42408,7363,3685,3678,1148,1876,661,935,1902,841
42409,2701,1372,1329,425,724,223,358,680,291
42410,1678,702,976,220,364,118,279,461,236
42411,1803,882,921,210,487,185,262,440,219
42413,3096,1529,1567,482,828,219,458,817,292
42420,37117,17871,19246,5633,9493,2745,5256,9950,4040
42431,26438,12436,14002,3875,6517,2044,3640,7066,3296
42436,366,189,177,82,100,7,56,115,6
42437,8613,4520,4093,1978,2003,539,1383,1984,726
42440,1035,498,537,164,254,80,133,263,141
42441,1825,908,917,248,534,126,277,528,112
42442,3512,1685,1827,521,929,235,512,932,383
42444,36,22,14,3,19,0,0,8,6
42445,11316,5310,6006,1461,2752,1097,1556,2968,1482
42450,4407,2063,2344,673,1043,347,675,1168,501
42451,946,506,440,171,304,31,120,250,70
42452,2398,1181,1217,403,612,166,418,658,141
42453,123,60,63,13,29,18,11,45,7
42455,3433,1678,1755,530,889,259,534,848,373
42456,1281,607,674,153,331,123,200,351,123
42457,175,77,98,11,43,23,27,63,8
42458,895,469,426,131,246,92,100,257,69
42459,4582,2136,2446,635,1145,356,692,1135,619
42461,1784,894,890,297,449,148,262,449,179
42462,1306,672,634,251,361,60,211,352,71
42463,147,87,60,24,45,18,10,41,9
42464,1893,962,931,288,569,105,273,529,129
42501,16752,7667,9085,2340,3782,1545,2375,4289,2421
42503,18974,9446,9528,2806,4968,1672,2606,5083,1839
42516,401,205,196,53,117,35,55,112,29
42518,2918,1524,1394,466,745,313,402,726,266
42519,3323,1696,1627,524,861,311,416,891,320
42528,1495,707,788,211,351,145,250,365,173
42533,501,224,277,77,124,23,77,150,50
42539,9653,4680,4973,1410,2444,826,1360,2512,1101
42541,619,321,298,117,144,60,67,163,68
42544,5686,2731,2955,699,1404,628,797,1512,646
42553,4089,2027,2062,632,1098,297,535,1116,411
42565,678,299,379,99,149,51,103,179,97
42566,578,285,293,91,127,67,50,161,82
42567,5302,2735,2567,864,1323,548,681,1344,542
42602,9341,4485,4856,1265,2351,869,1299,2422,1135
42603,922,463,459,162,231,70,142,241,76
42629,4747,2342,2405,653,1167,522,563,1155,687
42631,353,142,211,48,77,17,87,104,20
42632,25,6,19,0,0,6,0,13,6
42633,18523,9151,9372,3062,4605,1484,2763,4773,1836
42634,1547,779,768,274,425,80,240,407,121
42635,3696,1812,1884,631,895,286,582,959,343
42638,342,160,182,48,106,6,94,65,23
42642,11672,5644,6028,1676,2998,970,1559,3145,1324
42647,4302,2260,2042,879,1100,281,630,1125,287
42649,1984,961,1023,320,560,81,346,528,149
42653,4547,2202,2345,738,1130,334,723,1151,471
42701,38533,18647,19886,5967,10109,2571,5713,10422,3751
42711,192,88,104,7,34,47,26,28,50
42712,1762,887,875,290,456,141,259,408,208
42713,1743,836,907,271,422,143,301,430,176
42715,432,222,210,84,103,35,66,111,33
42716,1413,670,743,174,363,133,234,397,112
42717,6717,3212,3505,925,1608,679,899,1708,898
42718,23017,11020,11997,3469,5586,1965,3385,5889,2723
42721,3708,1811,1897,582,947,282,644,920,333
42722,658,358,300,107,157,94,76,143,81
42724,3850,1951,1899,586,1026,339,526,1036,337
42726,4472,2245,2227,525,1204,516,562,1163,502
42728,14263,6933,7330,2199,3533,1201,2117,3590,1623
42729,1482,747,735,212,396,139,271,335,129
42731,193,89,104,23,41,25,22,68,14
42732,1821,907,914,271,518,118,255,530,129
42733,1669,830,839,296,392,142,255,383,201
42740,1966,975,991,313,543,119,366,480,145
42741,405,176,229,32,108,36,56,139,34
42742,157,64,93,9,41,14,15,60,18
42743,9303,4555,4748,1295,2337,923,1125,2380,1243
42746,1983,964,1019,325,497,142,302,533,184
42748,8269,4031,4238,1258,2040,733,1152,2076,1010
42749,5435,2631,2804,853,1316,462,699,1384,721
42753,181,83,98,15,57,11,30,49,19
42754,14992,7389,7603,2370,3805,1214,2177,3884,1542
42757,3248,1654,1594,535,820,299,455,786,353
42759,79,42,37,29,6,7,16,21,0
42761,371,178,193,75,83,20,69,103,21
42762,185,84,101,29,34,21,22,36,43
42765,4907,2417,2490,776,1247,394,689,1208,593
42776,2231,1065,1166,334,555,176,378,564,224
42782,1115,585,530,173,341,71,181,263,86
42784,2744,1381,1363,454,758,169,413,742,208
42788,264,106,158,33,73,0,77,71,10
43001,1770,937,833,295,501,141,211,463,159
43002,1265,593,672,147,367,79,121,430,121
43003,2500,1275,1225,481,663,131,368,643,214
43004,8625,4224,4401,1380,2531,313,1283,2659,459
43005,108,61,47,15,43,3,9,30,8
43006,618,308,310,90,162,56,99,161,50
43008,2044,1017,1027,356,518,143,332,526,169
43009,1753,902,851,277,540,85,264,492,95
43010,114,62,52,32,30,0,20,32,0
43011,6029,3086,2943,1107,1582,397,931,1623,389
43013,943,479,464,151,250,78,145,216,103
43014,3391,1706,1685,671,767,268,664,724,297
43015,36843,18029,18814,6368,9478,2183,5912,9942,2960
43016,18959,9676,9283,3282,5968,426,2793,5800,690
43017,34122,16858,17264,5789,9804,1265,5472,10261,1531
43018,249,137,112,44,62,31,45,48,19
43019,8511,4298,4213,1421,2250,627,1188,2199,826
43021,5763,2982,2781,1007,1587,388,789,1603,389
43022,3247,1569,1678,891,544,134,990,546,142
43023,11308,5623,5685,2413,2512,698,2316,2561,808
43025,5856,2784,3072,855,1474,455,885,1579,608
43026,47413,23306,24107,8196,13591,1519,7724,14164,2219
43028,5313,2755,2558,801,1450,504,600,1460,498
43029,654,303,351,133,154,16,167,178,6
43031,10201,4971,5230,1597,2698,676,1559,2851,820
43032,58,10,48,0,10,0,27,9,12
43033,322,164,158,74,75,15,52,68,38
43035,11408,5558,5850,1772,3492,294,2040,3491,319
43036,140,67,73,21,41,5,32,26,15
43037,411,201,210,67,87,47,52,87,71
43040,25309,11763,13546,4183,6303,1277,3916,7769,1861
43044,5371,2741,2630,958,1436,347,760,1402,468
43045,1551,756,795,230,424,102,260,394,141
43046,3508,1701,1807,491,939,271,486,1004,317
43050,27690,13045,14645,4236,6603,2206,4309,6955,3381
43054,8300,4108,4192,1352,2328,428,1356,2431,405
43055,58057,27778,30279,8916,14495,4367,8771,15112,6396
43056,15063,7315,7748,2379,3731,1205,2224,4036,1488
43060,2760,1379,1381,535,741,103,517,728,136
43061,3052,1470,1582,409,890,171,503,878,201
43062,19321,9503,9818,2998,5330,1175,2997,5565,1256
43064,10098,5012,5086,1717,2606,689,1616,2635,835
43065,24287,12216,12071,4371,7046,799,3937,7255,879
43066,1212,582,630,194,313,75,213,324,93
43067,1471,741,730,282,379,80,245,400,85
43068,45502,21931,23571,7373,12126,2432,6862,13255,3454
43070,132,75,57,50,17,8,21,29,7
43071,2273,1101,1172,363,573,165,389,564,219
43072,5566,2765,2801,951,1483,331,846,1510,445
43074,9235,4569,4666,1536,2455,578,1380,2557,729
43076,8058,3953,4105,1093,2095,765,1288,2061,756
43077,259,129,130,40,69,20,38,66,26
43078,20836,10052,10784,3070,5391,1591,3035,5367,2382
43080,5280,2660,2620,945,1308,407,828,1304,488
43081,51294,24522,26772,8230,13791,2501,8216,15224,3332
43082,17572,8673,8899,3042,4800,831,2913,5008,978
43084,830,385,445,135,183,67,134,217,94
43085,23567,11368,12199,3540,6141,1687,3027,6891,2281
43101,333,178,155,55,103,20,45,89,21
43102,3904,1979,1925,681,1047,251,615,1020,290
43103,9525,4603,4922,1522,2445,636,1564,2581,777
43105,7699,3843,3856,1208,2007,628,1076,2081,699
43106,1631,857,774,309,477,71,255,431,88
43107,2725,1350,1375,458,631,261,460,637,278
43109,75,36,39,15,17,4,12,17,10
43110,18501,8782,9719,3013,4859,910,3132,5408,1179
43111,148,68,80,16,42,10,24,37,19
43112,3558,1824,1734,555,952,317,520,928,286
43113,22928,11294,11634,3698,5663,1933,3188,5927,2519
43115,1232,612,620,204,320,88,189,328,103
43116,346,173,173,48,100,25,49,105,19
43119,21720,10673,11047,3784,6287,602,3905,6430,712
43123,45871,22450,23421,7794,11819,2837,7197,12673,3551
43125,9601,4774,4827,1508,2539,727,1276,2638,913
43126,252,127,125,32,73,22,29,70,26
43127,28,13,15,0,7,6,0,4,11
43128,2503,1230,1273,432,645,153,386,711,176
43130,55828,27898,27930,8397,14890,4611,7672,14264,5994
43135,4505,2252,2253,705,1240,307,773,1167,313
43136,265,138,127,53,66,19,41,70,16
43137,2286,1240,1046,448,660,132,259,676,111
43138,17726,8668,9058,2792,4401,1475,2660,4486,1912
43140,22170,12798,9372,3365,8231,1202,2656,4913,1803
43142,114,58,56,11,34,13,11,33,12
43143,5755,2812,2943,868,1505,439,963,1445,535
43144,470,228,242,72,118,38,77,103,62
43145,1997,1004,993,310,514,180,256,500,237
43146,13332,9574,3758,1837,7152,585,1080,2161,517
43147,28277,14011,14266,5347,7602,1062,4916,8047,1303
43148,1859,875,984,306,444,125,338,454,192
43149,2529,1262,1267,364,750,148,370,677,220
43150,1841,915,926,318,513,84,321,481,124
43151,271,120,151,33,65,22,43,67,41
43152,1193,596,597,207,310,79,171,330,96
43153,966,485,481,149,245,91,142,232,107
43154,2500,1263,1237,440,695,128,396,723,118
43155,2251,1113,1138,383,591,139,324,656,158
43156,286,139,147,46,77,16,54,64,29
43157,397,173,224,63,78,32,97,90,37
43158,126,64,62,22,30,12,15,35,12
43160,21994,10738,11256,3388,5427,1923,3089,5593,2574
43162,6906,3394,3512,1156,1728,510,1055,1799,658
43164,2243,1086,1157,362,583,141,358,617,182
43201,33201,18695,14506,7055,11022,618,6906,6913,687
43202,19943,10347,9596,2519,7273,555,2336,6331,929
43203,10259,4507,5752,1962,1849,696,1989,2526,1237
43204,39832,19354,20478,6099,10948,2307,5962,10967,3549
43205,14707,7119,7588,2643,3684,792,2553,3856,1179
43206,24674,12064,12610,3957,6790,1317,3791,7000,1819
43207,44183,21388,22795,7187,10794,3407,6724,11697,4374
43209,28821,13423,15398,4507,6906,2010,4523,7772,3103
43210,9735,4856,4879,4117,735,4,4209,639,31
43211,25074,11700,13374,5182,5274,1244,4705,6716,1953
43212,17874,8620,9254,1766,5857,997,1780,5928,1546
43213,30748,14844,15904,4665,8097,2082,4179,8796,2929
43214,25574,11787,13787,2480,7263,2044,2511,7620,3656
43215,10116,5635,4481,782,4261,592,813,2692,976
43217,2697,1469,1228,761,678,30,520,677,31
43219,20501,8945,11556,3522,3905,1518,3703,5266,2587
43220,24173,11686,12487,2549,6969,2168,2626,7042,2819
43221,29700,14190,15510,4477,7595,2118,4217,8436,2857
43222,5994,2974,3020,972,1687,315,1147,1455,418
43223,27261,13146,14115,4727,7017,1402,4552,7432,2131
43224,41030,19790,21240,6702,10686,2402,6530,11106,3604
43227,23256,10798,12458,3636,5452,1710,3469,6643,2346
43228,47282,23522,23760,7858,13528,2136,7471,13133,3156
43229,45780,21892,23888,6382,12936,2574,6611,13577,3700
43230,48997,23401,25596,7648,13633,2120,7771,14698,3127
43231,16809,7980,8829,2461,4789,730,2491,5135,1203
43232,40146,19310,20836,6737,10775,1798,6293,11695,2848
43235,37577,18215,19362,4942,11266,2007,4690,11752,2920
43240,1097,500,597,72,392,36,64,468,65
43302,54175,28157,26018,8163,16030,3964,7315,13093,5610
43310,3216,1686,1530,600,805,281,400,824,306
43311,18866,9132,9734,3085,4748,1299,3071,4809,1854
43314,3352,1638,1714,495,890,253,522,892,300
43315,6487,3279,3208,1222,1658,399,1064,1688,456
43316,6528,3217,3311,1114,1597,506,1022,1615,674
43317,115,43,72,17,21,5,14,18,40
43318,3481,1705,1776,669,829,207,667,822,287
43319,1018,501,517,155,277,69,175,279,63
43320,1389,708,681,256,375,77,225,344,112
43321,356,188,168,48,111,29,39,80,49
43322,339,192,147,62,96,34,39,75,33
43323,776,404,372,100,199,105,95,181,96
43324,2485,1262,1223,322,723,217,355,613,255
43326,14153,6852,7301,2255,3554,1043,2103,3602,1596
43331,5560,2763,2797,721,1302,740,662,1375,760
43332,2261,1178,1083,451,525,202,351,506,226
43333,797,402,395,108,247,47,115,203,77
43334,5615,2828,2787,901,1453,474,876,1493,418
43336,51,27,24,11,4,12,4,10,10
43337,1027,503,524,152,233,118,148,283,93
43338,9460,4587,4873,1393,2384,810,1439,2415,1019
43340,1438,702,736,190,364,148,206,357,173
43341,928,467,461,152,258,57,143,267,51
43342,3330,1647,1683,546,859,242,537,855,291
43343,1555,744,811,272,359,113,251,408,152
43344,5509,2739,2770,940,1416,383,912,1350,508
43345,1008,524,484,208,245,71,178,238,68
43347,1324,639,685,194,360,85,264,300,121
43348,2476,1173,1303,341,536,296,334,659,310
43350,60,32,28,17,15,0,11,12,5
43351,10281,4870,5411,1472,2539,859,1515,2484,1412
43356,1018,481,537,149,275,57,149,297,91
43357,4608,2131,2477,753,1076,302,747,1180,550
43358,2582,1315,1267,464,701,150,367,746,154
43359,905,475,430,180,217,78,137,212,81
43360,1344,702,642,232,376,94,187,363,92
43402,35899,17071,18828,7323,8192,1556,8593,8068,2167
43406,2043,986,1057,319,533,134,352,513,192
43407,627,326,301,99,165,62,94,159,48
43408,294,164,130,61,90,13,34,79,17
43410,9918,4951,4967,1568,2620,763,1462,2564,941
43412,4504,2256,2248,708,1227,321,611,1275,362
43413,1544,769,775,258,381,130,251,398,126
43416,2846,1359,1487,391,708,260,423,715,349
43420,32199,15484,16715,5176,7642,2666,4919,8164,3632
43430,4949,2439,2510,779,1243,417,663,1241,606
43431,4533,2260,2273,767,1188,305,692,1161,420
43432,1395,772,623,307,377,88,164,372,87
43435,1524,760,764,246,398,116,215,397,152
43437,191,98,93,34,57,7,30,53,10
43438,347,172,175,31,83,58,17,92,66
43439,60,6,54,0,6,0,23,23,8
43440,4303,2129,2174,492,1024,613,409,1055,710
43442,1113,545,568,138,290,117,163,258,147
43443,1594,756,838,258,403,95,272,445,121
43445,1205,624,581,249,293,82,248,280,53
43447,3450,1737,1713,457,988,292,490,940,283
43449,8426,4102,4324,1239,2184,679,1261,2152,911
43450,3626,1766,1860,593,855,318,552,834,474
43451,1230,606,624,193,344,69,194,330,100
43452,14062,6876,7186,1813,3505,1558,1729,3553,1904
43456,764,403,361,78,218,107,76,211,74
43457,1679,826,853,251,448,127,291,440,122
43458,386,207,179,90,99,18,68,87,24
43460,6295,3005,3290,964,1558,483,891,1707,692
43462,1049,516,533,151,298,67,170,308,55
43464,1498,787,711,304,413,70,174,460,77
43465,5013,2403,2610,711,1202,490,711,1276,623
43466,1997,987,1010,313,545,129,349,506,155
43467,18,10,8,5,4,1,2,4,2
43468,206,111,95,39,50,22,21,54,20
43469,3028,1438,1590,488,715,235,466,758,366
43501,955,497,458,169,245,83,126,234,98
43502,7139,3525,3614,1217,1680,628,1136,1657,821
43504,948,452,496,123,241,88,152,231,113
43506,15093,7363,7730,2266,3859,1238,2173,3859,1698
43511,878,421,457,134,224,63,128,230,99
43512,29507,14485,15022,4821,7648,2016,4599,7570,2853
43515,8022,3992,4030,1213,2199,580,1264,2104,662
43516,3013,1515,1498,495,756,264,386,711,401
43517,3710,1844,1866,648,906,290,564,903,399
43518,2924,1371,1553,438,751,182,583,725,245
43521,2872,1416,1456,493,718,205,480,698,278
43522,3537,1791,1746,612,947,232,498,952,296
43524,1384,676,708,239,316,121,233,336,139
43525,603,290,313,114,158,18,116,155,42
43526,6103,2957,3146,993,1456,508,1040,1430,676
43527,2412,1244,1168,438,644,162,311,610,247
43528,14239,6906,7333,2137,3810,959,2131,3826,1376
43529,300,155,145,57,88,10,49,80,16
43531,123,55,68,18,37,0,16,42,10
43532,4054,2062,1992,775,1064,223,706,981,305
43533,1532,778,754,303,338,137,243,367,144
43534,1723,881,842,312,459,110,255,436,151
43535,824,423,401,175,178,70,122,209,70
43536,447,220,227,90,130,0,96,117,14
43537,24519,11909,12610,3629,6590,1690,3434,6866,2310
43540,1272,661,611,278,319,64,198,320,93
43541,196,101,95,47,41,13,36,38,21
43542,2521,1243,1278,396,667,180,417,651,210
43543,8182,3978,4204,1351,1966,661,1257,2085,862
43545,14814,7172,7642,2417,3613,1142,2256,3743,1643
43547,122,66,56,19,32,15,11,31,14
43548,701,363,338,123,177,63,95,174,69
43549,1333,698,635,210,356,132,174,342,119
43551,33363,16313,17050,5624,8722,1967,5098,9052,2900
43553,142,71,71,32,28,11,19,40,12
43554,2589,1291,1298,390,676,225,403,669,226
43555,167,71,96,24,32,15,15,27,54
43556,1866,940,926,315,477,148,320,469,137
43557,3364,1891,1473,575,1100,216,501,768,204
43558,13871,6918,6953,2269,3732,917,2182,3647,1124
43560,28426,13435,14991,4633,6953,1849,4800,7615,2576
43565,323,155,168,49,87,19,66,82,20
43566,6633,3171,3462,1008,1668,495,1077,1732,653
43567,12855,6210,6645,2235,3185,790,2178,3318,1149
43569,2934,1428,1506,498,790,140,541,794,171
43570,3628,1830,1798,686,886,258,571,862,365
43571,5405,2621,2784,909,1417,295,899,1485,400
43602,3860,1687,2173,954,592,141,959,1010,204
43604,5391,2663,2728,913,1384,366,939,1319,470
43605,31927,15396,16531,6077,7633,1686,5725,8106,2700
43606,28182,13318,14864,4993,6579,1746,4736,6924,3204
43607,26472,12528,13944,4694,5886,1948,4410,6638,2896
43608,18658,8748,9910,3658,3927,1163,3568,4762,1580
43609,27681,13736,13945,5380,6965,1391,4892,7235,1818
43610,6948,3259,3689,1311,1593,355,1384,1900,405
43611,21514,10308,11206,3431,5311,1566,3455,5675,2076
43612,31694,15563,16131,5126,8456,1981,4908,8308,2915
43613,33774,16191,17583,5014,8816,2361,4881,9078,3624
43614,30206,14101,16105,3741,7656,2704,3625,8096,4384
43615,39270,18992,20278,5416,10835,2741,5134,11176,3968
43616,16753,8057,8696,2394,4177,1486,2384,4223,2089
43617,7781,3767,4014,1231,2037,499,1306,2115,593
43618,3007,1494,1513,521,751,222,464,759,290
43619,7760,3808,3952,1340,2027,441,1315,2057,580
43620,6480,3128,3352,1148,1633,347,1044,1727,581
43623,20921,9963,10958,2853,5166,1944,2728,5426,2804
43624,2227,1155,1072,219,707,229,255,480,337
43701,55593,26418,29175,8459,13318,4641,8307,14094,6774
43713,7347,3419,3928,1102,1719,598,1089,1855,984
43716,2109,1105,1004,325,587,193,297,506,201
43717,164,76,88,26,35,15,29,45,14
43718,5348,3709,1639,690,2788,231,438,926,275
43719,2734,1320,1414,422,698,200,413,715,286
43720,1233,596,637,189,324,83,242,295,100
43721,131,54,77,8,35,11,5,32,40
43722,378,178,200,49,104,25,59,97,44
43723,5396,2588,2808,927,1274,387,904,1402,502
43724,8642,5242,3400,1220,3416,606,984,1538,878
43725,21110,10098,11012,3316,5067,1715,3069,5414,2529
43727,1160,684,476,244,319,121,105,266,105
43728,1348,634,714,201,342,91,186,410,118
43730,2222,1111,1111,356,528,227,317,575,219
43731,5831,2915,2916,1007,1513,395,915,1462,539
43732,1744,927,817,277,484,166,224,415,178
43734,1099,461,638,134,285,42,195,325,118
43735,463,173,290,56,90,27,127,111,52
43738,173,85,88,30,52,3,28,49,11
43739,2260,1109,1151,403,592,114,498,483,170
43740,199,113,86,45,52,16,16,45,25
43746,1335,669,666,194,405,70,207,373,86
43747,1036,518,518,192,229,97,112,296,110
43748,2990,1563,1427,628,787,148,461,793,173
43749,2387,1248,1139,360,657,231,292,610,237
43754,1368,661,707,209,333,119,200,321,186
43755,1820,898,922,272,456,170,257,474,191
43756,5621,2670,2951,859,1219,592,856,1267,828
43758,3168,1588,1580,477,777,334,504,750,326
43760,1596,937,659,348,481,108,104,421,134
43762,5313,2498,2815,1066,1123,309,1259,1062,494
43764,8155,4067,4088,1415,2133,519,1311,1995,782
43766,1521,768,753,249,376,143,248,365,140
43767,1525,707,818,190,404,113,298,412,108
43768,191,89,102,26,45,18,29,55,18
43771,1963,998,965,369,475,154,293,496,176
43772,1989,905,1084,278,484,143,326,544,214
43773,2910,1412,1498,477,654,281,548,690,260
43777,4667,2270,2397,819,1118,333,731,1219,447
43778,1454,695,759,326,304,65,330,341,88
43779,932,460,472,133,214,113,140,234,98
43780,2190,1099,1091,256,598,245,329,526,236
43782,792,402,390,162,209,31,134,203,53
43783,4143,1994,2149,654,1013,327,595,1086,468
43787,3126,1616,1510,520,858,238,453,771,286
43788,999,517,482,214,223,80,198,221,63
43791,14,5,9,0,0,5,0,0,9
43793,5474,2633,2841,791,1304,538,818,1299,724
43802,1104,545,559,208,274,63,206,284,69
43804,3454,1746,1708,900,651,195,748,701,259
43811,897,431,466,149,204,78,147,237,82
43812,19889,9529,10360,2936,4804,1789,2915,4876,2569
43821,4099,1985,2114,652,1044,289,679,1110,325
43822,4117,2031,2086,644,1116,271,655,1145,286
43824,3227,1683,1544,608,856,219,601,722,221
43830,5336,2606,2730,921,1391,294,913,1434,383
43832,7676,3714,3962,1225,1774,715,1178,1890,894
43837,1857,968,889,317,491,160,272,449,168
43840,867,420,447,128,215,77,113,216,118
43842,305,159,146,53,88,18,36,83,27
43843,934,484,450,191,205,88,105,232,113
43844,3812,1924,1888,593,1023,308,610,952,326
43845,4849,2347,2502,697,1242,408,661,1311,530
43901,2376,1162,1214,300,602,260,243,657,314
43902,178,89,89,16,50,23,29,50,10
43903,2564,1249,1315,368,615,266,384,602,329
43905,199,80,119,4,57,19,49,40,30
43906,9849,4664,5185,1394,2384,886,1288,2457,1440
43907,5700,2697,3003,812,1361,524,723,1532,748
43908,1565,802,763,265,428,109,217,392,154
43909,65,29,36,4,13,12,0,14,22
43910,3774,1891,1883,542,1008,341,484,994,405
43912,6825,3234,3591,911,1653,670,858,1694,1039
43913,1739,773,966,221,392,160,252,499,215
43914,89,34,55,5,20,9,25,24,6
43915,1958,976,982,264,533,179,269,499,214
43917,3182,1552,1630,406,800,346,364,788,478
43920,25717,12284,13433,3936,6058,2290,3737,6440,3256
43925,142,43,99,20,23,0,63,36,0
43926,300,155,145,53,80,22,42,79,24
43927,45,24,21,6,18,0,4,17,0
43928,68,30,38,8,17,5,10,16,12
43930,782,382,400,142,173,67,141,179,80
43932,1011,533,478,154,274,105,131,254,93
43933,1840,908,932,236,516,156,261,484,187
43934,482,214,268,57,98,59,72,96,100
43935,9416,4304,5112,1254,2083,967,1306,2433,1373
43938,6547,3189,3358,884,1659,646,768,1681,909
43939,438,212,226,73,100,39,80,99,47
43940,364,149,215,61,54,34,52,113,50
43942,2547,1252,1295,328,661,263,295,638,362
43943,4142,1996,2146,547,1021,428,532,1075,539
43944,2531,1248,1283,321,659,268,292,687,304
43945,3310,1680,1630,556,878,246,498,865,267
43946,2064,1016,1048,216,576,224,228,588,232
43947,5260,2470,2790,610,1239,621,585,1316,889
43948,645,311,334,115,141,55,88,180,66
43950,12768,6000,6768,1613,3143,1244,1543,3247,1978
43951,184,79,105,15,34,30,35,21,49
43952,20974,9613,11361,2842,4662,2109,3045,5182,3134
43953,11036,5337,5699,1456,2689,1192,1234,2843,1622
43961,278,127,151,31,53,43,30,67,54
43962,42,18,24,8,7,3,7,11,6
43963,1275,561,714,120,296,145,165,291,258
43964,10332,4837,5495,1421,2532,884,1346,2877,1272
43967,23,8,15,0,8,0,0,10,5
43968,8072,3855,4217,1194,1990,671,1211,2044,962
43971,1276,616,660,186,276,154,144,294,222
43972,104,57,47,15,38,4,8,39,0
43973,1966,973,993,257,475,241,264,514,215
43974,99,54,45,17,23,14,7,17,21
43976,1443,744,699,223,350,171,173,343,183
43977,2475,1281,1194,418,654,209,279,641,274
43981,372,167,205,52,83,32,44,96,65
43983,254,126,128,8,71,47,27,62,39
43986,2128,1076,1052,310,532,234,269,548,235
43988,2549,1269,1280,354,640,275,320,595,365
44001,20982,10199,10783,3267,5248,1684,3115,5440,2228
44003,4624,2269,2355,657,1182,430,707,1141,507
44004,35799,17130,18669,5518,8677,2935,5118,9381,4170
44010,1680,810,870,206,465,139,229,420,221
44011,11434,5560,5874,1749,2959,852,1700,3104,1070
44012,18301,8935,9366,3048,4742,1145,2786,4836,1744
44017,19015,8968,10047,3023,4586,1359,3185,4684,2178
44021,6886,3452,3434,1188,1858,406,1066,1769,599
44022,17947,8669,9278,2810,4107,1752,2497,4611,2170
44023,13922,6973,6949,2446,3595,932,2144,3737,1068
44024,22866,11126,11740,3545,5982,1599,3265,6143,2332
44026,12229,6011,6218,1797,2883,1331,1699,3233,1286
44028,10162,5979,4183,1573,3824,582,1239,2288,656
44030,16098,7832,8266,2461,3949,1422,2390,3986,1890
44032,1555,768,787,263,393,112,255,403,129
44035,65822,31794,34028,10207,16791,4796,9907,17460,6661
44039,22098,10841,11257,3250,6062,1529,3141,6293,1823
44040,2829,1362,1467,339,684,339,388,766,313
44041,15470,7620,7850,2293,4095,1232,2210,3991,1649
44044,13712,7844,5868,2002,4994,848,1797,3149,922
44046,2015,952,1063,349,481,122,354,518,191
44047,9407,4549,4858,1484,2339,726,1474,2371,1013
44048,2485,1228,1257,384,625,219,335,582,340
44049,81,49,32,15,28,6,8,18,6
44050,5947,2952,2995,989,1594,369,950,1683,362
44052,32999,15542,17457,5803,7510,2229,5679,8584,3194
44053,16944,7824,9120,2068,4136,1620,2391,4514,2215
44054,11955,5795,6160,1825,3226,744,1926,3397,837
44055,22739,10917,11822,4294,5073,1550,3984,5818,2020
44056,9235,4554,4681,1420,2609,525,1465,2598,618
44057,18958,9319,9639,2930,5137,1252,2818,5209,1612
44060,63721,30972,32749,9615,16889,4468,9163,17639,5947
44062,14298,7016,7282,3423,2954,639,3405,2962,915
44064,1548,800,748,246,412,142,190,401,157
44065,3962,1938,2024,551,1128,259,643,1062,319
44067,17824,8622,9202,2233,4913,1476,2216,5095,1891
44070,34112,16542,17570,5024,8658,2860,4502,9157,3911
44072,3936,1955,1981,511,1040,404,466,1058,457
44074,11811,5354,6457,2053,2575,726,2541,2629,1287
44076,4522,2281,2241,899,1075,307,751,1094,396
44077,50611,24924,25687,7890,13642,3392,7506,13730,4451
44080,104,76,28,36,35,5,0,20,8
44081,6582,3291,3291,1141,1669,481,1067,1708,516
44082,1467,717,750,267,367,83,267,343,140
44084,3690,1834,1856,569,996,269,592,1004,260
44085,3025,1535,1490,545,825,165,487,800,203
44086,2336,1186,1150,365,672,149,372,636,142
44087,18209,8736,9473,2793,4868,1075,2668,5263,1542
44089,16161,7912,8249,2390,4268,1254,2281,4400,1568
44090,11125,5570,5555,1917,2809,844,1615,2924,1016
44092,17894,8712,9182,2281,4384,2047,1985,4515,2682
44093,1617,825,792,320,367,138,255,403,134
44094,34408,16184,18224,4307,8798,3079,4194,9378,4652
44095,35235,17104,18131,4998,9079,3027,4650,9203,4278
44099,1527,757,770,285,373,99,298,344,128
44102,52229,26067,26162,9350,13994,2723,8936,13322,3904
44103,25581,12273,13308,4907,5484,1882,4710,6145,2453
44104,29057,12973,16084,6487,4919,1567,6044,7611,2429
44105,55006,25694,29312,9782,12502,3410,9752,14609,4951
44106,32127,15237,16890,5401,7497,2339,4950,8185,3755
44107,56701,27129,29572,7426,16521,3182,6939,17224,5409
44108,36502,16404,20098,6862,6850,2692,6645,9067,4386
44109,45759,21969,23790,7316,12140,2513,7708,12220,3862
44110,26584,12030,14554,4740,5658,1632,4632,7365,2557
44111,42939,20801,22138,6307,11799,2695,6036,12064,4038
44112,32893,14562,18331,5728,6731,2103,5772,9080,3479
44113,19386,10840,8546,3242,6700,898,2632,4676,1238
44114,3713,1993,1720,327,1322,344,305,913,502
44115,8216,3378,4838,1896,1305,177,2042,2555,241
44116,21084,9435,11649,2460,4718,2257,2456,5336,3857
44117,12068,5293,6775,1532,2425,1336,1367,3083,2325
44118,45554,21519,24035,7377,11371,2771,7376,12600,4059
44119,13702,6386,7316,1607,3609,1170,1799,3649,1868
44120,47125,20826,26299,7284,10399,3143,7778,13358,5163
44121,35222,16145,19077,5194,8443,2508,4995,10286,3796
44122,35174,15875,19299,4513,7190,4172,4261,8802,6236
44123,18224,8403,9821,2576,4495,1332,2467,5147,2207
44124,40399,18666,21733,4474,9236,4956,4074,10147,7512
44125,29873,14180,15693,4459,7149,2572,3877,7601,4215
44126,17258,8119,9139,2253,4220,1646,2116,4569,2454
44127,8419,4026,4393,1617,1856,553,1687,2129,577
44128,33265,14842,18423,4900,6877,3065,4748,9165,4510
44129,29675,13997,15678,3905,7517,2575,4047,7571,4060
44130,53472,25278,28194,6422,13028,5828,5991,13739,8464
44131,20758,10063,10695,2522,4853,2688,2343,4926,3426
44132,15157,7103,8054,2010,3797,1296,2011,4146,1897
44133,28669,13963,14706,4104,7883,1976,3950,8098,2658
44134,40476,19440,21036,5408,9977,4055,4977,9917,6142
44135,28695,13831,14864,4128,7456,2247,4147,7511,3206
44136,43861,21364,22497,6602,11644,3118,6428,12228,3841
44137,26109,12254,13855,4105,6169,1980,3704,7051,3100
44138,17940,8519,9421,2499,4592,1428,2519,4739,2163
44139,22229,10795,11434,3825,5520,1450,3649,6066,1719
44140,16052,7608,8444,2326,4019,1263,2314,4299,1831
44141,13584,6754,6830,1668,3531,1555,1805,3433,1592
44142,21146,10342,10804,3100,5198,2044,2588,5494,2722
44143,23764,11393,12371,3270,5686,2437,2872,6355,3144
44144,21765,10466,11299,2614,5853,1999,2436,5803,3060
44145,32101,15170,16931,4390,8016,2764,3903,8722,4306
44146,31629,14786,16843,3940,8064,2782,3936,8846,4061
44147,15967,7712,8255,2356,4000,1356,2202,4280,1773
44201,6878,3537,3341,1151,1861,525,1031,1775,535
44202,16953,8238,8715,2514,4301,1423,2303,4620,1792
44203,42059,20003,22056,6247,10153,3603,5988,10940,5128
44212,38493,18969,19524,6440,10504,2025,6086,10960,2478
44214,2170,1152,1018,388,615,149,285,567,166
44215,1873,994,879,323,552,119,219,525,135
44216,9181,4590,4591,1437,2451,702,1328,2464,799
44217,3901,2006,1895,599,1090,317,554,987,354
44221,30990,14812,16178,4210,8314,2288,4068,8725,3385
44223,17742,8289,9453,2369,4318,1602,2376,4689,2388
44224,35687,17347,18340,5546,9369,2432,4935,10004,3401
44230,7918,3921,3997,1177,2121,623,1175,2067,755
44231,8298,4133,4165,1375,2202,556,1347,2210,608
44233,6782,3425,3357,1087,1827,511,931,1889,537
44234,4084,2032,2052,866,860,306,803,946,303
44235,1821,864,957,357,427,80,400,462,95
44236,24344,12178,12166,4728,6092,1358,4033,6439,1694
44240,34943,16774,18169,5473,9416,1885,6027,9482,2660
44241,13237,6458,6779,1940,3726,792,1841,3855,1083
44243,5310,2121,3189,1829,292,0,2895,294,0
44250,1069,544,525,223,258,63,170,285,70
44251,396,181,215,63,86,32,78,99,38
44253,3407,1786,1621,655,885,246,564,864,193
44254,5164,2547,2617,786,1322,439,734,1360,523
44255,8244,4165,4079,1351,2300,514,1238,2211,630
44256,51615,25193,26422,8319,13932,2942,8206,14420,3796
44260,14137,7115,7022,2153,3855,1107,1948,3853,1221
44262,5544,2704,2840,823,1413,468,744,1494,602
44264,2452,1272,1180,374,652,246,241,689,250
44266,33997,16544,17453,5030,9006,2508,5117,9141,3195
44270,8632,4175,4457,1441,2094,640,1338,2221,898
44272,4201,2125,2076,724,1069,332,565,1097,414
44273,6914,3333,3581,1018,1795,520,1092,1867,622
44275,2825,1500,1325,528,779,193,382,768,175
44276,1952,1044,908,393,497,154,299,485,124
44278,17169,8334,8835,2649,3998,1687,2235,4280,2320
44280,4151,2025,2126,541,1117,367,566,1120,440
44281,26456,12931,13525,4128,6611,2192,3842,6773,2910
44286,5196,2547,2649,761,1329,457,658,1348,643
44287,7202,3643,3559,1266,1907,470,1182,1840,537
44288,4401,2132,2269,842,1049,241,754,1172,343
44301,17102,8074,9028,2705,4306,1063,2827,4568,1633
44302,6393,3085,3308,1002,1856,227,984,1802,522
44303,8038,3855,4183,1100,2085,670,950,2150,1083
44304,6461,3676,2785,1490,1973,213,1249,1279,257
44305,24551,11891,12660,3909,6470,1512,3738,6725,2197
44306,25479,11732,13747,4578,5630,1524,4737,6840,2170
44307,9326,4131,5195,1608,1846,677,1703,2401,1091
44308,928,580,348,12,451,117,35,240,73
44310,23940,11664,12276,3786,6173,1705,3515,6467,2294
44311,11031,5556,5475,2397,2845,314,2441,2550,484
44312,31746,15490,16256,4299,8331,2860,4082,8273,3901
44313,24784,11470,13314,2952,6386,2132,2905,6928,3481
44314,20397,9974,10423,3248,5255,1471,3019,5333,2071
44319,21978,10862,11116,2861,5848,2153,2636,5900,2580
44320,23074,10521,12553,3539,5204,1778,3735,6142,2676
44321,10908,5291,5617,1686,2863,742,1541,3071,1005
44322,337,203,134,77,98,28,19,85,30
44333,18870,9139,9731,2766,4338,2035,2392,4824,2515
44401,3231,1637,1594,391,986,260,436,942,216
44402,3282,1660,1622,525,858,277,461,859,302
44403,4023,1871,2152,507,859,505,471,954,727
44404,1748,877,871,249,496,132,261,466,144
44405,9442,4467,4975,1421,1988,1058,1334,2224,1417
44406,19909,9788,10121,2959,5129,1700,2718,5207,2196
44408,9643,4572,5071,1352,2236,984,1227,2430,1414
44410,17609,8500,9109,2614,4499,1387,2314,4955,1840
44411,2747,1375,1372,461,751,163,432,748,192
44412,2765,1404,1361,504,680,220,412,712,237
44413,7795,3775,4020,1172,1899,704,1058,1994,968
44417,1825,900,925,252,471,177,287,488,150
44418,1384,653,731,187,333,133,193,410,128
44420,16488,7835,8653,2389,3939,1507,2169,4307,2177
44423,2439,1210,1229,379,666,165,372,699,158
44425,15854,7756,8098,2298,4060,1398,2105,4078,1915
44427,1616,776,840,245,388,143,288,438,114
44428,3396,1652,1744,481,854,317,499,836,409
44429,2819,1402,1417,415,767,220,402,793,222
44430,5824,3653,2171,824,2435,394,624,1123,424
44431,4982,2585,2397,944,1267,374,754,1248,395
44432,14083,8270,5813,1757,5431,1082,1567,3093,1153
44436,4283,2079,2204,607,1011,461,572,1024,608
44437,4813,2311,2502,748,1214,349,732,1300,470
44438,5763,2837,2926,755,1575,507,733,1503,690
44440,4336,1995,2341,580,1122,293,705,1247,389
44441,1475,780,695,211,478,91,226,380,89
44442,3529,1623,1906,418,865,340,512,890,504
44443,2072,987,1085,267,520,200,316,535,234
44444,10804,5166,5638,1403,2839,924,1522,2868,1248
44445,3467,1740,1727,589,934,217,522,906,299
44446,23152,11079,12073,3239,5876,1964,2963,6025,3085
44449,1262,677,585,202,364,111,173,336,76
44450,2084,1061,1023,393,546,122,354,515,154
44451,3186,1632,1554,477,943,212,472,811,271
44452,2945,1492,1453,464,704,324,380,736,337
44454,1256,615,641,238,347,30,185,411,45
44455,1659,822,837,251,453,118,246,464,127
44460,26986,12796,14190,3870,6719,2207,3899,6985,3306
44470,3495,1751,1744,471,948,332,464,940,340
44471,12037,5675,6362,1781,2778,1116,1695,2865,1802
44473,4305,2186,2119,621,1122,443,554,1108,457
44481,11781,6044,5737,1668,3396,980,1507,3151,1079
44483,28383,13221,15162,4041,6657,2523,3957,7216,3989
44484,24295,11546,12749,3549,5901,2096,3387,6477,2885
44485,19668,9106,10562,3250,4247,1609,3262,4978,2322
44490,776,381,395,131,183,67,107,217,71
44491,3090,1574,1516,586,825,163,490,824,202
44502,11978,5774,6204,2046,2593,1135,1755,2777,1672
44503,972,666,306,51,495,120,20,153,133
44504,6068,2889,3179,1066,1336,487,943,1294,942
44505,21880,11306,10574,3285,5991,2030,3078,4974,2522
44506,3730,1750,1980,649,855,246,654,879,447
44507,9130,4197,4933,1847,1848,502,1894,2248,791
44509,13635,6241,7394,1921,3074,1246,1881,3389,2124
44510,3113,1328,1785,544,580,204,598,836,351
44511,23267,10765,12502,3245,5177,2343,3257,5796,3449
44512,35823,16698,19125,4484,8758,3456,4459,9517,5149
44514,22079,10559,11520,3050,5353,2156,2823,5609,3088
44515,28863,13743,15120,3989,7130,2624,3752,7668,3700
44601,37050,17487,19563,5925,8565,2997,6066,8912,4585
44606,7516,3774,3742,1624,1749,401,1512,1771,459
44608,2774,1386,1388,440,720,226,365,667,356
44609,4049,1994,2055,597,1101,296,563,1065,427
44610,209,88,121,16,36,36,16,51,54
44611,2066,1050,1016,416,508,126,360,494,162
44612,5200,2574,2626,818,1406,350,751,1501,374
44613,2353,1151,1202,403,547,201,321,554,327
44614,11709,5686,6023,1863,3161,662,1832,3200,991
44615,10935,5294,5641,1655,2666,973,1553,2944,1144
44618,6748,3416,3332,1312,1597,507,1154,1610,568
44619,27,23,4,12,6,5,0,0,4
44620,1475,750,725,224,415,111,184,407,134
44621,5026,2526,2500,832,1303,391,757,1264,479
44622,17865,8503,9362,2633,4313,1557,2464,4488,2410
44624,4305,2225,2080,1022,1058,145,850,1001,229
44625,1920,980,940,380,483,117,313,448,179
44626,3158,1568,1590,409,870,289,420,822,348
44627,5884,3055,2829,1680,1118,257,1351,1188,290
44628,1237,605,632,164,330,111,181,339,112
44629,2160,1059,1101,360,503,196,314,501,286
44632,9554,4821,4733,1649,2495,677,1353,2570,810
44633,2588,1326,1262,579,594,153,526,569,167
44634,2070,1096,974,377,544,175,310,507,157
44637,2537,1214,1323,417,605,192,411,675,237
44638,1443,739,704,250,376,113,256,337,111
44640,99,56,43,19,24,13,10,23,10
44641,20133,9827,10306,2990,5091,1746,2944,5038,2324
44643,3131,1637,1494,516,766,355,431,760,303
44644,5065,2558,2507,796,1325,437,689,1351,467
44645,2576,1300,1276,475,662,163,424,706,146
44646,45572,21971,23601,7239,11229,3503,6564,12300,4737
44647,17374,8404,8970,2442,4387,1575,2205,4587,2178
44651,901,477,424,180,233,64,117,197,110
44653,281,136,145,45,74,17,38,84,23
44654,18038,8961,9077,3816,4090,1055,3704,3931,1442
44656,3010,1469,1541,458,771,240,460,802,279
44657,10266,5071,5195,1509,2626,936,1476,2560,1159
44659,66,32,34,7,23,2,6,18,10
44661,161,91,70,28,43,20,9,47,14
44662,9433,4531,4902,1196,2342,993,1278,2431,1193
44663,25658,12375,13283,3576,6666,2133,3592,6738,2953
44666,2795,1363,1432,366,803,194,486,739,207
44667,13598,6689,6909,2394,3384,911,2054,3567,1288
44669,1699,850,849,342,412,96,304,423,122
44670,145,94,51,34,40,20,5,36,10
44671,367,167,200,61,74,32,44,110,46
44672,5320,2412,2908,678,1134,600,627,1163,1118
44675,1761,903,858,263,448,192,219,446,193
44676,4747,2385,2362,833,1264,288,731,1230,401
44677,2645,1261,1384,423,640,198,490,668,226
44678,242,129,113,58,57,14,31,63,19
44680,3659,1785,1874,549,927,309,551,932,391
44681,7504,3658,3846,1479,1601,578,1421,1696,729
44682,697,329,368,108,177,44,110,167,91
44683,8967,4295,4672,1447,2181,667,1448,2269,955
44685,23482,11563,11919,3712,6216,1635,3564,6393,1962
44688,3480,1709,1771,519,887,303,512,855,404
44689,935,495,440,261,196,38,192,199,49
44690,65,44,21,6,30,8,0,7,14
44691,42596,20545,22051,6773,10576,3196,6849,10730,4472
44693,90,42,48,7,16,19,7,30,11
44695,1655,806,849,208,411,187,188,447,214
44697,233,113,120,41,48,24,43,62,15
44699,928,492,436,154,240,98,117,217,102
44702,1083,500,583,66,301,133,46,285,252
44703,10880,5304,5576,1852,3035,417,1836,2988,752
44704,5046,2479,2567,1071,1029,379,843,1210,514
44705,20634,9864,10770,3656,4913,1295,3443,5338,1989
44706,18915,9346,9569,3012,4969,1365,2725,5063,1781
44707,10590,4950,5640,1959,2232,759,1906,2634,1100
44708,25647,12041,13606,3267,6202,2572,3096,6558,3952
44709,19008,8582,10426,2453,4474,1655,2864,4940,2622
44710,9726,4327,5399,1394,2226,707,1390,2475,1534
44714,9192,4229,4963,1088,2257,884,1122,2468,1373
44718,12406,5921,6485,1650,3185,1086,1574,3510,1401
44720,38196,18610,19586,5728,9663,3219,5122,10106,4358
44721,11867,5881,5986,1908,3064,909,1767,3294,925
44730,6241,3000,3241,834,1601,565,886,1660,695
44802,986,488,498,176,236,76,198,218,82
44804,1185,628,557,258,324,46,173,304,80
44805,32603,15610,16993,5466,7541,2603,5285,7891,3817
44807,2523,1238,1285,405,623,210,392,641,252
44809,287,140,147,58,64,18,40,67,40
44811,13001,6416,6585,2038,3363,1015,1972,3288,1325
44813,7165,3549,3616,1196,1830,523,1172,1829,615
44814,2643,1391,1252,419,765,207,337,700,215
44815,815,409,406,129,204,76,136,194,76
44816,115,60,55,35,25,0,21,34,0
44817,1490,789,701,288,410,91,211,385,105
44818,2795,1412,1383,527,676,209,431,678,274
44820,19122,9272,9850,2764,4829,1679,2758,4877,2215
44822,2977,1462,1515,521,741,200,520,747,248
44824,4144,2013,2131,622,1094,297,627,1072,432
44825,215,116,99,54,55,7,27,54,18
44826,1933,970,963,324,441,205,274,421,268
44827,7255,3587,3668,1179,1779,629,1069,1727,872
44828,82,40,42,5,27,8,5,30,7
44830,20173,9750,10423,3158,5059,1533,3145,4996,2282
44833,18176,8752,9424,2791,4403,1558,2504,4767,2153
44836,2789,1392,1397,532,677,183,419,675,303
44837,4362,2221,2141,821,1076,324,706,1046,389
44838,213,89,124,28,49,12,42,59,23
44839,12229,5885,6344,1684,3123,1078,1625,3217,1502
44840,2760,1379,1381,456,709,214,434,677,270
44841,892,426,466,136,245,45,169,239,58
44842,5927,3009,2918,1096,1483,430,886,1419,613
44843,2377,1239,1138,395,631,213,298,647,193
44844,809,393,416,140,197,56,153,210,53
44846,3419,1680,1739,554,828,298,502,909,328
44847,3630,1802,1828,625,917,260,611,917,300
44849,2189,1094,1095,296,620,178,282,594,219
44850,66,38,28,5,14,19,0,12,16
44851,5182,2656,2526,907,1358,391,795,1250,481
44853,1436,709,727,247,341,121,256,327,144
44854,1960,974,986,313,500,161,262,467,257
44855,1216,628,588,201,369,58,208,292,88
44856,174,81,93,28,41,12,33,45,15
44857,22807,10958,11849,3858,5445,1655,3582,5931,2336
44859,1761,935,826,301,501,133,253,445,128
44860,111,75,36,43,27,5,6,30,0
44861,150,89,61,27,52,10,4,33,24
44864,3113,1583,1530,483,803,297,468,785,277
44865,3576,1783,1793,640,906,237,625,888,280
44866,1969,1007,962,400,497,110,364,475,123
44867,2287,1116,1171,396,601,119,429,580,162
44870,43559,21011,22548,6487,10271,4253,6342,11027,5179
44874,182,87,95,30,44,13,40,41,14
44875,14834,7373,7461,2601,3536,1236,2113,3590,1758
44878,3542,1788,1754,823,789,176,757,800,197
44880,2425,1211,1214,448,578,185,474,565,175
44882,2961,1423,1538,450,796,177,521,746,271
44883,29380,14504,14876,4836,7270,2398,4493,7144,3239
44887,1202,636,566,219,348,69,197,290,79
44889,6423,3259,3164,990,1811,458,939,1754,471
44890,12003,5876,6127,2128,2840,908,1975,3038,1114
44902,6598,3174,3424,1255,1526,393,1256,1599,569
44903,31293,17705,13588,4901,10632,2172,3950,7021,2617
44904,13730,6574,7156,2065,3530,979,2035,3773,1348
44905,12623,6184,6439,1817,3311,1056,1655,3321,1463
44906,17614,8377,9237,2364,4318,1695,2472,4544,2221
44907,15628,7252,8376,2099,3649,1504,2114,3914,2348
45001,957,482,475,191,228,63,176,230,69
45002,12054,5969,6085,2178,3023,768,2093,3072,920
45003,674,352,322,140,160,52,76,181,65
45005,28245,13943,14302,4431,7414,2098,4196,7487,2619
45011,55455,27517,27938,10007,14699,2811,9389,14822,3727
45013,49395,23963,25432,7758,12320,3885,6967,12961,5504
45014,43250,21063,22187,6357,12066,2640,6148,12370,3669
45015,12664,6035,6629,1948,3182,905,1892,3303,1434
45030,15710,7818,7892,2742,4117,959,2510,4106,1276
45032,320,155,165,58,79,18,64,87,14
45033,197,86,111,32,36,18,38,55,18
45034,772,397,375,154,229,14,86,255,34
45036,30792,17281,13511,4647,10926,1708,4081,6812,2618
45039,15084,7344,7740,2327,4199,818,2262,4598,880
45040,34185,16867,17318,6350,9019,1498,5883,9452,1983
45041,242,151,91,46,75,30,7,56,28
45042,27172,13296,13876,3972,7012,2312,3780,7013,3083
45044,44748,21529,23219,7522,11144,2863,7167,11805,4247
45050,5377,2572,2805,741,1368,463,752,1403,650
45052,3986,1949,2037,691,992,266,720,1001,316
45053,2942,1560,1382,563,862,135,476,771,135
45054,1586,812,774,226,475,111,243,432,99
45056,27676,13019,14657,6848,5198,973,8189,5254,1214
45062,413,185,228,51,101,33,67,102,59
45064,2633,1388,1245,433,762,193,329,755,161
45065,2975,1543,1432,515,823,205,441,709,282
45066,16589,8035,8554,2880,4393,762,2846,4799,909
45067,10529,5193,5336,1798,2867,528,1753,2834,749
45068,9048,4520,4528,1502,2384,634,1283,2445,800
45069,42959,21359,21600,7385,12064,1910,7013,12420,2167
45070,203,97,106,44,41,12,26,62,18
45101,2478,1158,1320,377,613,168,415,664,241
45102,19585,9393,10192,3191,5393,809,3418,5564,1210
45103,26347,13482,12865,4988,7173,1321,4309,6988,1568
45106,11880,5853,6027,2080,2975,798,2042,3026,959
45107,8281,3912,4369,1296,2090,526,1427,2149,793
45111,398,199,199,64,111,24,14,125,60
45112,78,45,33,15,19,11,6,19,8
45113,2793,1410,1383,486,759,165,489,736,158
45114,46,30,16,7,15,8,0,9,7
45115,14,0,14,0,0,0,0,0,14
45118,3957,1967,1990,643,1042,282,723,973,294
45120,3615,1758,1857,605,954,199,649,960,248
45121,8138,3923,4215,1293,2009,621,1237,2004,974
45122,11259,5514,5745,1810,2961,743,1895,3126,724
45123,7232,3451,3781,1080,1717,654,1128,1786,867
45130,3683,1857,1826,577,1023,257,585,1001,240
45131,348,176,172,68,80,28,60,83,29
45132,304,157,147,66,67,24,58,69,20
45133,23438,11469,11969,3873,5728,1868,3575,5953,2441
45135,3678,1815,1863,645,949,221,633,992,238
45140,44141,21891,22250,8061,11845,1985,7477,12457,2316
45142,4291,2154,2137,828,1045,281,715,1073,349
45144,4306,2149,2157,674,1078,397,605,1116,436
45146,1440,734,706,253,362,119,259,332,115
45148,1313,653,660,179,395,79,220,361,79
45150,28397,13574,14823,4325,7424,1825,4077,7705,3041
45152,8026,3935,4091,1180,2132,623,1228,2159,704
45153,2032,1049,983,370,542,137,295,546,142
45154,8183,4080,4103,1544,2181,355,1351,2176,576
45155,218,109,109,35,66,8,28,62,19
45156,93,50,43,23,16,11,19,21,3
45157,9210,4661,4549,1690,2406,565,1521,2356,672
45159,2825,1364,1461,417,726,221,482,745,234
45160,828,373,455,151,180,42,132,204,119
45162,2721,1380,1341,496,720,164,445,749,147
45164,248,113,135,33,59,21,48,65,22
45167,3844,1885,1959,580,906,399,523,963,473
45168,1466,678,788,192,371,115,282,376,130
45169,5133,2564,2569,806,1409,349,813,1302,454
45171,5620,2867,2753,962,1415,490,781,1424,548
45172,155,77,78,20,42,15,17,36,25
45174,2293,1149,1144,481,520,148,388,543,213
45176,8039,3966,4073,1277,2247,442,1255,2261,557
45177,21171,10423,10748,3689,5367,1367,3315,5410,2023
45202,5874,3617,2257,359,2817,441,222,1490,545
45203,3372,1812,1560,658,1043,111,616,770,174
45204,7566,3732,3834,1298,2028,406,1311,1951,572
45205,23073,11049,12024,4319,5713,1017,4345,5852,1827
45206,12543,5964,6579,1668,3303,993,1723,3425,1431
45207,9369,3948,5421,2031,1428,489,2465,2045,911
45208,17203,7934,9269,1620,5091,1223,1670,5587,2012
45209,10687,4811,5876,967,3296,548,973,3672,1231
45210,9547,4970,4577,1724,2868,378,1790,2445,342
45211,38343,17756,20587,5589,9672,2495,5915,10347,4325
45212,24547,11870,12677,3744,6590,1536,3595,6619,2463
45213,13583,6158,7425,1843,3192,1123,1862,3936,1627
45214,11284,5348,5936,1968,2743,637,2306,2700,930
45215,31385,14658,16727,4738,7372,2548,4634,8177,3916
45216,9767,4769,4998,1450,2650,669,1444,2501,1053
45217,6311,2971,3340,1028,1419,524,882,1604,854
45218,4338,2069,2269,674,1047,348,651,1155,463
45219,17328,9245,8083,3824,4869,552,3567,3709,807
45220,14528,7464,7064,2006,4669,789,1761,3956,1347
45223,13630,6349,7281,2472,3352,525,2426,4050,805
45224,22921,10331,12590,3555,4727,2049,3136,5907,3547
45225,13230,6028,7202,3196,2356,476,3395,3163,644
45226,6933,3329,3604,747,2171,411,893,2162,549
45227,19016,8688,10328,2969,4408,1311,2848,5424,2056
45229,17838,8063,9775,3189,3644,1230,2936,4908,1931
45230,28279,13567,14712,4034,7457,2076,3778,7850,3084
45231,42218,19815,22403,6953,9730,3132,6360,11378,4665
45232,7622,3174,4448,1823,1179,172,2102,1848,498
45233,15938,7820,8118,2964,3729,1127,2616,3912,1590
45236,25609,11662,13947,3069,6018,2575,3258,6574,4115
45237,23647,10624,13023,3533,5303,1788,3520,6700,2803
45238,47079,22271,24808,7380,11291,3600,6822,12150,5836
45239,28829,13776,15053,4536,7051,2189,4206,7416,3431
45240,28624,13735,14889,5040,7112,1583,4691,8209,1989
45241,24627,11892,12735,3471,6325,2096,3331,6581,2823
45242,22754,10928,11826,3682,5557,1689,3266,6113,2447
45243,15956,7667,8289,2430,3572,1665,2253,3807,2229
45244,26437,13269,13168,4637,7036,1596,4288,7193,1687
45245,15986,7600,8386,2283,4306,1011,2167,4758,1461
45246,13939,6405,7534,1972,3357,1076,1848,3806,1880
45247,20910,10271,10639,3417,5212,1642,3160,5501,1978
45248,22631,10937,11694,3525,5211,2201,3398,5368,2928
45249,13681,6871,6810,2190,3928,753,2060,3827,923
45251,23868,11551,12317,4136,5959,1456,3892,6306,2119
45252,4804,2378,2426,722,1305,351,625,1411,390
45255,22957,10805,12152,3518,5809,1478,3596,6380,2176
45301,146,62,84,20,29,13,17,54,13
45302,3828,1982,1846,769,999,214,680,926,240
45303,2187,1090,1097,366,570,154,352,579,166
45304,7546,3780,3766,1159,2046,575,1109,2021,636
45305,9582,4697,4885,1566,2550,581,1620,2647,618
45306,2358,1192,1166,449,573,170,398,569,199
45307,312,164,148,66,75,23,51,70,27
45308,4825,2379,2446,797,1254,328,758,1243,445
45309,12114,5827,6287,1758,2965,1104,1668,3106,1513
45310,106,59,47,16,34,9,7,27,13
45311,7407,3724,3683,1198,1974,552,1033,1974,676
45312,1409,741,668,232,391,118,150,374,144
45314,5304,2534,2770,1426,899,209,1582,938,250
45315,3555,1844,1711,728,895,221,511,911,289
45316,177,83,94,20,43,20,32,39,23
45317,1103,576,527,143,312,121,128,255,144
45318,5483,2723,2760,915,1389,419,780,1358,622
45320,15003,7333,7670,2242,3869,1222,2202,3728,1740
45321,1067,503,564,186,255,62,207,256,101
45322,20190,9713,10477,2985,5171,1557,2966,5404,2107
45323,5376,2614,2762,702,1416,496,730,1373,659
45324,39549,19121,20428,6827,9758,2536,7018,9959,3451
45325,2513,1232,1281,382,651,199,392,652,237
45326,1151,566,585,183,330,53,208,305,72
45327,8333,4096,4237,1346,2172,578,1264,2209,764
45328,413,201,212,88,83,30,74,109,29
45330,260,150,110,41,88,21,27,57,26
45331,23257,11236,12021,3401,5687,2148,3161,5748,3112
45332,586,310,276,96,155,59,69,155,52
45333,1509,723,786,212,432,79,259,417,110
45334,2078,1014,1064,352,512,150,339,521,204
45335,6931,3437,3494,1241,1706,490,1106,1810,578
45336,100,47,53,18,19,10,22,24,7
45337,2119,1070,1049,329,584,157,325,546,178
45338,5397,2644,2753,848,1406,390,868,1396,489
45339,1313,656,657,185,383,88,187,360,110
45340,730,372,358,113,205,54,102,188,68
45341,4230,2169,2061,666,1010,493,470,1025,566
45342,31569,15421,16148,4628,8765,2028,4628,8757,2763
45344,18004,8928,9076,2882,4675,1371,2719,4648,1709
45345,6685,3339,3346,1134,1739,466,954,1765,627
45346,2569,1246,1323,432,657,157,424,643,256
45347,4449,2192,2257,652,1156,384,668,1147,442
45348,1127,601,526,236,275,90,160,248,118
45349,14,6,8,3,3,0,4,4,0
45351,76,37,39,7,23,7,9,15,15
45352,12,4,8,0,0,4,0,0,8
45353,61,27,34,0,15,12,14,7,13
45354,332,150,182,46,77,27,72,82,28
45356,25334,12311,13023,4039,6411,1861,3624,6587,2812
45358,0,0,0,0,0,0,0,0,0
45359,1948,979,969,333,434,212,318,458,193
45360,234,120,114,29,76,15,40,58,16
45362,1231,645,586,223,320,102,198,269,119
45363,1586,827,759,347,398,82,295,357,107
45365,30278,14834,15444,5074,7672,2088,4685,7809,2950
45368,5103,2502,2601,837,1269,396,763,1341,497
45369,3134,1574,1560,487,878,209,498,825,237
45370,2396,1222,1174,299,720,203,324,663,187
45371,17260,8459,8801,2599,4566,1294,2562,4639,1600
45373,32014,15506,16508,4901,8333,2272,4825,8562,3121
45377,14672,7239,7433,2055,3952,1232,1897,3945,1591
45378,383,195,188,75,97,23,66,95,27
45380,5232,2594,2638,882,1224,488,868,1197,573
45381,6007,3071,2936,1065,1523,483,849,1591,496
45382,1187,594,593,217,293,84,166,323,104
45383,7264,3543,3721,1158,1824,561,1079,1881,761
45384,455,219,236,120,81,18,150,72,14
45385,35405,17200,18205,6037,8584,2579,5581,8946,3678
45387,5599,2606,2993,835,1339,432,798,1576,619
45388,1024,489,535,202,225,62,236,227,72
45389,508,227,281,74,109,44,80,149,52
45390,3697,1779,1918,591,867,321,622,917,379
45402,3180,1992,1188,273,1485,234,174,736,278
45403,16855,8766,8089,2946,4928,892,2301,4358,1430
45404,13095,6227,6868,2410,3104,713,2380,3325,1163
45405,23204,10844,12360,3800,5802,1242,3716,6524,2120
45406,27437,12922,14515,5006,6264,1652,4599,7534,2382
45407,10986,4847,6139,2027,2053,767,2146,2808,1185
45408,11026,4921,6105,2216,1850,855,2121,2697,1287
45409,14487,7121,7366,3830,2770,521,4072,2538,756
45410,17720,8760,8960,2704,4994,1062,2722,4530,1708
45414,21949,10409,11540,3365,5323,1721,3618,5569,2353
45415,12662,6079,6583,1703,3190,1186,1562,3452,1569
45416,6392,2816,3576,951,1377,488,923,1716,937
45417,11518,5249,6269,1855,2276,1118,1971,2710,1588
45418,6824,3808,3016,1092,2160,556,827,1408,781
45419,15270,7254,8016,2313,3807,1134,2113,4322,1581
45420,26435,12517,13918,3324,7180,2013,3213,7368,3337
45424,48525,23783,24742,7943,13068,2772,7545,13773,3424
45426,16667,7577,9090,2526,3788,1263,2327,4787,1976
45427,10931,4983,5948,1957,2206,820,2043,2717,1188
45429,26978,12592,14386,3205,6456,2931,3338,6752,4296
45430,6994,3542,3452,1050,1899,593,854,1832,766
45431,22524,11005,11519,3646,5825,1534,3637,5998,1884
45432,16199,7910,8289,2189,4231,1490,2232,4160,1897
45433,3143,1654,1489,804,850,0,678,811,0
45434,9809,4836,4973,1460,2521,855,1326,2676,971
45439,10754,5059,5695,1506,2778,775,1564,2868,1263
45440,19867,9365,10502,2708,4905,1752,2827,5214,2461
45449,18763,8994,9769,2526,5102,1366,2581,5272,1916
45458,25601,12122,13479,3713,6954,1455,3788,7459,2232
45459,27789,13342,14447,3279,6908,3155,3097,7250,4100
45502,16522,8293,8229,2566,4410,1317,2200,4515,1514
45503,33387,15600,17787,4971,7750,2879,4817,8367,4603
45504,20195,9697,10498,3432,4691,1574,3467,4778,2253
45505,22073,10433,11640,3369,5496,1568,3469,5707,2464
45506,15635,7432,8203,2685,3594,1153,2464,4051,1688
45601,55321,29242,26079,8266,16970,4006,7278,13637,5164
45612,5214,2705,2509,1040,1286,379,798,1336,375
45613,3311,1597,1714,525,817,255,577,892,245
45614,4311,2165,2146,696,1083,386,579,1087,480
45616,1303,646,657,190,321,135,211,347,99
45619,7963,3823,4140,1256,1924,643,1136,2154,850
45620,1170,540,630,181,255,104,202,280,148
45621,220,109,111,48,52,9,44,52,15
45622,341,163,178,52,92,19,48,103,27
45623,3816,1948,1868,668,990,290,592,1011,265
45624,136,93,43,52,34,7,17,26,0
45628,4793,2559,2234,907,1290,362,625,1127,482
45629,3387,1772,1615,681,824,267,471,834,310
45631,15682,7416,8266,2274,3845,1297,2246,4185,1835
45634,2073,1001,1072,319,502,180,330,512,230
45638,22086,10498,11588,3228,5288,1982,3034,5708,2846
45640,15198,7217,7981,2325,3706,1186,2350,3949,1682
45642,44,31,13,7,24,0,5,8,0
45644,4193,2057,2136,660,1115,282,623,1140,373
45645,2748,1275,1473,349,726,200,524,737,212
45646,320,156,164,58,66,32,10,109,45
45647,1807,875,932,245,447,183,269,453,210
45648,13275,7258,6017,1888,4435,935,1758,3048,1211
45650,481,264,217,52,137,75,44,104,69
45651,6036,3008,3028,1080,1516,412,969,1504,555
45652,3684,1814,1870,605,900,309,526,1025,319
45653,4217,2124,2093,729,1077,318,606,1088,399
45654,1065,545,520,182,252,111,155,273,92
45656,6486,3206,3280,1022,1665,519,972,1617,691
45657,2540,1241,1299,419,618,204,452,630,217
45658,2385,1224,1161,490,589,145,407,597,157
45659,3289,1693,1596,634,909,150,541,784,271
45660,7808,3861,3947,1287,1949,625,1322,1909,716
45661,6894,3331,3563,1200,1626,505,1156,1749,658
45662,31189,14512,16677,4748,7113,2651,4233,7887,4557
45663,7144,3526,3618,1196,1798,532,1044,1916,658
45669,10080,4840,5240,1427,2516,897,1399,2714,1127
45671,339,164,175,69,85,10,70,77,28
45672,1581,826,755,250,457,119,267,379,109
45673,375,191,184,47,123,21,19,104,61
45674,809,417,392,271,120,26,257,120,15
45678,1018,565,453,171,294,100,94,274,85
45679,2629,1261,1368,399,641,221,406,687,275
45680,12883,6038,6845,1843,3090,1105,1893,3611,1341
45681,1427,700,727,225,392,83,217,418,92
45682,2433,1217,1216,471,589,157,340,676,200
45684,1694,890,804,250,469,171,246,428,130
45685,858,386,472,120,203,63,178,226,68
45686,3624,1749,1875,567,926,256,614,952,309
45688,552,296,256,128,125,43,89,130,37
45690,14182,6864,7318,2153,3547,1164,2236,3466,1616
45692,9491,4509,4982,1481,2434,594,1519,2433,1030
45693,8266,3946,4320,1213,2045,688,1327,2070,923
45694,11518,5401,6117,1723,2715,963,1779,3034,1304
45695,672,321,351,92,168,61,94,176,81
45696,1491,736,755,252,394,90,307,357,91
45697,4706,2333,2373,832,1172,329,761,1187,425
45698,252,109,143,30,66,13,45,68,30
45701,31262,14890,16372,6981,6770,1139,8444,6316,1612
45710,4874,2473,2401,700,1377,396,656,1325,420
45711,1098,527,571,150,289,88,134,316,121
45712,181,91,90,27,44,20,20,42,28
45713,174,72,102,42,20,10,53,39,10
45714,10148,4721,5427,1277,2570,874,1362,2881,1184
45715,2414,1220,1194,369,595,256,274,576,344
45716,345,160,185,46,94,20,58,100,27
45719,1074,497,577,177,239,81,165,307,105
45723,3441,1761,1680,525,904,332,412,907,361
45724,1419,733,686,236,361,136,168,368,150
45727,506,260,246,95,142,23,79,130,37
45729,1360,631,729,141,361,129,204,405,120
45732,5149,2514,2635,854,1266,394,839,1308,488
45734,820,441,379,172,173,96,93,204,82
45735,1587,835,752,283,399,153,189,424,139
45740,434,197,237,71,100,26,69,112,56
45741,905,406,499,130,229,47,187,248,64
45742,3211,1584,1627,545,812,227,501,851,275
45743,1606,817,789,202,501,114,217,419,153
45744,3051,1511,1540,466,819,226,413,798,329
45745,1145,529,616,124,259,146,159,290,167
45746,463,253,210,105,100,48,59,115,36
45750,28265,13506,14759,4152,7014,2340,4209,7099,3451
45760,3838,1760,2078,525,876,359,588,975,515
45761,1877,946,931,344,515,87,295,497,139
45764,9498,5174,4324,1826,2556,792,1456,2055,813
45766,1430,665,765,205,370,90,260,399,106
45767,2757,1377,1380,370,766,241,362,689,329
45768,2014,1031,983,297,554,180,275,545,163
45769,6748,3253,3495,1030,1726,497,996,1710,789
45770,494,266,228,65,152,49,44,117,67
45771,3634,1770,1864,543,865,362,546,968,350
45772,2027,1014,1013,318,533,163,271,502,240
45773,217,106,111,18,65,23,34,68,9
45775,1214,654,560,216,369,69,131,337,92
45776,726,368,358,146,184,38,93,186,79
45778,1056,533,523,212,282,39,227,257,39
45779,745,352,393,98,191,63,98,206,89
45780,3278,1481,1797,473,751,257,497,843,457
45782,295,157,138,66,79,12,36,89,13
45784,3051,1616,1435,527,888,201,405,811,219
45786,3046,1527,1519,501,759,267,495,762,262
45788,1002,534,468,174,281,79,130,277,61
45789,297,151,146,69,68,14,32,101,13
45801,26915,14780,12135,4445,8710,1625,3894,6126,2115
45804,17498,8128,9370,2841,3903,1384,3033,4282,2055
45805,22820,11014,11806,3900,5171,1943,3268,5603,2935
45806,11116,5300,5816,1666,2736,898,1820,2888,1108
45807,10987,5540,5447,1837,2777,926,1592,2801,1054
45808,350,171,179,53,94,24,52,85,42
45809,199,111,88,26,64,21,19,46,23
45810,8155,4089,4066,1794,1842,453,1788,1809,469
45812,1993,986,1007,303,506,177,277,523,207
45813,3621,1779,1842,599,911,269,546,963,333
45814,2479,1153,1326,399,582,172,467,599,260
45816,302,152,150,54,81,17,55,67,28
45817,6518,3010,3508,1154,1339,517,1238,1423,847
45819,272,131,141,40,66,25,46,69,26
45820,412,188,224,65,94,29,73,113,38
45821,1537,767,770,267,412,88,256,411,103
45822,19469,9702,9767,3299,4776,1627,2942,4671,2154
45827,2476,1297,1179,507,626,164,419,549,211
45828,6393,3159,3234,1220,1468,471,1128,1481,625
45830,6058,2930,3128,963,1512,455,1119,1460,549
45831,3301,1596,1705,558,805,233,538,823,344
45832,3014,1461,1553,516,735,210,535,759,259
45833,11065,5458,5607,1930,2674,854,1728,2613,1266
45835,450,225,225,52,117,56,61,102,62
45836,1541,789,752,285,381,123,215,381,156
45837,90,46,44,20,22,4,19,23,2
45838,37,15,22,9,6,0,15,7,0
45840,51670,25006,26664,8196,13171,3639,8115,13332,5217
45841,1028,550,478,186,311,53,160,238,80
45843,3714,1802,1912,599,958,245,629,986,297
45844,3660,1796,1864,658,908,230,709,839,316
45845,3003,1493,1510,539,761,193,565,722,223
45846,4317,2176,2141,854,1043,279,802,947,392
45849,1278,641,637,214,313,114,206,309,122
45850,3729,1877,1852,630,920,327,546,935,371
45851,694,345,349,123,174,48,149,140,60
45853,985,511,474,176,269,66,138,243,93
45855,207,102,105,34,41,27,39,37,29
45856,5600,2806,2794,1034,1320,452,933,1198,663
45858,2978,1499,1479,554,757,188,514,741,224
45859,427,193,234,65,100,28,69,105,60
45860,2346,1227,1119,533,532,162,446,473,200
45861,254,125,129,51,57,17,54,56,19
45862,1555,785,770,257,397,131,252,381,137
45863,1267,606,661,184,353,69,215,330,116
45865,4701,2364,2337,794,1191,379,706,1091,540
45866,126,71,55,34,33,4,16,35,4
45867,1236,619,617,213,289,117,171,318,128
45868,692,335,357,113,164,58,105,169,83
45869,4601,2329,2272,823,1178,328,774,1102,396
45870,103,39,64,9,26,4,28,19,17
45871,2006,982,1024,302,533,147,269,563,192
45872,4152,1937,2215,637,1004,296,735,1026,454
45873,2366,1176,1190,358,652,166,386,631,173
45874,2384,1160,1224,362,558,240,365,599,260
45875,11211,5492,5719,1933,2785,774,2013,2590,1116
45876,414,201,213,73,93,35,64,86,63
45877,2335,1170,1165,432,562,176,351,567,247
45879,6440,3106,3334,1059,1580,467,1010,1680,644
45880,2379,1148,1231,336,585,227,336,599,296
45881,1301,674,627,230,368,76,204,338,85
45882,2909,1394,1515,413,727,254,386,728,401
45883,3685,1892,1793,788,832,272,711,806,276
45885,12865,6354,6511,2162,3157,1035,1914,3120,1477
45886,574,284,290,103,129,52,88,142,60
45887,4745,2361,2384,733,1217,411,676,1167,541
45888,168,85,83,24,39,22,26,38,19
45889,1191,609,582,217,333,59,157,341,84
45890,679,326,353,107,158,61,131,154,68
45891,15606,7544,8062,2379,3779,1386,2213,3851,1998
45894,712,354,358,134,177,43,126,163,69
45895,18089,8868,9221,2960,4698,1210,2815,4536,1870
45896,2022,994,1028,337,496,161,349,505,174
45897,45,24,21,0,17,7,16,5,0
45898,1364,726,638,310,342,74,210,318,110
45899,194,77,117,9,57,11,38,61,18
46001,12566,6263,6303,2047,3262,954,1906,3151,1246
46011,17558,8430,9128,2567,4315,1548,2307,4634,2187
46012,21059,9981,11078,3110,5086,1785,3185,5401,2492
46013,17994,8533,9461,2420,4250,1863,2135,4492,2834
46016,21602,10480,11122,3715,5441,1324,3394,5631,2097
46017,6208,2961,3247,836,1596,529,903,1700,644
46030,3381,1705,1676,445,943,317,445,938,293
46031,2371,1151,1220,387,678,86,434,647,139
46032,35996,17734,18262,6364,9693,1677,5863,10009,2390
46033,29251,14547,14704,5510,7505,1532,5101,8084,1519
46034,5683,2671,3012,799,1579,293,939,1700,373
46035,1091,546,545,191,301,54,173,289,83
46036,12662,6054,6608,1810,3159,1085,1794,3376,1438
46038,41006,19983,21023,6959,11940,1084,6839,12795,1389
46039,766,386,380,122,181,83,102,192,86
46040,6969,3979,2990,1014,2632,333,940,1498,552
46041,24634,12107,12527,4029,6125,1953,3892,5955,2680
46044,2842,1404,1438,447,726,231,381,734,323
46045,99,44,55,21,23,0,24,31,0
46047,64,39,25,16,23,0,11,14,0
46048,1306,653,653,220,356,77,231,320,102
46049,885,449,436,136,223,90,122,210,104
46050,1861,977,884,368,445,164,236,459,189
46051,2593,1286,1307,446,614,226,392,633,282
46052,21204,10265,10939,3334,5540,1391,3255,5696,1988
46055,2788,1309,1479,370,722,217,403,828,248
46056,2008,978,1030,228,547,203,328,504,198
46057,1272,613,659,216,318,79,208,327,124
46058,2161,1028,1133,333,527,168,315,532,286
46060,43413,21609,21804,7644,11807,2158,6901,12066,2837
46063,126,54,72,15,25,14,21,31,20
46064,11292,6204,5088,1656,3887,661,1634,2635,819
46065,2973,1408,1565,463,769,176,499,777,289
46068,3058,1558,1500,510,847,201,472,821,207
46069,6884,3469,3415,1262,1714,493,1011,1775,629
46070,2386,1206,1180,392,609,205,319,613,248
46071,3528,1783,1745,633,888,262,545,920,280
46072,9409,4458,4951,1353,2333,772,1269,2401,1281
46074,8900,4283,4617,1538,2375,370,1622,2538,457
46075,1696,867,829,274,436,157,200,478,151
46076,1794,896,898,285,466,145,243,455,200
46077,15453,7493,7960,2778,3895,820,2543,4263,1154
46102,50,22,28,6,16,0,12,14,2
46103,174,84,90,33,47,4,43,46,1
46104,1192,584,608,197,276,111,210,313,85
46105,1840,896,944,236,433,227,278,453,213
46106,4370,2228,2142,726,1213,289,625,1220,297
46107,11930,5603,6327,2060,2652,891,1653,3134,1540
46110,541,283,258,100,145,38,91,131,36
46111,244,135,109,46,68,21,30,62,17
46112,25252,12405,12847,4196,6781,1428,4145,6879,1823
46113,6073,2999,3074,1006,1656,337,983,1613,478
46115,2011,1004,1007,329,494,181,295,516,196
46117,612,324,288,112,138,74,77,147,64
46118,4819,2380,2439,777,1244,359,717,1381,341
46120,6019,2907,3112,940,1561,406,984,1593,535
46121,4237,2162,2075,683,1141,338,561,1111,403
46122,12531,6211,6320,1979,3342,890,1916,3273,1131
46123,20155,9980,10175,3220,5692,1068,3297,5853,1025
46124,7979,3981,3998,1365,2131,485,1354,2068,576
46125,32,12,20,0,3,9,8,7,5
46126,4681,2297,2384,772,1204,321,799,1204,381
46127,349,188,161,60,75,53,28,81,52
46128,2023,1020,1003,291,573,156,290,571,142
46130,1882,1000,882,378,532,90,284,500,98
46131,27270,13225,14045,4576,6698,1951,4373,6767,2905
46133,879,432,447,168,202,62,134,204,109
46135,19936,10563,9373,3305,5885,1373,3412,4095,1866
46140,33508,16511,16997,5268,8864,2379,4795,9235,2967
46142,30825,15275,15550,5090,8368,1817,4600,8572,2378
46143,32030,15246,16784,4943,8564,1739,5073,8985,2726
46144,170,86,84,15,60,11,19,54,11
46147,2816,1363,1453,430,751,182,455,757,241
46148,4570,2187,2383,669,1099,419,676,1226,481
46149,1832,925,907,301,496,128,269,496,142
46150,864,466,398,177,222,67,100,180,118
46151,31837,16027,15810,5308,8754,1965,4719,8393,2698
46155,244,110,134,46,43,21,50,54,30
46156,1511,736,775,276,363,97,268,386,121
46157,2762,1378,1384,450,708,220,432,703,249
46158,23768,11641,12127,3836,6481,1324,3797,6622,1708
46160,5751,2925,2826,788,1586,551,704,1524,598
46161,2648,1297,1351,465,641,191,442,664,245
46162,371,169,202,39,113,17,73,104,25
46163,9431,4857,4574,1688,2653,516,1378,2693,503
46164,3925,2019,1906,620,1093,306,469,1061,376
46165,1456,686,770,203,373,110,225,420,125
46166,2425,1249,1176,456,604,189,379,593,204
46167,4764,2323,2441,806,1240,277,757,1313,371
46168,22578,11919,10659,3761,6754,1404,3164,5483,2012
46171,1656,873,783,319,431,123,190,406,187
46172,2527,1305,1222,466,655,184,369,639,214
46173,11457,5526,5931,1658,2975,893,1752,2921,1258
46175,548,273,275,51,135,87,58,108,109
46176,26539,13038,13501,4075,7107,1856,3901,6849,2751
46180,1021,546,475,155,278,113,129,257,89
46181,4446,2221,2225,747,1128,346,742,1171,312
46182,1956,957,999,306,461,190,311,452,236
46184,9276,4610,4666,1651,2454,505,1572,2554,540
46186,1663,906,757,285,463,158,192,445,120
46201,39556,19411,20145,6784,10730,1897,7024,10480,2641
46202,15177,7700,7477,1596,5217,887,1971,4127,1379
46203,40450,19859,20591,6872,10452,2535,6224,10523,3844
46204,6592,5208,1384,670,4248,290,45,1045,294
46205,29696,13960,15736,4846,7543,1571,5216,8263,2257
46208,25410,11712,13698,4300,5656,1756,4372,6415,2911
46214,22291,10507,11784,2916,6320,1271,3154,6604,2026
46216,257,92,165,31,45,16,21,115,29
46217,19211,9348,9863,2967,5046,1335,2828,5415,1620
46218,34420,15964,18456,6060,7300,2604,5590,9053,3813
46219,36399,17021,19378,4868,9273,2880,5014,9702,4662
46220,35498,17000,18498,4066,10593,2341,3849,10989,3660
46221,24059,12091,11968,4387,6283,1421,3711,6426,1831
46222,36451,17830,18621,6494,9296,2040,6375,9432,2814
46224,34725,16862,17863,5118,9825,1919,5106,9629,3128
46225,8475,4386,4089,1482,2394,510,1462,2058,569
46226,44924,21435,23489,7585,10974,2876,7270,12705,3514
46227,52922,25418,27504,8290,13521,3607,7979,13668,5857
46228,14747,6749,7998,2070,3554,1125,2254,4136,1608
46229,23946,11047,12899,3941,5814,1292,4148,6777,1974
46231,5922,3073,2849,1066,1642,365,863,1568,418
46234,18390,8893,9497,2861,5005,1027,2779,5264,1454
46235,23987,10807,13180,5195,5046,566,5309,6872,999
46236,26764,13118,13646,4919,7236,963,4685,7707,1254
46237,30198,14789,15409,4808,8632,1349,4806,8917,1686
46239,13791,6940,6851,2315,3624,1001,2001,3668,1182
46240,17875,8500,9375,1867,5055,1578,1765,5235,2375
46241,30331,14947,15384,5180,7944,1823,4947,8160,2277
46250,17152,8306,8846,2065,5316,925,1956,5531,1359
46254,35187,16750,18437,5519,10278,953,5433,11516,1488
46256,23457,11304,12153,3680,6411,1213,3620,6843,1690
46259,6846,3317,3529,1166,1829,322,1278,1879,372
46260,31661,15005,16656,4392,8308,2305,4256,9069,3331
46268,23650,10691,12959,3189,6191,1311,3196,7185,2578
46278,6533,3234,3299,940,1936,358,1043,2009,247
46280,6126,2973,3153,910,1609,454,868,1730,555
46290,225,87,138,17,53,17,61,59,18
46301,645,344,301,41,184,119,38,170,93
46303,11739,6014,5725,2086,3228,700,1886,3145,694
46304,21595,10540,11055,3448,5866,1226,3361,6012,1682
46307,48616,23927,24689,7687,12862,3378,6963,12940,4786
46310,11970,5938,6032,2005,3085,848,1793,3115,1124
46311,17148,8374,8774,2687,4486,1201,2492,4796,1486
46312,32395,15538,16857,6046,7082,2410,5941,7818,3098
46319,19208,9306,9902,2971,5125,1210,2977,5424,1501
46320,16594,8025,8569,3195,3900,930,3196,4139,1234
46321,21511,10394,11117,3084,5111,2199,2865,5275,2977
46322,23546,11295,12251,3163,5936,2196,2858,6366,3027
46323,23530,11607,11923,3635,6374,1598,3613,6146,2164
46324,23277,11285,11992,3858,5846,1581,3707,6059,2226
46327,12075,6002,6073,2234,2979,789,1982,2995,1096
46340,1098,536,562,155,302,79,157,291,114
46341,9305,4456,4849,1447,2321,688,1508,2605,736
46342,29437,14333,15104,4424,7510,2399,4087,7794,3223
46345,158,67,91,26,34,7,36,43,12
46346,1449,711,738,327,313,71,238,409,91
46347,4036,2016,2020,691,1065,260,597,1100,323
46348,1056,523,533,174,270,79,152,272,109
46349,3214,1569,1645,505,876,188,534,880,231
46350,41994,20859,21135,6757,10850,3252,5943,10709,4483
46356,14774,7378,7396,2562,3852,964,2364,3846,1186
46360,46468,23178,23290,6942,12553,3683,6588,11535,5167
46365,1161,648,513,246,355,47,175,295,43
46366,6210,3103,3107,1073,1450,580,951,1524,632
46368,35734,17524,18210,5646,9513,2365,5437,9459,3314
46371,3025,1507,1518,484,828,195,458,786,274
46373,8196,4154,4042,1512,2175,467,1238,2174,630
46374,1273,630,643,226,302,102,165,332,146
46375,18750,9208,9542,2850,5038,1320,2526,5341,1675
46376,343,182,161,64,90,28,61,80,20
46377,135,71,64,12,37,22,10,21,33
46379,259,155,104,59,83,13,24,62,18
46381,203,107,96,55,52,0,38,46,12
46382,1970,996,974,291,545,160,294,539,141
46383,35734,17268,18466,5907,9117,2244,5716,9256,3494
46385,33356,16610,16746,5486,9251,1873,5343,9289,2114
46390,2502,1272,1230,421,687,164,359,674,197
46391,7583,5347,2236,1076,3997,274,671,1259,306
46392,6526,3336,3190,1250,1703,383,1093,1646,451
46393,179,79,100,21,40,18,31,47,22
46394,12728,6128,6600,1731,3228,1169,1731,3251,1618
46402,8657,3972,4685,1472,1778,722,1620,2060,1005
46403,14678,6915,7763,2549,3563,803,2292,4477,994
46404,21161,9421,11740,3645,3959,1817,3652,5392,2696
46405,13115,6503,6612,2192,3514,797,2171,3392,1049
46406,12198,5539,6659,2062,2549,928,2288,3183,1188
46407,18152,8121,10031,3170,3456,1495,3227,4350,2454
46408,20249,9524,10725,3524,4832,1168,3730,5476,1519
46409,12721,5725,6996,2610,2640,475,2798,3557,641
46410,33043,15724,17319,4721,8575,2428,5023,8715,3581
46501,3923,2034,1889,768,1017,249,589,1000,300
46502,62,24,38,0,1,23,8,10,20
46504,3211,1582,1629,588,801,193,601,757,271
46506,9932,4941,4991,1693,2473,775,1587,2411,993
46507,9327,4683,4644,1622,2484,577,1505,2545,594
46508,173,74,99,32,34,8,36,50,13
46510,3613,1849,1764,597,993,259,528,968,268
46511,4435,2111,2324,641,1059,411,678,1111,535
46513,56,30,26,15,15,0,14,12,0
46514,38004,18224,19780,5621,9843,2760,5930,10064,3786
46516,35045,17438,17607,6554,9098,1786,6257,9008,2342
46517,20543,9881,10662,3192,5374,1315,3390,5182,2090
46524,2242,1182,1060,520,547,115,417,523,120
46526,27585,13714,13871,4711,7170,1833,4505,6553,2813
46528,21792,11352,10440,4211,5987,1154,3625,5436,1379
46530,25948,12847,13101,4732,6891,1224,4630,7285,1186
46531,1185,612,573,171,350,91,167,307,99
46532,2046,1096,950,364,562,170,313,490,147
46534,11025,5335,5690,1724,2741,870,1726,2841,1123
46536,3014,1490,1524,478,794,218,475,752,297
46537,429,193,236,41,119,33,60,138,38
46538,3974,2053,1921,487,1248,318,505,1017,399
46539,2215,1074,1141,408,539,127,409,541,191
46540,9965,4989,4976,2083,2393,513,1900,2447,629
46542,3975,1919,2056,677,955,287,610,1091,355
46543,3156,1689,1467,838,724,127,650,684,133
46544,29705,14431,15274,4839,7534,2058,4568,7619,3087
46545,25890,12299,13591,3709,6839,1751,3766,6891,2934
46550,11968,6040,5928,2578,2871,591,2241,2880,807
46552,5979,2840,3139,843,1552,445,902,1503,734
46553,3044,1508,1536,597,662,249,583,699,254
46554,4010,1989,2021,618,1032,339,562,1110,349
46555,2729,1365,1364,424,743,198,382,717,265
46556,6731,3696,3035,3215,375,106,2815,220,0
46561,11981,6037,5944,2160,3138,739,1952,3216,776
46562,4289,2216,2073,809,1126,281,641,1136,296
46563,21941,10982,10959,3767,5744,1471,3350,5393,2216
46565,7226,3704,3522,1764,1619,321,1527,1615,380
46566,195,106,89,47,40,19,19,48,22
46567,9563,4784,4779,1493,2455,836,1334,2458,987
46570,1137,556,581,180,279,97,180,283,118
46571,4888,2466,2422,1162,1122,182,1035,1131,256
46573,3432,1650,1782,545,797,308,535,826,421
46574,8279,4122,4157,1330,2098,694,1171,2004,982
46580,21204,10390,10814,3563,5260,1567,3214,5371,2229
46582,10704,5440,5264,1874,2920,646,1709,2732,823
46590,3769,1740,2029,583,953,204,698,962,369
46595,108,48,60,26,15,7,22,22,16
46601,6080,3069,3011,1029,1716,324,1012,1391,608
46613,12166,5945,6221,2331,2974,640,2238,3101,882
46614,29535,14050,15485,4227,7228,2595,4015,7318,4152
46615,15693,7266,8427,2307,3935,1024,2403,4232,1792
46616,7250,3383,3867,1147,1889,347,1280,2056,531
46617,11129,5216,5913,1564,2727,925,1651,2709,1553
46619,20635,10207,10428,3733,4820,1654,3215,4919,2294
46628,27255,12977,14278,4871,6342,1764,4550,7202,2526
46629,0,0,0,0,0,0,0,0,0
46635,6988,3272,3716,955,1599,718,832,1752,1132
46637,15580,7089,8491,2145,3739,1205,3016,3772,1703
46701,7661,4078,3583,1343,2203,532,1077,1882,624
46702,2533,1320,1213,458,691,171,357,621,235
46703,17709,9113,8596,3297,4684,1132,2697,4333,1566
46705,1600,851,749,352,400,99,238,399,112
46706,17069,8339,8730,2615,4490,1234,2592,4423,1715
46710,4247,2129,2118,661,1199,269,626,1071,421
46711,7496,3656,3840,1485,1524,647,1308,1559,973
46714,14302,6887,7415,2228,3539,1120,2162,3549,1704
46721,5116,2546,2570,916,1324,306,868,1279,423
46723,7090,3521,3569,1214,1800,507,1163,1872,534
46725,20492,10165,10327,3316,5355,1494,3004,5258,2065
46730,1507,810,697,285,403,122,225,353,119
46731,698,360,338,155,165,40,135,152,51
46732,3581,1801,1780,692,966,143,662,883,235
46733,19035,9387,9648,3236,4744,1407,2993,4670,1985
46737,6373,3150,3223,966,1650,534,949,1659,615
46738,7755,3779,3976,1340,2045,394,1284,2011,681
46740,3690,1826,1864,792,832,202,781,824,259
46741,4781,2377,2404,1073,1087,217,975,1146,283
46742,3470,1701,1769,585,892,224,618,853,298
46743,1107,557,550,181,267,109,176,267,107
46745,1675,804,871,287,396,121,300,429,142
46746,3929,1976,1953,635,1051,290,629,980,344
46747,2654,1344,1310,371,726,247,408,653,249
46748,3349,1681,1668,602,923,156,555,908,205
46750,27925,13602,14323,4729,6818,2055,4608,6917,2798
46755,15074,7255,7819,2354,3975,926,2557,3839,1423
46759,890,458,432,214,182,62,123,205,104
46760,1176,594,582,217,306,71,176,322,84
46761,11542,5783,5759,2378,2695,710,2123,2685,951
46763,1648,876,772,313,425,138,201,441,130
46764,1579,824,755,291,433,100,230,406,119
46765,4035,2038,1997,806,938,294,690,985,322
46766,606,278,328,89,149,40,106,176,46
46767,8152,4258,3894,1836,2033,389,1486,1810,598
46770,2511,1253,1258,437,622,194,385,642,231
46772,3059,1572,1487,795,646,131,687,648,152
46773,3655,1771,1884,547,985,239,629,928,327
46774,14269,6906,7363,2272,3605,1029,2270,3653,1440
46776,1326,673,653,216,318,139,153,361,139
46777,6232,3105,3127,1105,1566,434,981,1542,604
46779,2424,1218,1206,426,621,171,389,584,233
46781,918,504,414,188,260,56,151,191,72
46783,5072,2524,2548,803,1363,358,819,1353,376
46784,2620,1283,1337,393,719,171,428,702,207
46785,1451,784,667,329,387,68,205,382,80
46787,3859,1872,1987,577,1035,260,649,988,350
46788,2934,1496,1438,614,767,115,579,724,135
46791,946,477,469,189,211,77,160,232,77
46792,4130,2017,2113,620,983,414,520,920,673
46793,4066,2057,2009,730,1134,193,661,1057,291
46794,1820,933,887,353,460,120,347,442,98
46795,5730,2933,2797,945,1446,542,841,1406,550
46797,3866,1956,1910,741,943,272,636,997,277
46798,1882,921,961,294,518,109,345,490,126
46799,142,62,80,26,26,10,32,43,5
46802,11631,6489,5142,2084,3740,665,1461,2838,843
46803,10040,4980,5060,2214,2172,594,1882,2334,844
46804,25508,12344,13164,3888,6829,1627,3839,7092,2233
46805,22229,10647,11582,3269,5891,1487,3355,5564,2663
46806,27068,12959,14109,5899,6001,1059,5479,7020,1610
46807,17379,8375,9004,2936,4636,803,3159,4582,1263
46808,19113,9391,9722,2991,5327,1073,2947,5188,1587
46809,9058,4423,4635,1379,2399,645,1228,2453,954
46814,7897,3980,3917,1475,2119,386,1357,2215,345
46815,26466,12689,13777,4237,6269,2183,4040,6732,3005
46816,17336,8217,9119,3099,3984,1134,2850,4474,1795
46818,14171,7003,7168,2136,3874,993,2144,3825,1199
46819,9145,4623,4522,1522,2331,770,1233,2225,1064
46825,25093,11921,13172,4036,6473,1412,3962,6986,2224
46835,31273,15601,15672,5030,8539,2032,4730,8218,2724
46845,15313,7603,7710,2746,4119,738,2585,4353,772
46901,40174,19505,20669,6430,10139,2936,6001,10401,4267
46902,35438,17087,18351,5379,8999,2709,5080,9547,3724
46910,3241,1596,1645,567,813,216,576,786,283
46911,1637,791,846,253,415,123,261,433,152
46913,1540,775,765,260,414,101,239,405,121
46914,2165,1107,1058,395,564,148,360,534,164
46917,1712,863,849,273,451,139,241,412,196
46919,2277,1162,1115,370,602,190,281,604,230
46920,1614,859,755,277,436,146,238,386,131
46921,66,23,43,0,17,6,9,21,13
46923,8357,4192,4165,1337,2240,615,1294,1996,875
46926,1846,928,918,310,471,147,292,455,171
46928,5474,2697,2777,834,1337,526,763,1387,627
46929,3252,1507,1745,468,738,301,459,819,467
46930,259,133,126,42,67,24,42,58,26
46931,214,115,99,52,45,18,33,48,18
46932,3908,1891,2017,590,1065,236,638,1086,293
46933,6177,2918,3259,948,1544,426,878,1729,652
46936,6223,3025,3198,984,1608,433,985,1597,616
46938,3508,1625,1883,503,807,315,567,920,396
46939,2227,1150,1077,387,511,252,289,517,271
46940,2925,1427,1498,409,773,245,413,759,326
46941,1318,720,598,251,355,114,194,319,85
46943,240,86,154,25,45,16,46,45,63
46946,162,64,98,21,37,6,50,48,0
46947,30030,15148,14882,4958,7792,2398,4275,7287,3320
46950,607,296,311,75,157,64,69,153,89
46951,2232,1174,1058,401,602,171,336,562,160
46952,21620,10154,11466,2914,5188,2052,2957,5601,2908
46953,25984,12561,13423,4393,6174,1994,4160,6451,2812
46957,329,134,195,28,81,25,67,86,42
46958,725,325,400,114,172,39,125,185,90
46959,113,76,37,23,22,31,10,18,9
46960,1519,744,775,220,390,134,276,340,159
46961,45,23,22,0,0,23,0,0,22
46962,9799,4625,5174,1587,2202,836,1692,2129,1353
46968,102,53,49,0,32,21,17,17,15
46970,25246,12740,12506,3744,7030,1966,3641,6268,2597
46974,1625,797,828,232,436,129,265,412,151
46975,14036,6793,7243,2105,3499,1189,2060,3546,1637
46978,2325,1213,1112,452,597,164,370,531,211
46979,4520,2242,2278,788,1173,281,740,1171,367
46982,2616,1376,1240,513,668,195,355,680,205
46985,1632,842,790,245,451,146,242,356,192
46986,1726,829,897,240,422,167,224,476,197
46987,589,286,303,96,129,61,81,144,78
46988,1027,567,460,153,337,77,111,260,89
46989,5077,2459,2618,1211,979,269,1411,877,330
46990,871,381,490,136,181,64,183,224,83
46991,2060,1016,1044,338,536,142,325,567,152
46992,18228,8892,9336,2924,4479,1489,2631,4585,2120
46994,2863,1414,1449,526,704,184,463,719,267
46996,6952,3468,3484,1142,1763,563,1019,1721,744
46998,64,14,50,0,14,0,12,23,15
47001,10670,5280,5390,1639,2890,751,1634,2952,804
47003,691,369,322,169,170,30,117,158,47
47006,10671,5139,5532,1748,2622,769,1706,2690,1136
47010,349,169,180,17,107,45,54,87,39
47011,739,371,368,138,176,57,156,168,44
47012,9604,4737,4867,1632,2321,784,1538,2301,1028
47016,629,317,312,100,172,45,81,161,70
47017,400,194,206,62,83,49,41,100,65
47018,3594,1672,1922,554,829,289,605,877,440
47019,39,19,20,0,14,5,0,14,6
47020,1111,544,567,181,290,73,174,287,106
47021,63,39,24,15,10,14,10,14,0
47022,3077,1588,1489,581,816,191,463,808,218
47023,1440,726,714,208,398,120,211,403,100
47024,3381,1717,1664,608,862,247,606,799,259
47025,20032,9721,10311,3259,5160,1302,3263,5248,1800
47030,1486,810,676,308,404,98,211,356,109
47031,5183,2595,2588,882,1327,386,811,1246,531
47032,3401,1724,1677,711,847,166,574,863,240
47034,123,60,63,23,19,18,13,27,23
47035,128,61,67,11,40,10,22,45,0
47036,666,341,325,130,167,44,125,150,50
47037,4557,2238,2319,791,1084,363,762,1087,470
47038,1514,808,706,276,422,110,251,374,81
47040,4859,2365,2494,702,1282,381,706,1264,524
47041,5275,2662,2613,924,1373,365,815,1308,490
47042,4401,2108,2293,685,1055,368,736,1128,429
47043,5216,2648,2568,862,1307,479,667,1312,589
47060,6054,3114,2940,1017,1687,410,899,1667,374
47102,7575,3818,3757,1338,1953,527,1209,1990,558
47106,4301,2121,2180,687,1157,277,648,1195,337
47108,2385,1195,1190,410,616,169,362,625,203
47111,11911,5873,6038,2001,3191,681,1826,3240,972
47112,14402,7026,7376,2176,3826,1024,2286,3752,1338
47114,141,73,68,27,36,10,21,35,12
47115,2289,1098,1191,348,547,203,370,548,273
47116,773,391,382,85,238,68,100,227,55
47117,4064,2101,1963,680,1194,227,588,1108,267
47118,3520,1796,1724,597,940,259,543,898,283
47119,9797,4794,5003,1543,2579,672,1595,2741,667
47120,859,486,373,200,232,54,78,232,63
47122,8295,4213,4082,1385,2403,425,1260,2367,455
47123,21,5,16,0,0,5,0,11,5
47124,3815,1868,1947,652,1039,177,670,1069,208
47125,1616,828,788,262,443,123,286,395,107
47126,3523,1804,1719,587,1048,169,495,1008,216
47129,20601,9844,10757,2852,5348,1644,2969,5258,2530
47130,38859,18827,20032,5816,10445,2566,5311,11097,3624
47135,1188,619,569,189,303,127,125,307,137
47136,3757,1906,1851,654,1013,239,542,1022,287
47137,1429,690,739,156,372,162,188,385,166
47138,4504,2283,2221,692,1262,329,678,1213,330
47139,42,22,20,5,14,3,9,9,2
47140,2891,1469,1422,529,737,203,421,747,254
47141,1382,677,705,186,375,116,226,349,130
47142,1035,511,524,156,293,62,173,274,77
47143,2075,1007,1068,278,558,171,316,564,188
47145,2019,1034,985,361,541,132,303,548,134
47147,1076,495,581,147,282,66,201,299,81
47150,46759,22260,24499,7234,11527,3499,6778,12418,5303
47160,33,21,12,8,11,2,2,9,1
47161,3422,1741,1681,610,991,140,573,977,131
47162,773,379,394,164,174,41,132,204,58
47163,1746,918,828,237,543,138,248,443,137
47164,3699,1848,1851,610,1040,198,605,990,256
47165,5868,2931,2937,1041,1531,359,946,1600,391
47166,1348,670,678,230,386,54,179,412,87
47167,14878,7284,7594,2295,3841,1148,2302,3691,1601
47170,14010,6892,7118,2254,3684,954,2070,3743,1305
47172,11919,5835,6084,1783,3234,818,1564,3399,1121
47174,72,28,44,8,20,0,16,14,14
47175,841,445,396,126,235,84,82,244,70
47177,630,355,275,139,149,67,80,139,56
47201,38018,18875,19143,5792,10355,2728,5726,9990,3427
47203,23946,11454,12492,3642,6054,1758,3589,6454,2449
47220,5024,2419,2605,869,1159,391,680,1293,632
47223,2019,1061,958,289,633,139,282,546,130
47224,572,292,280,86,187,19,68,199,13
47226,180,102,78,45,46,11,23,38,17
47227,1498,739,759,249,375,115,257,373,129
47229,3313,1671,1642,494,912,265,477,862,303
47230,1737,867,870,297,442,128,305,455,110
47231,1188,647,541,234,336,77,162,317,62
47232,2522,1261,1261,355,731,175,374,678,209
47234,1550,805,745,245,436,124,202,404,139
47235,2028,1088,940,344,553,191,284,534,122
47240,19673,9685,9988,3089,5014,1582,2903,4953,2132
47243,5909,2868,3041,1196,1254,418,1226,1317,498
47244,839,452,387,160,222,70,89,227,71
47246,4432,2217,2215,771,1117,329,673,1126,416
47247,111,67,44,14,39,14,7,21,16
47250,20948,10400,10548,3133,5618,1649,2892,5328,2328
47260,2007,959,1048,327,515,117,373,512,163
47263,244,132,112,52,60,20,22,61,29
47264,1338,727,611,156,405,166,101,373,137
47265,19695,9689,10006,3318,5131,1240,3238,5151,1617
47270,804,439,365,147,265,27,124,205,36
47272,1996,991,1005,328,552,111,342,527,136
47273,1919,943,976,305,484,154,318,543,115
47274,27901,13646,14255,4228,7389,2029,4188,7169,2898
47280,942,415,527,138,201,76,196,276,55
47281,1330,674,656,173,361,140,181,325,150
47282,276,160,116,84,61,15,30,43,43
47283,3498,1762,1736,590,910,262,553,905,278
47302,30018,14192,15826,4573,7211,2408,4617,7827,3382
47303,31294,14739,16555,5975,7086,1678,7208,6825,2522
47304,28797,13653,15144,4236,6973,2444,3941,7600,3603
47305,4813,2549,2264,727,1563,259,654,1256,354
47320,4254,2025,2229,597,1051,377,662,1044,523
47325,696,329,367,83,208,38,124,205,38
47326,2030,1015,1015,375,480,160,422,447,146
47327,5549,2702,2847,899,1304,499,822,1382,643
47330,5339,2586,2753,860,1235,491,818,1394,541
47331,24819,11974,12845,3582,6223,2169,3591,6222,3032
47334,3033,1470,1563,449,742,279,453,775,335
47336,4195,2093,2102,632,1077,384,568,1049,485
47337,188,97,91,27,53,17,23,47,21
47338,3165,1586,1579,512,803,271,430,821,328
47339,570,300,270,98,144,58,71,150,49
47340,3182,1590,1592,539,752,299,426,802,364
47341,2051,1078,973,386,501,191,226,525,222
47342,2929,1449,1480,410,857,182,407,826,247
47344,93,56,37,14,34,8,11,18,8
47345,1449,656,793,211,357,88,310,386,97
47346,4025,1939,2086,569,1013,357,581,994,511
47348,10749,5255,5494,1597,2760,898,1412,2784,1298
47351,433,208,225,84,83,41,82,99,44
47352,1023,489,534,123,280,86,137,288,109
47353,5998,2947,3051,987,1510,450,868,1524,659
47354,1320,648,672,193,323,132,168,344,160
47355,3009,1458,1551,436,789,233,510,750,291
47356,6485,3145,3340,966,1663,516,952,1680,708
47357,1143,561,582,179,301,81,192,285,105
47358,1096,581,515,222,294,65,132,305,78
47359,3317,1666,1651,534,850,282,493,840,318
47360,1579,725,854,196,396,133,294,400,160
47361,143,68,75,18,40,10,19,43,13
47362,29508,14115,15393,4099,7390,2626,4072,7529,3792
47368,2903,1412,1491,477,733,202,456,743,292
47369,1361,654,707,222,328,104,223,339,145
47371,12720,6243,6477,2053,3226,964,1880,3182,1415
47373,2384,1159,1225,357,592,210,310,655,260
47374,49730,23883,25847,7606,11983,4294,7200,12494,6153
47380,2171,1042,1129,299,569,174,331,587,211
47381,81,33,48,24,9,0,24,22,2
47382,172,80,92,27,44,9,27,46,19
47383,2983,1469,1514,459,726,284,470,803,241
47384,1893,936,957,271,501,164,278,492,187
47385,1678,843,835,296,422,125,238,425,172
47386,1262,707,555,233,364,110,127,329,99
47387,702,325,377,86,183,56,99,188,90
47390,5385,2692,2693,851,1324,517,731,1279,683
47392,49,27,22,5,10,12,0,9,13
47393,1546,845,701,290,372,183,170,384,147
47394,8725,4202,4523,1221,2223,758,1201,2178,1144
47396,6562,3257,3305,1074,1667,516,909,1752,644
47401,34589,16704,17885,5078,9632,1994,5755,9352,2778
47403,25344,12440,12904,3801,7268,1371,3667,7115,2122
47404,18358,9000,9358,2845,5014,1141,2999,4891,1468
47406,7675,3558,4117,3272,286,0,3849,268,0
47408,25090,12580,12510,4634,6967,979,5117,6012,1381
47420,104,70,34,36,34,0,3,24,7
47421,27694,13474,14220,3918,7085,2471,3624,7162,3434
47424,8945,4477,4468,1384,2261,832,1218,2247,1003
47427,1070,495,575,145,274,76,184,302,89
47429,7083,3438,3645,1379,1777,282,1214,1985,446
47430,78,28,50,0,28,0,28,16,6
47431,1217,673,544,206,347,120,157,245,142
47432,4337,2156,2181,580,1123,453,569,1025,587
47433,3329,1700,1629,513,900,287,417,889,323
47436,1312,661,651,156,413,92,167,382,102
47438,5064,2469,2595,817,1232,420,740,1221,634
47441,9311,4393,4918,1212,2259,922,1274,2227,1417
47443,1342,659,683,225,333,101,214,303,166
47445,53,20,33,9,11,0,10,16,7
47446,10680,5191,5489,1747,2672,772,1591,2882,1016
47448,7489,3631,3858,1056,1937,638,960,2079,819
47449,487,238,249,36,158,44,83,119,47
47451,1323,608,715,158,345,105,223,351,141
47452,5067,2472,2595,853,1208,411,882,1208,505
47453,597,279,318,77,151,51,127,120,71
47454,7394,3620,3774,1153,1852,615,1060,1894,820
47455,329,151,178,54,69,28,63,84,31
47456,849,462,387,193,211,58,132,184,71
47459,3530,1777,1753,552,1016,209,556,1008,189
47460,11618,5729,5889,1857,3035,837,1736,2985,1168
47462,4691,2339,2352,750,1253,336,635,1374,343
47464,106,56,50,29,21,6,17,24,9
47465,698,342,356,133,159,50,116,189,51
47467,88,68,20,40,21,7,6,8,6
47468,1300,605,695,194,346,65,233,340,122
47469,1853,946,907,285,445,216,236,462,209
47470,1663,898,765,331,450,117,268,387,110
47471,2882,1427,1455,534,637,256,469,670,316
47501,16944,8254,8690,2688,4039,1527,2389,4121,2180
47512,4703,2276,2427,723,1111,442,688,1146,593
47513,1851,927,924,356,468,103,287,479,158
47514,337,171,166,81,68,22,64,72,30
47515,1095,541,554,162,278,101,196,278,80
47516,1238,606,632,191,330,85,201,277,154
47519,584,330,254,110,171,49,97,118,39
47520,2861,1430,1431,399,820,211,425,749,257
47521,821,426,395,164,220,42,144,233,18
47522,222,110,112,30,55,25,32,60,20
47523,3715,1819,1896,601,910,308,583,972,341
47524,623,331,292,110,143,78,61,139,92
47525,462,216,246,80,109,27,77,137,32
47527,1675,849,826,199,482,168,296,365,165
47528,571,292,279,90,165,37,78,153,48
47529,1208,596,612,173,324,99,151,295,166
47531,602,288,314,61,174,53,94,158,62
47532,4579,2143,2436,743,1104,296,776,1114,546
47535,700,334,366,104,154,76,98,157,111
47536,62,26,36,0,15,11,0,10,26
47537,596,298,298,81,182,35,82,150,66
47541,1212,595,617,183,310,102,205,286,126
47542,8803,4341,4462,1487,2248,606,1438,2142,882
47545,28,15,13,0,0,15,0,0,13
47546,19663,9779,9884,3200,5154,1425,2929,5045,1910
47550,962,501,461,205,244,52,140,251,70
47551,557,284,273,82,162,40,60,172,41
47552,197,113,84,45,52,16,22,45,17
47553,7913,3971,3942,1372,1992,607,1210,1890,842
47557,1406,676,730,218,314,144,245,313,172
47558,3853,1914,1939,911,843,160,937,804,198
47561,1388,668,720,218,354,96,202,373,145
47562,4127,2067,2060,819,922,326,684,936,440
47564,1411,708,703,236,372,100,217,327,159
47567,5926,2914,3012,814,1511,589,738,1421,853
47568,997,516,481,195,229,92,144,242,95
47574,108,57,51,10,32,15,8,35,8
47575,1007,477,530,145,293,39,161,287,82
47576,371,204,167,49,100,55,28,94,45
47577,1074,634,440,158,353,123,134,216,90
47578,970,488,482,186,227,75,123,249,110
47579,2084,1019,1065,347,523,149,346,577,142
47580,165,93,72,32,49,12,10,36,26
47581,3832,1961,1871,564,1101,296,493,966,412
47584,120,63,57,16,37,10,21,22,14
47585,435,241,194,67,119,55,51,85,58
47586,12300,6377,5923,1822,3524,1031,1621,2799,1503
47588,457,230,227,61,123,46,58,104,65
47590,749,389,360,151,172,66,114,187,59
47591,26741,13239,13502,5137,6123,1979,4223,6165,3114
47596,206,105,101,34,65,6,29,50,22
47597,1079,520,559,144,302,74,181,288,90
47598,3661,1892,1769,593,1007,292,449,961,359
47601,13927,6782,7145,2130,3701,951,2020,3705,1420
47610,5445,2764,2681,916,1470,378,813,1490,378
47611,1308,661,647,235,320,106,185,336,126
47612,1085,567,518,173,317,77,153,255,110
47613,2353,1171,1182,355,620,196,326,577,279
47615,1775,917,858,296,497,124,259,458,141
47616,451,207,244,72,76,59,80,97,67
47619,1582,806,776,246,423,137,201,421,154
47620,14126,6965,7161,2283,3655,1027,2175,3599,1387
47630,27178,13204,13974,4475,7054,1675,4294,7581,2099
47631,2124,1073,1051,350,548,175,252,502,297
47633,2896,1473,1423,515,708,250,405,682,336
47634,2437,1234,1203,363,647,224,361,603,239
47635,5622,2727,2895,874,1443,410,845,1484,566
47637,1816,921,895,280,519,122,299,491,105
47638,3413,1752,1661,625,959,168,527,897,237
47639,3452,1737,1715,547,920,270,481,844,390
47640,937,463,474,142,251,70,140,272,62
47647,83,13,70,0,7,6,21,23,26
47648,4292,2128,2164,702,1119,307,716,1084,364
47649,1600,778,822,251,431,96,241,456,125
47654,75,33,42,7,22,4,19,15,8
47660,5285,2555,2730,852,1213,490,789,1253,688
47665,3522,1730,1792,596,855,279,564,871,357
47666,1625,863,762,309,408,146,213,399,150
47670,11527,5487,6040,1582,2871,1034,1589,2790,1661
47683,382,181,201,60,90,31,69,97,35
47708,917,523,394,60,359,104,53,148,193
47710,21311,9979,11332,2990,5181,1808,2802,5321,3209
47711,28605,13592,15013,4033,7273,2286,4325,7360,3328
47712,25342,11939,13403,4206,5992,1741,4902,6114,2387
47713,12467,5887,6580,1984,3072,831,2218,2935,1427
47714,35884,16496,19388,5381,8459,2656,5940,9338,4110
47715,24319,11419,12900,3435,6092,1892,3236,6608,3056
47720,16716,8180,8536,2573,4298,1309,2474,4222,1840
47725,9447,4815,4632,1516,2542,757,1356,2527,749
47802,31246,15926,15320,4546,9071,2309,4155,7585,3580
47803,20470,10093,10377,3468,4918,1707,2660,5178,2539
47804,11236,5159,6077,1557,2629,973,1659,2666,1752
47805,12553,6260,6293,2027,3198,1035,1716,3354,1223
47807,17158,8450,8708,4021,3868,561,4085,3630,993
47832,1154,616,538,224,331,61,162,295,81
47833,909,486,423,173,235,78,137,254,32
47834,19089,9244,9845,2950,4751,1543,2871,4676,2298
47836,114,63,51,21,37,5,19,32,0
47837,1400,701,699,269,351,81,278,330,91
47838,4153,3113,1040,482,2388,243,327,535,178
47840,1739,835,904,299,434,102,309,468,127
47841,2385,1153,1232,344,571,238,332,571,329
47842,10306,4917,5389,1537,2562,818,1364,2625,1400
47846,749,381,368,139,173,69,97,184,87
47847,1133,555,578,156,289,110,185,272,121
47848,1672,851,821,275,417,159,174,450,197
47849,455,225,230,62,96,67,58,112,60
47850,2599,1334,1265,431,687,216,339,658,268
47853,185,77,108,30,43,4,34,49,25
47854,929,479,450,161,249,69,136,242,72
47855,658,324,334,94,174,56,106,160,68
47856,77,36,41,9,21,6,8,24,9
47858,664,323,341,84,167,72,118,149,74
47859,1069,575,494,229,243,103,162,242,90
47860,309,137,172,41,82,14,62,89,21
47861,828,435,393,197,173,65,128,199,66
47862,1713,899,814,310,430,159,223,418,173
47863,0,0,0,0,0,0,0,0,0
47865,66,25,41,0,10,15,0,32,9
47866,439,198,241,47,103,48,55,123,63
47868,3111,1602,1509,465,840,297,448,803,258
47872,8431,3734,4697,1038,1961,735,951,2724,1022
47874,3238,1638,1600,463,883,292,407,841,352
47876,431,0,431,0,0,0,165,27,239
47879,3225,1626,1599,516,857,253,449,820,330
47881,338,146,192,40,86,20,73,88,31
47882,8367,3861,4506,1146,2074,641,1268,2063,1175
47884,371,202,169,54,137,11,52,93,24
47885,10180,5046,5134,1630,2685,731,1471,2619,1044
47901,3804,2159,1645,738,1254,167,469,1013,163
47904,15876,8137,7739,2341,4699,1097,2134,3968,1637
47905,35884,17374,18510,5201,9928,2245,5314,9888,3308
47906,57196,30566,26630,15129,13182,2255,13171,10644,2815
47909,29973,14783,15190,5209,8012,1562,4878,8438,1874
47916,77,43,34,15,16,12,12,16,6
47917,470,233,237,79,108,46,78,114,45
47918,6424,3136,3288,1085,1585,466,1049,1493,746
47920,2087,997,1090,232,603,162,333,571,186
47921,1150,551,599,174,281,96,164,300,135
47922,1687,812,875,266,391,155,286,383,206
47923,3830,1882,1948,682,976,224,620,1023,305
47924,100,60,40,24,28,8,0,26,14
47925,187,81,106,14,67,0,54,38,14
47926,1026,501,525,138,248,115,139,248,138
47928,1916,939,977,251,546,142,280,458,239
47929,785,397,388,127,215,55,118,198,72
47930,1132,502,630,170,262,70,249,308,73
47932,5609,2795,2814,912,1382,501,697,1490,627
47933,27658,13808,13850,4713,6852,2243,3910,6977,2963
47940,1567,796,771,299,399,98,265,379,127
47941,565,264,301,97,148,19,114,154,33
47942,882,428,454,145,207,76,135,201,118
47943,844,433,411,176,207,50,141,208,62
47944,3727,1843,1884,613,872,358,531,899,454
47946,2127,1044,1083,337,473,234,290,476,317
47948,1487,745,742,238,386,121,218,357,167
47949,1170,558,612,176,299,83,200,287,125
47950,1016,502,514,183,289,30,186,245,83
47951,2399,1169,1230,370,590,209,334,600,296
47952,3202,1692,1510,567,798,327,429,737,344
47954,2270,1163,1107,434,565,164,293,604,210
47955,1083,527,556,165,260,102,164,285,107
47957,2157,1118,1039,352,602,164,350,536,153
47958,265,142,123,57,51,34,32,54,37
47959,2934,1455,1479,423,767,265,414,747,318
47960,15136,7637,7499,2342,3816,1479,1778,3850,1871
47963,2034,1031,1003,300,533,198,271,515,217
47964,168,80,88,31,42,7,38,43,7
47965,303,140,163,57,68,15,51,84,28
47966,487,238,249,77,120,41,83,116,50
47967,817,401,416,136,213,52,120,224,72
47968,998,487,511,137,279,71,145,255,111
47969,143,83,60,30,41,12,17,32,11
47970,2242,1113,1129,442,572,99,354,567,208
47971,1774,905,869,309,438,158,214,451,204
47974,1232,612,620,195,311,106,189,286,145
47975,729,359,370,116,179,64,82,218,70
47977,2358,1184,1174,399,594,191,358,595,221
47978,11238,5605,5633,2054,2683,868,1869,2590,1174
47980,1249,589,660,171,325,93,262,285,113
47981,774,398,376,139,216,43,138,168,70
47982,101,55,46,13,32,10,14,28,4
47983,192,103,89,26,44,33,27,36,26
47986,61,53,8,28,25,0,0,8,0
47987,4165,2069,2096,628,1046,395,586,1050,460
47989,1073,552,521,198,280,74,161,255,105
47990,1552,749,803,198,410,141,240,399,164
47991,1018,541,477,209,244,88,144,231,102
47992,1224,630,594,230,302,98,175,321,98
47993,4005,2029,1976,667,1021,341,535,999,442
47994,524,269,255,115,105,49,71,126,58
47995,1678,798,880,268,416,114,311,386,183
47997,47,29,18,5,24,0,0,17,1
48001,13191,6561,6630,1836,3687,1038,1884,3453,1293
48002,3162,1605,1557,547,895,163,508,872,177
48003,5546,2792,2754,985,1495,312,854,1524,376
48005,5212,2634,2578,909,1427,298,839,1351,388
48006,3785,1927,1858,632,1081,214,596,1020,242
48009,19418,9286,10132,2301,5497,1488,2155,5897,2080
48014,3811,1915,1896,721,1012,182,680,969,247
48015,8737,3906,4831,1049,2118,739,1066,2203,1562
48017,12928,6199,6729,1610,3634,955,1556,3688,1485
48021,33416,16281,17135,4913,8787,2581,4584,8614,3937
48022,2468,1253,1215,457,653,143,433,646,136
48023,7015,3506,3509,1166,1936,404,1082,1913,514
48025,14405,6961,7444,2021,3429,1511,1901,3732,1811
48026,15297,7163,8134,2362,3694,1107,2182,4097,1855
48027,2986,1501,1485,497,823,181,455,828,202
48028,1154,548,606,34,290,224,115,312,179
48030,18894,9456,9438,3376,5052,1028,2889,4913,1636
48032,1993,1052,941,359,571,122,280,524,137
48034,31802,14309,17493,3491,8485,2333,3596,9984,3913
48035,34352,16701,17651,5038,9418,2245,4980,9436,3235
48036,22331,10565,11766,3004,5495,2066,2879,6083,2804
48038,39595,18983,20612,5446,10727,2810,5127,11135,4350
48039,8412,4079,4333,1369,2127,583,1399,2209,725
48040,9724,4729,4995,1427,2391,911,1268,2487,1240
48041,4315,2214,2101,752,1170,292,649,1145,307
48042,15815,7761,8054,2628,4127,1006,2619,4225,1210
48043,17651,9115,8536,2578,5424,1113,2071,4709,1756
48044,34575,17293,17282,6210,9711,1372,5826,9880,1576
48045,24038,12036,12002,3103,7348,1585,3144,6861,1997
48047,31355,15741,15614,5388,8990,1363,4655,9110,1849
48048,6651,3900,2751,1004,2600,296,903,1492,356
48049,5794,2978,2816,925,1679,374,870,1556,390
48050,1430,729,701,223,378,128,228,356,117
48051,13597,6655,6942,2427,3751,477,2521,3792,629
48054,7043,3468,3575,1076,1817,575,973,1822,780
48059,14739,7068,7671,2084,3767,1217,2121,4014,1536
48060,40588,19430,21158,6531,10072,2827,6446,10442,4270
48062,8350,4096,4254,1317,2232,547,1261,2157,836
48063,4511,2441,2070,826,1344,271,634,1181,255
48064,4765,2359,2406,812,1302,245,866,1286,254
48065,10001,5005,4996,1744,2651,610,1501,2720,775
48066,49032,23815,25217,6990,13113,3712,6407,13102,5708
48067,25261,12661,12600,2829,8291,1541,2482,7705,2413
48069,2422,1191,1231,285,718,188,280,744,207
48070,6098,2971,3127,899,1629,443,824,1775,528
48071,31101,15248,15853,4261,8900,2087,3858,8431,3564
48072,15529,7454,8075,2170,4411,873,1910,4587,1578
48073,34671,16754,17917,3820,10254,2680,3471,10264,4182
48074,8619,4308,4311,1408,2406,494,1287,2355,669
48075,22500,10454,12046,3092,5511,1851,2886,6462,2698
48076,28262,13216,15046,4239,6967,2010,3986,8290,2770
48079,12294,5944,6350,1957,3099,888,2012,3258,1080
48080,23576,10867,12709,2712,5706,2449,2775,5826,4108
48081,22260,10714,11546,2841,5476,2397,2502,5680,3364
48082,16752,8152,8600,2179,4324,1649,1953,4292,2355
48083,22294,10958,11336,3202,6558,1198,2931,6390,2015
48084,13890,6965,6925,1876,4074,1015,1687,3972,1266
48089,34260,16970,17290,5710,9175,2085,5366,8735,3189
48091,31973,16021,15952,4993,8527,2501,4458,8051,3443
48092,25432,12630,12802,3434,6664,2532,3197,6423,3182
48093,46448,21784,24664,5281,11060,5443,5081,11574,8009
48094,13167,6557,6610,2030,3698,829,1969,3809,832
48095,3911,1957,1954,648,1026,283,665,1007,282
48096,3958,2049,1909,645,1130,274,567,1039,303
48097,5410,2666,2744,948,1351,367,908,1311,525
48098,44790,22214,22576,7445,11980,2789,6916,12514,3146
48101,29504,13949,15555,3824,7275,2850,3801,7319,4435
48103,48806,23645,25161,6569,14307,2769,6344,14970,3847
48104,42373,21248,21125,8742,10956,1550,9298,9863,1964
48105,33380,16760,16620,4797,10306,1657,4487,10078,2055
48108,23079,11328,11751,3560,6963,805,3247,7352,1152
48109,4231,2206,2025,1770,398,38,1769,243,13
48111,39095,19408,19687,5775,11679,1954,6139,11300,2248
48114,19072,9499,9573,3199,5232,1068,3121,5323,1129
48116,24831,12338,12493,4088,6773,1477,3685,6974,1834
48117,10097,5130,4967,1713,2766,651,1505,2681,781
48118,11994,6051,5943,2021,3153,877,1657,3002,1284
48120,7442,4033,3409,1520,2007,506,1275,1359,775
48122,10763,5250,5513,1582,2891,777,1503,2914,1096
48124,33231,16062,17169,4439,8691,2932,4165,8644,4360
48125,22663,11021,11642,3123,6152,1746,3014,6047,2581
48126,46576,23743,22833,9253,11392,3098,8358,10118,4357
48127,35600,17008,18592,4732,8525,3751,4561,8596,5435
48128,10527,5067,5460,1469,2663,935,1316,2810,1334
48130,10366,5265,5101,1759,2937,569,1601,2896,604
48131,6262,3086,3176,1029,1696,361,1007,1641,528
48133,5335,2692,2643,848,1451,393,796,1447,400
48134,16289,8124,8165,2986,4409,729,2678,4608,879
48135,29465,14547,14918,4563,7883,2101,4273,7802,2843
48137,4488,2289,2199,765,1237,287,657,1210,332
48138,10894,5442,5452,1573,2949,920,1402,3096,954
48139,67,35,32,6,25,4,7,17,8
48140,3201,1637,1564,559,864,214,527,830,207
48141,30115,14325,15790,5481,7082,1762,5118,8270,2402
48143,50,21,29,4,17,0,4,25,0
48144,8962,4438,4524,1559,2348,531,1440,2433,651
48145,3412,1749,1663,579,987,183,505,947,211
48146,39842,19540,20302,5800,10932,2808,5685,10469,4148
48150,28138,13841,14297,4096,7446,2299,3721,7310,3266
48152,32183,15711,16472,4702,8474,2535,4221,8586,3665
48154,40542,19452,21090,5663,9772,4017,5498,10164,5428
48157,1478,752,726,267,397,88,233,391,102
48158,7041,3611,3430,1119,2023,469,931,1929,570
48159,2579,1293,1286,439,691,163,458,670,158
48160,12767,7203,5564,1862,4658,683,1649,3061,854
48161,25526,12574,12952,4188,6594,1792,3969,6569,2414
48162,29271,14139,15132,4724,7490,1925,4299,7575,3258
48164,7800,3914,3886,1268,2273,373,1188,2176,522
48165,5531,2762,2769,988,1549,225,962,1555,252
48166,10484,5298,5186,1919,2909,470,1799,2923,464
48167,36307,17079,19228,4799,9482,2798,4452,11083,3693
48169,19699,10012,9687,3189,5820,1003,3114,5459,1114
48170,39296,19534,19762,5076,11727,2731,4641,11021,4100
48173,10390,5305,5085,1618,3073,614,1434,2946,705
48174,29724,14434,15290,4877,8081,1476,5018,8305,1967
48176,18328,8930,9398,3121,4783,1026,3058,5068,1272
48178,23805,11642,12163,3636,6434,1572,3616,6509,2038
48179,2791,1460,1331,454,802,204,372,739,220
48180,65868,31738,34130,10877,16803,4058,10540,18021,5569
48182,20950,10247,10703,3448,5294,1505,3258,5615,1830
48183,41074,19975,21099,6230,10865,2880,5923,11308,3868
48184,19133,9147,9986,3056,4875,1216,3086,5169,1731
48185,49010,23096,25914,6288,13240,3568,6123,13510,6281
48186,38008,18760,19248,6107,10404,2249,5889,10378,2981
48187,44953,22079,22874,7423,12767,1889,7446,13074,2354
48188,31624,15612,16012,5426,9151,1035,5396,9369,1247
48189,13481,6972,6509,2357,3944,671,1853,3888,768
48190,135,86,49,43,35,8,11,38,0
48191,2584,1291,1293,339,789,163,346,733,214
48192,44990,21505,23485,6374,11474,3657,6187,11796,5502
48195,30136,14564,15572,4001,8035,2528,3844,8079,3649
48197,55634,27714,27920,9265,16569,1880,9814,15504,2602
48198,38697,18480,20217,6074,10503,1903,6209,11344,2664
48201,15476,8194,7282,1964,4897,1333,1859,4108,1315
48202,21936,10949,10987,3316,6235,1398,3231,5626,2130
48203,45311,21083,24228,8491,10000,2592,8399,11931,3898
48204,41713,19184,22529,7486,8602,3096,7383,10592,4554
48205,67229,31341,35888,15584,13840,1917,15520,17758,2610
48206,32582,14816,17766,6042,6552,2222,5767,8410,3589
48207,25550,11529,14021,3679,5767,2083,3483,7302,3236
48208,13160,6246,6914,2090,3295,861,2032,3369,1513
48209,38652,20469,18183,8248,10601,1620,7323,8794,2066
48210,39613,20127,19486,8271,9785,2071,7434,9097,2955
48211,11115,5927,5188,2243,3045,639,1911,2394,883
48212,45980,23515,22465,8169,12774,2572,8042,10552,3871
48213,44089,20432,23657,9285,9026,2121,9221,10925,3511
48214,32937,15211,17726,4831,7611,2769,4967,8182,4577
48215,19025,8957,10068,3662,4331,964,3434,5149,1485
48216,6690,3365,3325,1046,1990,329,1172,1728,425
48217,10546,4958,5588,1667,2318,973,1597,2521,1470
48218,10066,4745,5321,1910,2245,590,1827,2618,876
48219,59636,27546,32090,10838,14010,2698,10314,17815,3961
48220,25147,12255,12892,3280,7652,1323,3292,7462,2138
48221,45274,20577,24697,7103,9776,3698,6922,12080,5695
48223,35913,16724,19189,7124,8276,1324,7102,10587,1500
48224,55432,25861,29571,11075,12942,1844,10843,15654,3074
48225,14425,6737,7688,1993,3583,1161,1711,3912,2065
48226,5747,3631,2116,744,2609,278,329,1404,383
48227,61188,28062,33126,11738,13480,2844,11424,17695,4007
48228,65049,30377,34672,12320,14930,3127,12169,18275,4228
48229,11090,5303,5787,1838,2719,746,1884,2844,1059
48230,18149,8704,9445,2768,4708,1228,2677,5042,1726
48234,45735,20872,24863,9026,9494,2352,8636,12659,3568
48235,53515,23774,29741,8436,11854,3484,8674,15523,5544
48236,31330,14957,16373,4572,7231,3154,4394,7995,3984
48237,32438,15125,17313,5303,7785,2037,5194,9076,3043
48238,44912,20597,24315,8278,9356,2963,8164,11539,4612
48239,37667,18534,19133,5761,9931,2842,5160,9929,4044
48240,19089,9316,9773,2958,5138,1220,2799,4995,1979
48242,0,0,0,0,0,0,0,0,0
48301,14632,7268,7364,2126,3618,1524,1946,3542,1876
48302,16478,8124,8354,2171,4076,1877,1981,4381,1992
48304,16744,8043,8701,2159,3917,1967,1952,4473,2276
48306,23257,11553,11704,4124,6266,1163,3927,6507,1270
48307,38087,18493,19594,5486,11121,1886,5373,11317,2904
48309,28082,13495,14587,4133,7192,2170,4318,7385,2884
48310,41953,20919,21034,6563,11603,2753,5867,11716,3451
48312,31877,15282,16595,3952,8425,2905,3859,8630,4106
48313,33554,16510,17044,5443,9293,1774,5012,9517,2515
48314,16741,8231,8510,2569,4549,1113,2465,4559,1486
48315,22616,10823,11793,3446,5617,1760,3364,5918,2511
48316,21133,10560,10573,3146,5837,1577,3036,5959,1578
48317,25956,13281,12675,3965,8051,1265,3634,7353,1688
48320,4386,2228,2158,620,1373,235,512,1321,325
48322,30046,14552,15494,4305,7284,2963,3924,7866,3704
48323,17969,8766,9203,2682,4429,1655,2694,4952,1557
48324,18132,9213,8919,3033,5224,956,2688,5125,1106
48326,18105,9093,9012,2424,5825,844,2341,5423,1248
48327,21258,10668,10590,3250,6277,1141,2725,6294,1571
48328,26449,13252,13197,3761,8052,1439,3406,7378,2413
48329,25991,12850,13141,3725,7429,1696,3613,7483,2045
48331,22843,11118,11725,3497,6057,1564,3326,6707,1692
48334,18069,8476,9593,2281,4307,1888,2214,4598,2781
48335,22541,11152,11389,2674,6844,1634,2343,6507,2539
48336,26921,12938,13983,3733,7286,1919,3424,7387,3172
48340,24720,12095,12625,4539,6603,953,4210,6855,1560
48341,19737,9503,10234,3452,4955,1096,3186,5314,1734
48342,21510,10287,11223,4159,5325,803,4284,5659,1280
48346,23154,11590,11564,3637,6656,1297,3265,6723,1576
48348,20110,9939,10171,3691,5428,820,3433,5916,822
48350,7053,3589,3464,1267,1984,338,1098,2016,350
48353,6011,3008,3003,923,1704,381,864,1829,310
48356,8717,4475,4242,1532,2426,517,1291,2407,544
48357,9314,4667,4647,1646,2565,456,1599,2555,493
48359,7418,3808,3610,1261,2207,340,1106,2104,400
48360,11424,5859,5565,2088,3321,450,1802,3304,459
48362,13770,6891,6879,2089,4230,572,2231,3855,793
48363,4270,2148,2122,741,1106,301,586,1239,297
48367,4907,2416,2491,817,1302,297,835,1343,313
48370,1695,892,803,295,495,102,193,533,77
48371,18746,9372,9374,3329,5248,795,2957,5293,1124
48374,12135,6107,6028,2676,3150,281,2403,3315,310
48375,20986,10215,10771,3232,6116,867,3051,6371,1349
48377,10674,5286,5388,1286,3424,576,1189,3390,809
48380,6176,3133,3043,1122,1660,351,902,1598,543
48381,12176,6068,6108,2150,3233,685,1900,3457,751
48382,19141,9610,9531,3342,5461,807,3104,5372,1055
48383,12329,6195,6134,2091,3672,432,2073,3535,526
48386,15894,7819,8075,2228,4668,923,2446,4439,1190
48390,19681,9559,10122,2902,5541,1116,2908,5741,1473
48393,16263,8332,7931,2765,5036,531,2463,4744,724
48401,1493,761,732,258,347,156,195,379,158
48412,6028,3071,2957,1136,1564,371,982,1566,409
48413,8039,3876,4163,1210,1958,708,1187,1986,990
48414,2632,1307,1325,462,667,178,417,719,189
48415,9592,4776,4816,1524,2635,617,1430,2655,731
48416,5261,2656,2605,964,1338,354,896,1294,415
48417,3195,1595,1600,614,841,140,583,876,141
48418,3921,2027,1894,632,1091,304,573,1018,303
48419,2731,1428,1303,458,718,252,385,648,270
48420,22476,11001,11475,3471,6057,1473,3404,6281,1790
48421,6930,3587,3343,1253,1914,420,1026,1860,457
48422,6478,3237,3241,1185,1613,439,1021,1659,561
48423,31257,14973,16284,4699,8408,1866,4926,8642,2716
48426,1155,622,533,210,316,96,163,259,111
48427,3115,1483,1632,485,672,326,465,767,400
48428,5033,2550,2483,849,1402,299,853,1376,254
48429,10149,4920,5229,1649,2564,707,1704,2573,952
48430,32191,15974,16217,4875,9010,2089,4891,8707,2619
48432,807,408,399,111,225,72,116,189,94
48433,25158,12131,13027,3843,6100,2188,3540,6602,2885
48434,94,38,56,6,20,12,12,23,21
48435,2116,1098,1018,390,559,149,277,527,214
48436,3631,1852,1779,630,1068,154,559,1019,201
48437,351,150,201,55,76,19,83,88,30
48438,6137,3176,2961,1201,1695,280,900,1743,318
48439,39812,19675,20137,6118,10924,2633,5586,11253,3298
48440,88,38,50,13,15,10,31,19,0
48441,4583,2302,2281,777,1040,485,666,1001,614
48442,19072,9429,9643,3148,5294,987,3069,5249,1325
48444,8963,4371,4592,1582,2192,597,1489,2211,892
48445,1774,896,878,242,407,247,220,412,246
48446,30854,15604,15250,4904,8830,1870,4689,8137,2424
48449,3766,1850,1916,596,1017,237,641,986,289
48450,4956,2403,2553,605,1132,666,578,1176,799
48451,12017,6011,6006,2024,3279,708,1745,3354,907
48453,5543,2733,2810,1041,1300,392,928,1294,588
48454,1127,551,576,174,294,83,216,273,87
48455,8325,4220,4105,1354,2312,554,1292,2298,515
48456,1114,543,571,189,272,82,209,263,99
48457,8344,4144,4200,1301,2300,543,1329,2195,676
48458,24036,11772,12264,4336,5807,1629,3742,6383,2139
48460,2440,1213,1227,411,614,188,382,631,214
48461,7900,3952,3948,1491,2025,436,1493,1993,462
48462,13198,6821,6377,2256,4041,524,2080,3751,546
48463,4748,2389,2359,756,1338,295,672,1319,368
48464,2034,1049,985,315,588,146,313,552,120
48465,585,325,260,90,165,70,81,122,57
48466,1602,821,781,291,407,123,231,405,145
48467,2608,1272,1336,270,605,397,255,594,487
48468,1365,686,679,154,311,221,159,282,238
48469,1402,606,796,131,252,223,184,311,301
48470,922,455,467,176,204,75,156,205,106
48471,5920,2793,3127,879,1465,449,911,1468,748
48472,2042,1018,1024,346,514,158,345,514,165
48473,19485,9326,10159,2907,4981,1438,2749,5530,1880
48475,2758,1409,1349,476,671,262,380,659,310
48476,428,184,244,54,104,26,85,126,33
48502,986,785,201,103,647,35,19,148,34
48503,29497,13718,15779,4826,6923,1969,4739,8057,2983
48504,38981,18146,20835,7831,8527,1788,7522,10617,2696
48505,35047,16188,18859,7294,6825,2069,7281,8823,2755
48506,33356,16411,16945,5928,8640,1843,5441,8793,2711
48507,33084,15390,17694,4987,8057,2346,4939,9062,3693
48509,10037,4841,5196,1519,2467,855,1420,2624,1152
48519,7034,3281,3753,1071,1763,447,1214,1903,636
48529,11289,5573,5716,2078,2891,604,1932,2983,801
48532,19588,8942,10646,2535,4836,1571,2997,5381,2268
48601,47769,21692,26077,9202,9660,2830,9414,12805,3858
48602,32914,15882,17032,5629,8160,2093,5265,8494,3273
48603,38751,18044,20707,5269,9176,3599,5070,10086,5551
48604,11902,5702,6200,2163,2700,839,2151,2838,1211
48607,2605,1458,1147,488,746,224,369,527,251
48609,12231,5945,6286,1762,3136,1047,1637,3325,1324
48610,3470,1789,1681,505,809,475,429,803,449
48611,6100,3020,3080,1039,1516,465,906,1616,558
48612,9186,4619,4567,1344,2315,960,1279,2261,1027
48613,1096,546,550,170,280,96,186,278,86
48614,1341,646,695,218,334,94,225,368,102
48615,3086,1578,1508,588,752,238,438,786,284
48616,7614,3788,3826,1120,2107,561,1081,2010,735
48617,8707,4193,4514,1442,2038,713,1461,2098,955
48618,5256,2676,2580,913,1314,449,757,1328,495
48619,446,228,218,50,89,89,45,103,70
48620,36,17,19,0,2,15,0,4,15
48621,1583,708,875,196,334,178,266,342,267
48622,6161,2989,3172,885,1493,611,845,1606,721
48623,12507,6881,5626,1956,4204,721,1696,3071,859
48624,16283,8053,8230,2320,3547,2186,2141,3764,2325
48625,13531,6816,6715,1888,3290,1638,1799,3253,1663
48626,5834,2846,2988,946,1447,453,917,1574,497
48627,262,125,137,23,59,43,24,66,47
48628,2011,996,1015,227,537,232,264,495,256
48629,7616,3690,3926,903,1727,1060,936,1792,1198
48630,223,117,106,34,55,28,19,51,36
48631,4506,2259,2247,642,1183,434,582,1205,460
48632,5161,2610,2551,668,1221,721,606,1233,712
48633,58,30,28,3,8,19,2,7,19
48634,4732,2395,2337,779,1271,345,735,1241,361
48635,1861,916,945,188,444,284,213,429,303
48636,1203,567,636,121,272,174,175,288,173
48637,3444,1677,1767,519,867,291,527,847,393
48640,33085,16301,16784,5756,8341,2204,5206,8625,2953
48642,31222,15045,16177,5164,7890,1991,5014,8311,2852
48647,4644,2339,2305,739,1046,554,669,1067,569
48649,1681,847,834,309,417,121,239,425,170
48650,7589,3731,3858,1103,2117,511,1132,2023,703
48651,5100,2479,2621,638,1038,803,624,1174,823
48652,1572,801,771,260,412,129,242,407,122
48653,10125,5123,5002,1299,2367,1457,1104,2327,1571
48654,2796,1380,1416,409,645,326,417,656,343
48655,6672,3294,3378,1079,1770,445,1056,1743,579
48656,4564,2249,2315,569,1043,637,463,1114,738
48657,8053,3972,4081,1151,2201,620,1204,2251,626
48658,5933,3157,2776,882,1792,483,789,1365,622
48659,2809,1446,1363,484,693,269,402,667,294
48661,10028,4854,5174,1489,2365,1000,1419,2512,1243
48662,1666,853,813,281,460,112,254,414,145
48701,1509,760,749,258,356,146,217,376,156
48703,3406,1728,1678,438,777,513,362,778,538
48705,556,295,261,55,154,86,58,116,87
48706,40616,19404,21212,5666,10334,3404,5644,10633,4935
48708,29095,14131,14964,4515,7547,2069,4474,7393,3097
48720,1227,629,598,195,335,99,177,295,126
48721,498,260,238,69,126,65,83,118,37
48722,3322,1640,1682,418,900,322,387,933,362
48723,12907,6374,6533,1929,3469,976,1893,3275,1365
48724,335,169,166,74,59,36,42,115,9
48725,2480,1205,1275,266,542,397,249,504,522
48726,6524,3242,3282,1114,1554,574,972,1563,747
48727,1288,648,640,217,344,87,190,331,119
48728,284,138,146,10,57,71,17,65,64
48729,1611,821,790,279,431,111,258,404,128
48730,4798,2225,2573,580,1046,599,520,1106,947
48731,1879,960,919,332,465,163,283,472,164
48732,11809,5453,6356,1627,2872,954,1667,3101,1588
48733,2040,1017,1023,259,553,205,293,505,225
48734,7377,3507,3870,987,1726,794,953,1699,1218
48735,964,460,504,128,254,78,138,245,121
48737,1354,705,649,149,283,273,134,283,232
48738,1503,752,751,180,279,293,136,314,301
48739,4605,2327,2278,531,1028,768,541,980,757
48740,2573,1261,1312,308,570,383,287,628,397
48741,2139,1076,1063,353,537,186,343,537,183
48742,1810,875,935,233,374,268,178,372,385
48743,26,20,6,0,10,10,0,0,6
48744,4981,2447,2534,814,1258,375,844,1269,421
48745,1382,760,622,218,347,195,148,312,162
48746,8962,4540,4422,1558,2378,604,1414,2352,656
48747,1537,782,755,257,396,129,185,395,175
48748,1767,867,900,186,401,280,191,408,301
48749,1299,645,654,213,300,132,205,295,154
48750,9309,4618,4691,1358,2185,1075,1266,2210,1215
48754,991,507,484,178,236,93,148,226,110
48755,3201,1621,1580,434,731,456,378,713,489
48756,4172,2089,2083,584,959,546,532,957,594
48757,4036,1992,2044,663,1002,327,588,1040,416
48759,3638,1723,1915,485,873,365,525,862,528
48760,1162,572,590,173,289,110,195,281,114
48761,1087,558,529,100,265,193,100,212,217
48762,1392,735,657,172,353,210,142,322,193
48763,5151,2535,2616,643,1227,665,628,1172,816
48765,908,486,422,165,226,95,117,215,90
48766,1394,692,702,211,369,112,241,346,115
48767,2269,1158,1111,357,603,198,305,529,277
48768,10035,5098,4937,1936,2483,679,1520,2517,900
48770,2014,988,1026,297,478,213,289,496,241
48801,12960,6012,6948,2222,2854,936,2474,2941,1533
48806,1884,937,947,301,496,140,272,468,207
48807,888,449,439,131,255,63,139,215,85
48808,4269,2201,2068,699,1249,253,616,1215,237
48809,11197,5493,5704,2012,2855,626,1927,2886,891
48811,5023,3219,1804,697,2234,288,603,865,336
48813,20364,10120,10244,3331,5477,1312,3181,5389,1674
48815,1948,986,962,335,533,118,297,496,169
48817,6626,3273,3353,1003,1821,449,982,1749,622
48818,2628,1263,1365,369,652,242,405,665,295
48819,2360,1168,1192,378,663,127,387,659,146
48820,14149,7180,6969,2584,3794,802,2142,3884,943
48821,5733,2708,3025,775,1374,559,707,1564,754
48822,2368,1208,1160,352,680,176,307,646,207
48823,46158,22241,23917,8190,11982,2069,9056,11842,3019
48824,12607,5821,6786,5154,667,0,6293,493,0
48827,14771,7328,7443,2561,3842,925,2388,4026,1029
48829,3349,1605,1744,530,799,276,562,805,377
48830,55,21,34,8,10,3,8,17,9
48831,3625,1817,1808,608,915,294,549,901,358
48832,1408,716,692,248,337,131,199,383,110
48834,2363,1231,1132,423,652,156,371,599,162
48835,3329,1714,1615,655,838,221,559,793,263
48836,12071,6038,6033,2340,3077,621,2128,3240,665
48837,17664,8693,8971,2911,4595,1187,2688,4918,1365
48838,16420,8036,8384,2722,4074,1240,2477,4235,1672
48840,12057,5519,6538,1747,3170,602,1721,3704,1113
48841,859,446,413,176,201,69,125,202,86
48842,18640,8926,9714,3072,4886,968,3154,5074,1486
48843,43873,22053,21820,7551,12200,2302,6925,12002,2893
48845,1030,541,489,224,251,66,175,240,74
48846,19931,12381,7550,3784,7543,1054,2437,3735,1378
48847,6357,3075,3282,1044,1556,475,956,1623,703
48848,7732,3917,3815,1362,2061,494,1180,2163,472
48849,6192,3072,3120,1129,1551,392,1073,1511,536
48850,4669,2259,2410,768,1085,406,786,1116,508
48851,2253,1193,1060,435,601,157,318,585,157
48852,102,49,53,14,29,6,19,23,11
48853,422,199,223,82,96,21,64,114,45
48854,17022,8621,8401,2836,4625,1160,2476,4499,1426
48856,959,475,484,159,233,83,174,224,86
48857,2367,1227,1140,398,681,148,355,660,125
48858,44097,20584,23513,8735,10115,1734,11061,9848,2604
48860,1404,718,686,244,390,84,248,347,91
48861,1624,815,809,274,433,108,258,424,127
48864,19778,9534,10244,3077,5405,1052,3064,5838,1342
48865,1883,1015,868,343,533,139,266,464,138
48866,4518,2202,2316,722,1154,326,724,1149,443
48867,28037,13560,14477,4471,6976,2113,4257,7165,3055
48871,1886,927,959,276,471,180,270,477,212
48872,7583,3674,3909,1266,2024,384,1307,2097,505
48873,1874,937,937,354,460,123,356,451,130
48874,169,73,96,25,46,2,39,43,14
48875,9301,4564,4737,1645,2454,465,1678,2420,639
48876,3348,1577,1771,548,865,164,623,965,183
48877,2640,1321,1319,468,656,197,457,688,174
48878,1725,825,900,293,421,111,314,447,139
48879,17477,8731,8746,2972,4589,1170,2653,4496,1597
48880,9502,6160,3342,1215,4301,644,1051,1592,699
48881,5406,2625,2781,918,1374,333,913,1436,432
48883,7383,3666,3717,1286,1932,448,1207,1953,557
48884,4702,2654,2048,659,1647,348,636,1080,332
48885,845,428,417,162,219,47,118,241,58
48886,2220,1087,1133,350,537,200,369,536,228
48888,6958,3503,3455,1184,1794,525,1101,1710,644
48889,1368,674,694,213,359,102,214,354,126
48890,2076,1010,1066,340,545,125,339,539,188
48891,2895,1458,1437,461,780,217,463,701,273
48892,4362,2137,2225,748,1127,262,716,1221,288
48893,4720,2313,2407,659,1201,453,741,1211,455
48894,657,316,341,109,138,69,107,152,82
48895,11163,5536,5627,1886,2932,718,1715,3091,821
48896,115,47,68,14,29,4,31,35,2
48897,1497,756,741,217,377,162,233,386,122
48906,26741,13251,13490,4648,6931,1672,4291,7000,2199
48910,35702,16900,18802,5218,9751,1931,5265,10439,3098
48911,39707,18591,21116,7021,9738,1832,6822,11563,2731
48912,18515,8982,9533,2842,5186,954,2507,5484,1542
48915,10400,5284,5116,1988,2794,502,1648,2816,652
48917,31216,14728,16488,4548,7941,2239,4131,9101,3256
48933,2318,1264,1054,252,840,172,210,593,251
49001,41772,20355,21417,7038,11230,2087,6771,11119,3527
49002,19074,9288,9786,2814,5083,1391,2779,5013,1994
49004,21654,10412,11242,3506,5204,1702,3081,5828,2333
49006,23937,11476,12461,4354,5928,1194,4818,5528,2115
49007,11924,5848,6076,2287,3068,493,2343,3007,726
49008,21520,10429,11091,4743,4555,1131,4878,4600,1613
49009,29964,14190,15774,4495,7781,1914,5019,8124,2631
49010,16629,8345,8284,2756,4333,1256,2571,4164,1549
49011,2317,1143,1174,425,565,153,396,563,215
49012,3506,1739,1767,486,967,286,474,980,313
49013,5392,2665,2727,990,1261,414,895,1295,537
49014,22768,11402,11366,3714,6111,1577,3290,6030,2046
49015,34252,16698,17554,5357,8777,2564,4927,9066,3561
49016,281,281,0,22,203,56,0,0,0
49017,36435,17199,19236,5711,8819,2669,5569,9506,4161
49021,6078,3060,3018,1040,1562,458,898,1581,539
49022,35013,16411,18602,6348,7682,2381,6496,8906,3200
49024,27984,13474,14510,4684,6969,1821,4392,7840,2278
49026,2701,1355,1346,442,712,201,335,753,258
49027,130,63,67,14,35,14,26,30,11
49028,6732,3462,3270,1195,1788,479,1062,1555,653
49029,1687,839,848,248,462,129,237,477,134
49030,2657,1328,1329,481,660,187,473,620,236
49031,7930,3963,3967,1220,2064,679,1131,2047,789
49032,3421,1722,1699,641,832,249,592,819,288
49033,1610,812,798,258,399,155,212,472,114
49034,2255,1139,1116,367,626,146,350,580,186
49036,24723,12545,12178,3540,6992,2013,3217,6385,2576
49038,10140,4979,5161,1481,2698,800,1548,2549,1064
49040,3507,1790,1717,599,885,306,475,887,355
49042,5001,2501,2500,854,1296,351,849,1274,377
49043,2557,1249,1308,462,574,213,484,616,208
49045,5967,3068,2899,1140,1452,476,908,1448,543
49046,7151,3518,3633,1020,1897,601,1036,1877,720
49047,15542,7659,7883,2507,3770,1382,2330,3773,1780
49050,1529,822,707,273,427,122,155,422,130
49051,2230,1063,1167,290,541,232,289,631,247
49052,828,444,384,131,246,67,122,191,71
49053,6356,3084,3272,1011,1620,453,987,1719,566
49055,6080,3077,3003,1098,1550,429,992,1553,458
49056,4203,2212,1991,766,1107,339,662,962,367
49057,6861,3517,3344,1311,1756,450,1116,1687,541
49058,18266,9067,9199,2956,4720,1391,2796,4542,1861
49060,2103,1056,1047,287,607,162,256,602,189
49061,1590,833,757,283,417,133,189,465,103
49064,3843,1895,1948,660,982,253,660,964,324
49065,6438,3082,3356,1044,1606,432,1084,1677,595
49066,784,396,388,163,160,73,136,184,68
49067,4450,2263,2187,732,1176,355,664,1144,379
49068,15154,7280,7874,2285,3749,1246,2235,3889,1750
49070,2173,1093,1080,387,558,148,376,529,175
49071,8335,4237,4098,1580,2292,365,1489,2283,326
49072,3313,1653,1660,529,870,254,534,821,305
49073,5107,2521,2586,850,1352,319,867,1280,439
49075,150,55,95,28,23,4,44,44,7
49076,4558,2283,2275,992,1081,210,934,1063,278
49078,8968,4398,4570,1508,2255,635,1292,2494,784
49079,12501,6237,6264,2003,3346,888,1904,3217,1143
49080,14480,7262,7218,2408,3894,960,2266,3819,1133
49082,6750,3328,3422,1243,1645,440,1190,1677,555
49083,6434,3225,3209,1098,1657,470,964,1704,541
49085,24089,11754,12335,3476,6079,2199,3149,6199,2987
49087,5390,2733,2657,992,1428,313,836,1428,393
49088,3004,1470,1534,430,798,242,450,849,235
49089,2043,1057,986,355,546,156,314,518,154
49090,15044,7298,7746,2458,3573,1267,2124,3757,1865
49091,20308,10018,10290,3446,5226,1346,3213,5042,2035
49092,2170,1063,1107,308,588,167,337,551,219
49093,17912,8783,9129,2835,4483,1465,2722,4528,1879
49094,4176,2070,2106,637,1036,397,643,1005,458
49095,1895,1006,889,320,483,203,214,458,217
49096,3297,1680,1617,586,881,213,535,827,255
49097,9908,4819,5089,1511,2512,796,1631,2636,822
49098,6205,2977,3228,985,1508,484,966,1613,649
49099,5634,2813,2821,885,1472,456,851,1485,485
49101,3187,1620,1567,531,840,249,452,816,299
49102,1512,745,767,252,337,156,235,326,206
49103,12768,6100,6668,2166,3126,808,2105,3397,1166
49106,4994,2412,2582,707,1280,425,695,1215,672
49107,10648,5186,5462,1727,2611,848,1599,2779,1084
49111,3700,1840,1860,575,980,285,599,930,331
49112,9997,5077,4920,1647,2632,798,1391,2651,878
49113,1993,964,1029,287,528,149,313,517,199
49115,17,5,12,0,0,5,0,0,12
49116,311,172,139,54,54,64,20,55,64
49117,4236,2143,2093,524,1142,477,455,1053,585
49119,77,35,42,6,20,9,9,21,12
49120,35297,17042,18255,5309,8745,2988,5122,9148,3985
49125,2629,1397,1232,456,692,249,312,609,311
49126,1507,752,755,219,371,162,180,364,211
49127,9188,4541,4647,1432,2389,720,1367,2444,836
49128,4609,2215,2394,580,1201,434,624,1260,510
49129,726,315,411,71,149,95,72,199,140
49130,1348,680,668,214,326,140,162,360,146
49201,45438,25980,19458,6504,16158,3318,5910,10307,3241
49202,21300,9878,11422,3283,5111,1484,3013,5472,2937
49203,38469,18399,20070,6491,9052,2856,6154,9783,4133
49220,2318,1102,1216,414,536,152,399,622,195
49221,41098,20722,20376,6553,11479,2690,6383,9937,4056
49224,14805,7148,7657,2778,3232,1138,2638,3514,1505
49227,1184,582,602,198,305,79,198,308,96
49228,5683,2764,2919,940,1378,446,879,1432,608
49229,2968,1485,1483,489,785,211,487,738,258
49230,9414,4615,4799,1257,2429,929,1247,2422,1130
49232,2849,1442,1407,544,696,202,469,700,238
49233,1557,838,719,243,407,188,162,423,134
49234,2570,1336,1234,382,673,281,345,654,235
49235,2050,1087,963,367,561,159,295,488,180
49236,4865,2420,2445,789,1330,301,777,1280,388
49237,3103,1569,1534,575,789,205,484,810,240
49238,1833,900,933,324,458,118,334,448,151
49240,7489,3793,3696,1058,2172,563,1023,2025,648
49241,2363,1204,1159,425,584,195,334,600,225
49242,15418,7389,8029,2578,3730,1081,2677,3745,1607
49245,4812,2380,2432,852,1240,288,824,1192,416
49246,3371,1712,1659,539,922,251,493,912,254
49247,5989,2955,3034,980,1466,509,921,1524,589
49248,983,480,503,165,248,67,185,233,85
49249,3435,1760,1675,485,911,364,435,926,314
49250,5987,2988,2999,1087,1483,418,999,1475,525
49251,6249,3079,3170,990,1724,365,1000,1693,477
49252,2542,1285,1257,412,644,229,359,590,308
49253,3106,1580,1526,428,911,241,413,806,307
49254,3511,1825,1686,575,1012,238,558,792,336
49255,1941,1002,939,408,459,135,377,437,125
49256,4232,2119,2113,764,1055,300,645,1040,428
49259,2765,1376,1389,567,652,157,523,694,172
49262,1412,757,655,240,371,146,172,325,158
49263,28,11,17,2,9,0,4,8,5
49264,1902,938,964,339,490,109,367,469,128
49265,4780,2342,2438,754,1269,319,724,1343,371
49266,3001,1466,1535,467,753,246,510,748,277
49267,3959,2067,1892,703,1088,276,504,1057,331
49268,1201,640,561,224,318,98,175,279,107
49269,6421,3289,3132,1235,1713,341,1108,1582,442
49270,5785,2987,2798,986,1615,386,835,1521,442
49271,2299,1185,1114,389,636,160,357,565,192
49272,2405,1181,1224,363,672,146,360,664,200
49274,3597,1808,1789,598,863,347,574,893,322
49276,1069,536,533,194,279,63,169,275,89
49277,3689,1823,1866,623,1031,169,621,1003,242
49279,909,440,469,131,230,79,183,197,89
49281,587,285,302,80,167,38,85,184,33
49282,866,384,482,132,162,90,145,213,124
49283,3073,1345,1728,517,565,263,684,608,436
49284,3042,1521,1521,466,831,224,482,766,273
49285,5006,2468,2538,765,1406,297,797,1362,379
49286,13973,6790,7183,2216,3615,959,1941,3799,1443
49287,2010,1070,940,333,605,132,255,549,136
49288,1417,721,696,274,344,103,221,333,142
49289,96,48,48,21,19,8,9,31,8
49301,10122,5050,5072,1727,2832,491,1660,2889,523
49302,6342,3204,3138,1172,1717,315,1071,1733,334
49303,945,487,458,180,242,65,150,246,62
49304,4544,2497,2047,831,1006,660,427,936,684
49305,2670,1325,1345,400,627,298,364,648,333
49306,7729,3881,3848,1374,2023,484,1222,2036,590
49307,19074,9798,9276,4316,4501,981,3784,4070,1422
49309,1804,935,869,260,435,240,253,407,209
49310,2692,1374,1318,459,707,208,410,670,238
49312,99,43,56,10,21,12,21,23,12
49315,13923,7016,6907,2445,3714,857,2422,3510,975
49316,13862,6895,6967,2472,3634,789,2359,3644,964
49318,1596,849,747,273,481,95,244,415,88
49319,13779,6754,7025,2317,3685,752,2638,3534,853
49321,15437,7799,7638,2798,4289,712,2533,4213,892
49322,1267,642,625,221,311,110,205,307,113
49323,7932,3967,3965,1561,2108,298,1496,2101,368
49325,1599,790,809,237,428,125,282,409,118
49326,3435,1728,1707,516,944,268,445,954,308
49327,7778,3867,3911,1461,1949,457,1419,1955,537
49328,3770,1899,1871,700,977,222,683,935,253
49329,6908,3484,3424,1300,1770,414,1141,1820,463
49330,4917,2442,2475,921,1265,256,930,1277,268
49331,14574,7240,7334,2706,3891,643,2463,3832,1039
49332,2823,1411,1412,337,673,401,313,653,446
49333,9261,4608,4653,1621,2459,528,1627,2446,580
49335,118,45,73,12,25,8,36,27,10
49336,4013,2024,1989,744,1038,242,722,966,301
49337,12163,6177,5986,2046,3039,1092,1823,3003,1160
49338,2109,1057,1052,397,556,104,405,534,113
49339,2163,1093,1070,360,602,131,370,563,137
49340,3020,1498,1522,520,718,260,496,742,284
49341,29349,14656,14693,5711,7491,1454,5250,7960,1483
49342,1807,893,914,273,401,219,268,453,193
49343,4916,2512,2404,855,1365,292,802,1251,351
49344,3438,1806,1632,556,882,368,424,866,342
49345,12576,6117,6459,2182,3157,778,2187,3260,1012
49346,4502,2268,2234,614,956,698,557,1011,666
49347,1275,648,627,213,331,104,194,318,115
49348,11397,5690,5707,2134,2946,610,1998,2935,774
49349,8422,4295,4127,1488,2131,676,1373,2025,729
49401,13160,6163,6997,3263,2508,392,4123,2403,471
49402,1324,701,623,161,351,189,98,356,169
49403,2538,1340,1198,457,680,203,434,590,174
49404,8074,3977,4097,1495,1999,483,1361,2079,657
49405,1606,790,816,220,436,134,257,415,144
49406,746,371,375,78,201,92,80,173,122
49408,9236,4727,4509,1640,2504,583,1380,2361,768
49410,1667,836,831,238,417,181,236,392,203
49411,1707,945,762,249,539,157,205,401,156
49412,11262,5374,5888,1874,2500,1000,1839,2720,1329
49415,5753,2851,2902,886,1561,404,920,1565,417
49417,28109,13827,14282,4502,7489,1836,4201,7449,2632
49418,24862,12386,12476,4577,6206,1603,4144,6137,2195
49419,6303,3177,3126,1151,1747,279,1120,1700,306
49420,6747,3415,3332,1221,1632,562,1134,1509,689
49421,6120,3103,3017,1113,1486,504,958,1498,561
49423,46782,22495,24287,8293,11413,2789,8692,11160,4435
49424,42185,21125,21060,7520,11641,1964,7385,11460,2215
49425,3601,1832,1769,619,956,257,585,932,252
49426,27473,13763,13710,5468,6827,1468,5207,6667,1836
49428,24410,11805,12605,4240,6012,1553,4128,6343,2134
49431,16514,7978,8536,2374,3968,1636,2373,3999,2164
49434,48,10,38,0,0,10,0,12,26
49435,3512,1695,1817,569,941,185,682,873,262
49436,1700,893,807,276,435,182,214,413,180
49437,6702,3319,3383,1028,1689,602,968,1690,725
49440,775,292,483,62,171,59,119,179,185
49441,40859,19714,21145,5991,10012,3711,5783,10288,5074
49442,45933,23731,22202,8125,13152,2454,7346,10646,4210
49444,21603,10211,11392,4122,4781,1308,3975,5571,1846
49445,19774,9894,9880,3346,5015,1533,2810,5159,1911
49446,2460,1247,1213,436,635,176,420,601,192
49448,3331,1755,1576,596,935,224,463,893,220
49449,2712,1357,1355,348,626,383,290,629,436
49450,3173,1619,1554,695,781,143,575,789,190
49451,5834,2955,2879,1096,1466,393,958,1425,496
49452,1878,992,886,387,495,110,283,492,111
49453,2535,1227,1308,314,678,235,340,686,282
49454,4635,2322,2313,820,1115,387,715,1125,473
49455,5032,2517,2515,907,1179,431,769,1207,539
49456,17015,8238,8777,2477,4302,1459,2423,4523,1831
49457,9689,4847,4842,1765,2646,436,1626,2661,555
49458,131,71,60,12,48,11,14,33,13
49459,1442,724,718,291,331,102,254,339,125
49460,7350,3878,3472,1444,1981,453,1048,1958,466
49461,8843,4252,4591,1408,2185,659,1475,2246,870
49464,21336,10308,11028,4105,4977,1226,4086,5293,1649
49503,34141,17842,16299,5515,10789,1538,5063,8915,2321
49504,40364,19848,20516,6564,10684,2600,6513,9873,4130
49505,31981,15584,16397,5231,7797,2556,4659,8513,3225
49506,33618,15854,17764,5752,8128,1974,5677,8598,3489
49507,39819,19566,20253,8449,9815,1302,7834,10491,1928
49508,39716,18791,20925,6521,10056,2214,6609,10965,3351
49509,59163,29268,29895,10221,15982,3065,9686,15859,4350
49512,11303,5725,5578,1621,3640,464,1304,3631,643
49525,26819,13078,13741,4853,6644,1581,4682,7007,2052
49544,28261,14068,14193,4864,7496,1708,4363,7656,2174
49546,33933,15757,18176,5887,7418,2452,6341,8104,3731
49548,31561,15284,16277,5240,8378,1666,5308,8567,2402
49601,20148,9803,10345,3269,4887,1647,3020,5045,2280
49611,301,152,149,58,70,24,50,74,25
49612,1012,498,514,116,257,125,142,241,131
49613,682,326,356,57,141,128,84,131,141
49614,2656,1326,1330,396,644,286,359,647,324
49615,3977,1933,2044,487,944,502,473,940,631
49616,2060,1024,1036,295,497,232,261,459,316
49617,3085,1512,1573,363,800,349,407,767,399
49618,829,416,413,128,217,71,149,205,59
49619,1026,514,512,143,245,126,120,236,156
49620,2098,1058,1040,365,543,150,356,534,150
49621,2852,1432,1420,463,703,266,446,698,276
49622,2724,1348,1376,380,649,319,368,673,335
49623,1262,635,627,196,344,95,211,316,100
49625,1283,689,594,225,362,102,161,310,123
49626,293,131,162,39,71,21,51,70,41
49627,245,135,110,35,54,46,16,44,50
49628,291,120,171,45,60,15,65,76,30
49629,2299,1159,1140,355,495,309,245,526,369
49630,1229,603,626,140,281,182,139,313,174
49631,6217,3098,3119,996,1494,608,943,1476,700
49632,1162,576,586,200,270,106,186,274,126
49633,3484,1770,1714,550,885,335,500,867,347
49634,96,56,40,28,23,5,11,29,0
49635,3607,1742,1865,447,781,514,401,834,630
49636,563,269,294,58,119,92,61,116,117
49637,2703,1337,1366,453,750,134,414,736,216
49638,835,429,406,121,203,105,101,199,106
49639,2345,1168,1177,383,545,240,390,579,208
49640,1471,753,718,199,355,199,136,370,212
49642,669,329,340,112,118,99,90,149,101
49643,4945,2463,2482,827,1306,330,731,1418,333
49644,1737,879,858,161,400,318,170,418,270
49645,1604,797,807,241,402,154,229,416,162
49646,8205,4083,4122,1255,2077,751,1242,2012,868
49648,2028,1027,1001,292,437,298,218,490,293
49649,5849,2951,2898,1072,1641,238,1081,1470,347
49650,2550,1246,1304,398,661,187,422,694,188
49651,7381,3673,3708,1062,1862,749,1047,1802,859
49653,2061,1047,1014,315,493,239,299,481,234
49654,620,292,328,64,115,113,50,142,136
49655,3010,1497,1513,504,725,268,467,778,268
49656,1559,767,792,206,370,191,260,362,170
49657,3434,1719,1715,664,774,281,578,761,376
49659,6408,3225,3183,1015,1683,527,1010,1607,566
49660,14115,7238,6877,2018,3808,1412,1688,3265,1924
49663,5534,2747,2787,967,1352,428,928,1402,457
49664,2011,1039,972,322,543,174,273,499,200
49665,4265,2099,2166,704,1012,383,700,1044,422
49666,15,9,6,0,9,0,0,6,0
49667,551,256,295,68,136,52,117,132,46
49668,3291,1681,1610,589,818,274,466,823,321
49670,2126,1052,1074,258,445,349,212,484,378
49675,1172,625,547,198,262,165,117,229,201
49676,3152,1588,1564,475,807,306,383,837,344
49677,6867,3326,3541,1082,1640,604,1101,1710,730
49679,1087,560,527,155,281,124,145,262,120
49680,1831,926,905,348,475,103,314,454,137
49682,3988,1986,2002,651,940,395,630,945,427
49683,1800,932,868,283,449,200,217,473,178
49684,34640,16807,17833,5256,9171,2380,5126,9523,3184
49686,29000,13876,15124,4152,7243,2481,4169,7472,3483
49688,2593,1288,1305,413,663,212,402,659,244
49689,1628,862,766,239,430,193,197,384,185
49690,6556,3319,3237,908,1827,584,908,1694,635
49701,805,383,422,93,179,111,112,207,103
49705,906,457,449,160,212,85,125,244,80
49706,4588,2280,2308,694,1229,357,631,1265,412
49707,24054,11664,12390,3493,5864,2307,3374,5877,3139
49709,3953,1906,2047,439,885,582,481,889,677
49710,450,224,226,42,100,82,51,109,66
49712,8024,3983,4041,1284,2022,677,1203,2024,814
49713,2032,1053,979,335,535,183,301,494,184
49715,2810,1470,1340,511,701,258,411,697,232
49716,904,475,429,145,248,82,124,213,92
49718,929,453,476,111,221,121,125,198,153
49719,1664,811,853,206,399,206,177,402,274
49720,9468,4627,4841,1397,2292,938,1360,2452,1029
49721,15020,7493,7527,2244,3664,1585,1962,3605,1960
49722,54,21,33,0,17,4,10,23,0
49724,1123,567,556,170,295,102,189,272,95
49725,822,430,392,80,202,148,69,179,144
49726,1031,525,506,118,260,147,92,246,168
49727,7160,3567,3593,1199,1742,626,1068,1774,751
49728,305,165,140,58,70,37,46,55,39
49729,1602,806,796,273,399,134,216,416,164
49730,1843,939,904,298,483,158,276,450,178
49733,1979,997,982,291,483,223,259,512,211
49735,18872,9315,9557,3033,4740,1542,2946,4772,1839
49736,562,283,279,44,149,90,47,122,110
49738,10421,5317,5104,1642,2607,1068,1395,2441,1268
49740,7257,3666,3591,1007,1891,768,849,1831,911
49743,831,411,420,96,197,118,110,194,116
49744,845,427,418,138,206,83,149,207,62
49745,235,129,106,35,62,32,18,62,26
49746,3857,1942,1915,554,891,497,457,895,563
49747,1826,917,909,224,430,263,215,433,261
49748,261,151,110,26,81,44,25,57,28
49749,4355,2141,2214,544,974,623,515,1045,654
49751,1814,947,867,215,468,264,207,458,202
49752,342,177,165,44,100,33,38,90,37
49753,2245,1089,1156,281,572,236,354,549,253
49755,1996,1018,978,298,551,169,256,538,184
49756,3948,1975,1973,424,879,672,402,858,713
49757,510,248,262,59,138,51,54,162,46
49759,1716,842,874,198,360,284,201,384,289
49760,687,384,303,114,197,73,64,156,83
49761,36,21,15,3,6,12,1,8,6
49762,762,400,362,95,178,127,84,156,122
49764,80,45,35,18,20,7,5,17,13
49765,4420,2230,2190,668,1058,504,604,1006,580
49766,2640,1286,1354,366,699,221,409,610,335
49768,477,237,240,44,125,68,31,121,88
49769,1520,769,751,304,364,101,242,388,121
49770,15517,7423,8094,2434,3801,1188,2349,3985,1760
49774,1920,975,945,294,476,205,257,477,211
49775,80,41,39,7,22,12,10,20,9
49776,2092,1081,1011,342,507,232,276,482,253
49777,1536,801,735,176,351,274,127,328,280
49779,5200,2536,2664,691,1174,671,588,1220,856
49780,2186,1098,1088,359,545,194,327,545,216
49781,5248,2628,2620,779,1349,500,703,1309,608
49782,544,254,290,57,125,72,60,130,100
49783,21450,11513,9937,3313,6725,1475,3157,4728,2052
49788,5111,3783,1328,672,2956,155,577,664,87
49791,71,33,38,0,23,10,9,14,15
49792,63,26,37,15,9,2,10,17,10
49793,161,71,90,12,41,18,20,39,31
49795,1918,956,962,274,500,182,270,486,206
49796,162,81,81,25,41,15,30,34,17
49799,2167,1077,1090,327,568,182,378,532,180
49801,12475,6164,6311,1930,3013,1221,1694,2965,1652
49802,7023,3400,3623,1079,1675,646,992,1704,927
49805,199,110,89,28,50,32,9,51,29
49806,599,315,284,77,151,87,58,127,99
49807,3599,1857,1742,531,965,361,477,946,319
49808,179,85,94,17,44,24,25,52,17
49812,853,457,396,147,228,82,111,211,74
49813,242,134,108,17,64,53,15,63,30
49814,1520,785,735,226,420,139,190,398,147
49815,541,258,283,79,120,59,87,117,79
49816,768,373,395,90,202,81,113,195,87
49817,623,305,318,109,131,65,91,152,75
49818,1058,567,491,162,292,113,142,281,68
49820,868,436,432,105,207,124,88,229,115
49821,1469,770,699,222,375,173,200,358,141
49822,215,118,97,36,57,25,29,48,20
49825,192,86,106,21,50,15,37,48,21
49826,32,16,16,3,10,3,6,7,3
49827,935,446,489,102,212,132,121,234,134
49829,18401,8810,9591,2722,4478,1610,2673,4408,2510
49831,41,25,16,11,12,2,2,7,7
49833,171,81,90,8,44,29,10,66,14
49834,257,120,137,30,61,29,45,61,31
49835,918,451,467,121,217,113,104,220,143
49836,662,317,345,72,145,100,67,154,124
49837,9668,4702,4966,1451,2304,947,1510,2398,1058
49838,307,139,168,13,71,55,36,74,58
49839,411,211,200,45,90,76,33,82,85
49840,859,450,409,107,219,124,106,208,95
49841,5609,2867,2742,901,1507,459,825,1484,433
49847,1080,553,527,175,252,126,130,260,137
49848,207,107,100,43,45,19,38,56,6
49849,12659,6128,6531,1881,3172,1075,1882,3214,1435
49852,120,51,69,4,29,18,16,37,16
49853,1277,651,626,148,314,189,131,317,178
49854,6738,3383,3355,956,1714,713,876,1538,941
49855,32373,16512,15861,5120,9170,2222,5051,7978,2832
49858,13285,6528,6757,1947,3358,1223,1797,3253,1707
49861,509,262,247,57,131,74,36,135,76
49862,5054,2738,2316,695,1594,449,574,1088,654
49863,143,62,81,20,36,6,36,32,13
49864,26,15,11,0,6,9,0,0,11
49866,7790,3826,3964,1171,2021,634,1048,2012,904
49868,5771,3266,2505,825,1975,466,733,1152,620
49870,3481,1693,1788,536,860,297,492,849,447
49871,451,211,240,62,91,58,54,102,84
49872,55,24,31,0,22,2,6,17,8
49873,97,46,51,8,24,14,14,20,17
49874,1068,464,604,131,244,89,161,244,199
49876,1186,592,594,166,328,98,187,323,84
49877,49,22,27,0,6,16,4,10,13
49878,3979,2067,1912,539,1037,491,468,950,494
49879,1019,527,492,106,252,169,111,216,165
49880,1221,588,633,163,306,119,193,334,106
49881,391,214,177,79,98,37,45,98,34
49883,167,91,76,14,54,23,18,41,17
49884,970,633,337,119,454,60,101,187,49
49885,2108,1065,1043,345,579,141,288,596,159
49886,561,296,265,70,146,80,83,113,69
49887,2217,1091,1126,298,510,283,249,508,369
49891,932,474,458,109,249,116,118,224,116
49892,1986,1005,981,319,527,159,280,520,181
49893,1733,872,861,234,485,153,286,438,137
49894,708,383,325,130,170,83,60,171,94
49895,663,336,327,82,180,74,98,152,77
49896,1629,825,804,322,401,102,300,387,117
49901,406,203,203,42,109,52,51,91,61
49902,204,111,93,33,46,32,29,36,28
49903,153,75,78,22,29,24,17,36,25
49905,1662,866,796,385,388,93,343,350,103
49908,3116,1843,1273,445,1184,214,423,589,261
49910,480,228,252,42,110,76,55,132,65
49911,3018,1504,1514,443,702,359,376,674,464
49912,1096,579,517,152,260,167,113,242,162
49913,8056,4019,4037,1253,1858,908,1202,1759,1076
49915,940,456,484,132,208,116,123,201,160
49916,2628,1355,1273,414,653,288,367,648,258
49917,193,81,112,23,32,26,33,54,25
49918,76,37,39,3,19,15,9,19,11
49919,208,118,90,32,54,32,20,49,21
49920,4473,2199,2274,548,1032,619,483,955,836
49921,390,219,171,83,111,25,35,98,38
49922,1201,615,586,185,314,116,161,307,118
49925,677,341,336,93,175,73,81,157,98
49927,496,246,250,59,117,70,66,99,85
49929,156,83,73,15,43,25,14,38,21
49930,6190,3101,3089,997,1562,542,864,1358,867
49931,9041,5356,3685,2820,2140,396,1567,1540,578
49934,891,430,461,136,218,76,129,228,104
49935,5855,2923,2932,695,1479,749,683,1283,966
49938,8960,4278,4682,1207,2020,1051,1214,2061,1407
49942,306,153,153,39,57,57,40,64,49
49945,2716,1360,1356,422,636,302,343,613,400
49946,4212,2020,2192,568,1045,407,611,1039,542
49947,1174,823,351,211,502,110,91,180,80
49948,731,396,335,105,214,77,76,172,87
49950,1411,770,641,280,327,163,144,308,189
49952,81,43,38,9,26,8,11,21,6
49953,3282,1596,1686,373,817,406,382,767,537
49955,601,417,184,71,306,40,60,73,51
49958,1288,702,586,226,335,141,159,253,174
49959,370,214,156,66,96,52,19,81,56
49960,253,126,127,33,57,36,34,50,43
49961,137,79,58,20,40,19,10,25,23
49962,207,112,95,16,57,39,5,48,42
49963,697,383,314,96,189,98,89,134,91
49964,979,437,542,120,208,109,139,233,170
49965,400,216,184,41,108,67,45,90,49
49967,451,244,207,44,121,79,38,85,84
49968,2501,1170,1331,249,571,350,241,582,508
49969,1451,782,669,275,311,196,163,309,197
49970,378,179,199,32,87,60,40,89,70
49971,624,316,308,67,131,118,61,143,104
50001,726,374,352,134,211,29,142,181,29
50002,1277,639,638,182,289,168,130,284,224
50003,5914,2886,3028,986,1487,413,917,1537,574
50005,923,457,466,151,217,89,157,223,86
50006,1947,936,1011,303,457,176,321,446,244
50007,452,209,243,70,107,32,84,132,27
50008,974,453,521,141,215,97,187,235,99
50009,11842,5706,6136,2141,2965,600,1931,3478,727
50010,24901,12397,12504,3544,7326,1527,3437,6942,2125
50014,29821,16221,13600,8116,7282,823,7021,5555,1024
50020,1527,768,759,250,353,165,189,346,224
50021,31114,15114,16000,5270,8269,1575,5152,8831,2017
50022,8753,4158,4595,1259,1977,922,1120,2069,1406
50025,3831,1825,2006,599,762,464,504,789,713
50026,658,307,351,83,168,56,115,162,74
50027,367,195,172,70,88,37,54,77,41
50028,1557,775,782,253,386,136,214,384,184
50029,780,370,410,127,160,83,127,150,133
50032,418,189,229,46,126,17,62,97,70
50033,44,24,20,5,17,2,5,11,4
50034,503,250,253,77,137,36,88,129,36
50035,3010,1511,1499,541,801,169,474,825,200
50036,16194,7799,8395,2430,3996,1373,2297,4139,1959
50038,341,174,167,34,115,25,55,89,23
50039,376,199,177,66,96,37,43,98,36
50040,219,107,112,25,50,32,22,56,34
50041,148,76,72,28,48,0,27,39,6
50042,363,199,164,61,74,64,37,76,51
50044,1133,586,547,193,299,94,171,254,122
50046,1371,701,670,229,359,113,209,353,108
50047,5050,2422,2628,781,1256,385,769,1344,515
50048,1030,503,527,149,253,101,169,231,127
50049,6836,3294,3542,1059,1550,685,962,1508,1072
50050,845,416,429,137,150,129,101,193,135
50051,300,169,131,41,96,32,35,53,43
50052,197,96,101,38,30,28,31,35,35
50054,3659,1884,1775,667,977,240,503,908,364
50055,900,450,450,127,225,98,119,208,123
50056,1514,772,742,270,388,114,225,372,145
50057,229,119,110,40,47,32,32,45,33
50058,2065,1001,1064,324,455,222,274,450,340
50059,23,23,0,15,8,0,0,0,0
50060,2563,1244,1319,344,545,355,278,543,498
50061,1197,583,614,195,279,109,188,341,85
50062,1642,791,851,244,386,161,268,380,203
50063,2589,1285,1304,398,670,217,411,625,268
50064,126,68,58,14,49,5,19,28,11
50065,597,269,328,82,120,67,116,139,73
50066,278,144,134,44,76,24,38,57,39
50067,294,132,162,36,79,17,53,80,29
50068,365,201,164,72,88,41,52,68,44
50069,1015,491,524,174,264,53,195,273,56
50070,1503,793,710,220,377,196,206,350,154
50071,1227,605,622,171,310,124,136,266,220
50072,2457,1230,1227,397,668,165,364,631,232
50073,721,371,350,64,234,73,85,172,93
50074,430,238,192,41,116,81,14,80,98
50075,841,416,425,133,209,74,134,194,97
50076,1516,681,835,187,314,180,233,310,292
50078,107,45,62,5,32,8,15,40,7
50101,63,37,26,15,12,10,0,20,6
50102,97,59,38,12,34,13,4,28,6
50103,520,274,246,105,118,51,72,113,61
50104,247,128,119,53,60,15,44,58,17
50105,1076,573,503,222,291,60,177,263,63
50106,1176,563,613,195,280,88,197,282,134
50107,1247,617,630,215,268,134,213,263,154
50108,517,262,255,78,112,72,75,89,91
50109,1821,933,888,307,478,148,255,473,160
50110,75,31,44,5,11,15,9,17,18
50111,5698,2829,2869,1084,1549,196,981,1614,274
50112,11385,5365,6020,1864,2519,982,2044,2481,1495
50115,2756,1359,1397,407,655,297,342,594,461
50116,214,132,82,43,75,14,21,44,17
50117,252,147,105,38,89,20,17,74,14
50118,913,479,434,157,250,72,110,252,72
50119,504,244,260,87,109,48,97,131,32
50120,351,179,172,77,90,12,54,97,21
50122,1518,772,746,267,332,173,187,323,236
50123,962,448,514,133,207,108,164,203,147
50124,2767,1369,1398,470,756,143,429,783,186
50125,17343,8198,9145,2843,4065,1290,3126,4300,1719
50126,6815,3300,3515,1136,1502,662,905,1568,1042
50128,404,189,215,49,100,40,63,105,47
50129,5712,2679,3033,844,1199,636,739,1324,970
50130,1702,870,832,285,421,164,225,401,206
50131,9020,4413,4607,1591,2323,499,1346,2456,805
50132,438,242,196,85,112,45,50,105,41
50133,769,380,389,155,118,107,139,170,80
50134,718,356,362,112,215,29,157,179,26
50135,1723,848,875,241,440,167,291,410,174
50136,609,298,311,100,140,58,96,140,75
50137,60,35,25,12,21,2,0,22,3
50138,11677,5908,5769,1709,3062,1137,1589,2834,1346
50139,1245,647,598,198,345,104,163,312,123
50140,2991,1477,1514,608,612,257,626,545,343
50141,708,339,369,93,193,53,143,165,61
50142,916,446,470,157,216,73,149,244,77
50143,706,329,377,106,179,44,140,187,50
50144,2890,1357,1533,450,619,288,451,636,446
50145,11,0,11,0,0,0,0,5,6
50146,472,258,214,77,137,44,42,133,39
50147,487,251,236,77,117,57,62,107,67
50148,403,204,199,67,87,50,55,103,41
50149,999,510,489,147,268,95,153,237,99
50150,1062,518,544,188,210,120,157,265,122
50151,771,366,405,97,203,66,141,187,77
50152,29,19,10,14,5,0,2,8,0
50153,743,368,375,129,182,57,122,187,66
50154,509,272,237,102,116,54,75,102,60
50155,310,161,149,59,67,35,45,81,23
50156,4162,2020,2142,624,1021,375,607,1018,517
50157,828,417,411,127,219,71,116,223,72
50158,30150,14931,15219,4575,7469,2887,4415,7260,3544
50160,358,169,189,67,74,28,68,87,34
50161,2033,1041,992,365,522,154,295,503,194
50162,1217,619,598,249,309,61,172,316,110
50164,685,325,360,89,165,71,107,169,84
50165,46,16,30,2,11,3,15,9,6
50166,1527,769,758,305,344,120,235,395,128
50167,814,410,404,125,230,55,119,205,80
50168,691,341,350,81,192,68,97,191,62
50169,3003,1322,1681,519,649,154,432,1002,247
50170,2651,1269,1382,390,663,216,406,695,281
50171,2877,1410,1467,416,688,306,370,715,382
50173,704,351,353,80,173,98,104,176,73
50174,1458,738,720,275,322,141,204,343,173
50201,7989,3865,4124,1234,2108,523,1260,2035,829
50206,521,255,266,51,126,78,74,131,61
50207,2665,1294,1371,460,619,215,443,596,332
50208,20748,10613,10135,2939,5712,1962,2693,4781,2661
50210,1377,704,673,167,349,188,137,371,165
50211,9043,4331,4712,1663,2295,373,1607,2588,517
50212,3293,1591,1702,544,777,270,489,789,424
50213,6626,3228,3398,1014,1615,599,922,1601,875
50214,863,478,385,185,257,36,121,213,51
50216,2705,1371,1334,335,667,369,294,588,452
50217,651,349,302,127,154,68,79,138,85
50218,138,77,61,19,42,16,13,38,10
50219,12860,6232,6628,2313,2903,1016,2231,2941,1456
50220,8880,4412,4468,1546,2152,714,1409,1994,1065
50222,503,254,249,82,121,51,87,119,43
50223,399,202,197,54,94,54,49,99,49
50225,2724,1307,1417,456,662,189,455,689,273
50226,3276,1623,1653,521,986,116,521,917,215
50227,17,10,7,1,4,5,2,3,2
50228,2084,1005,1079,298,540,167,296,515,268
50229,906,500,406,203,256,41,141,214,51
50230,1224,624,600,213,311,100,186,250,164
50231,127,66,61,19,35,12,3,35,23
50232,501,243,258,85,128,30,68,145,45
50233,1433,741,692,242,348,151,179,359,154
50234,457,244,213,72,133,39,66,100,47
50235,546,290,256,120,116,54,58,130,68
50236,1704,840,864,318,399,123,312,423,129
50237,2614,1321,1293,501,656,164,422,688,183
50238,1286,624,662,180,313,131,237,276,149
50239,289,135,154,37,67,31,59,61,34
50240,2083,1084,999,327,601,156,294,536,169
50241,3,0,3,0,0,0,0,0,3
50242,457,239,218,62,112,65,56,106,56
50243,255,139,116,42,77,20,36,61,19
50244,1754,845,909,295,422,128,290,436,183
50246,795,401,394,119,182,100,96,181,117
50247,2284,1136,1148,380,541,215,312,515,321
50248,4201,1969,2232,558,1056,355,568,970,694
50249,1366,656,710,198,327,131,211,301,198
50250,2374,1146,1228,344,565,237,337,518,373
50251,1402,691,711,220,312,159,238,293,180
50252,365,173,192,59,91,23,68,92,32
50254,415,229,186,72,107,50,48,95,43
50256,427,217,210,60,118,39,49,92,69
50257,863,435,428,136,233,66,141,224,63
50258,901,446,455,140,200,106,146,179,130
50261,1709,840,869,313,415,112,295,466,108
50262,505,274,231,90,141,43,73,120,38
50263,6414,3233,3181,1139,1785,309,952,1843,386
50264,433,229,204,68,124,37,61,107,36
50265,30291,14412,15879,4189,8484,1739,4129,9208,2542
50266,16620,7948,8672,2537,4658,753,2414,5235,1023
50268,1055,500,555,160,211,129,155,230,170
50269,158,78,80,30,34,14,40,29,11
50271,745,369,376,94,190,85,91,187,98
50272,246,124,122,48,56,20,38,53,31
50273,7355,3471,3884,1123,1774,574,1101,1874,909
50274,479,268,211,74,141,53,79,94,38
50275,669,337,332,122,172,43,143,145,44
50276,2635,1426,1209,460,757,209,320,693,196
50277,523,255,268,77,114,64,84,104,80
50278,923,458,465,147,242,69,146,216,103
50309,4897,2706,2191,512,1794,400,408,1011,772
50310,30989,14873,16116,4189,8557,2127,3988,8689,3439
50311,19001,9275,9726,3335,5126,814,3452,5070,1204
50312,16327,7676,8651,1866,4558,1252,1945,4573,2133
50313,16515,8062,8453,2372,4450,1240,2424,4416,1613
50314,12433,5877,6556,2346,2908,623,2451,3197,908
50315,35851,17325,18526,5534,9556,2235,5433,9679,3414
50316,16602,8230,8372,2943,4304,983,2723,4131,1518
50317,40855,19720,21135,6252,10513,2955,6171,10940,4024
50320,15389,7612,7777,2761,4101,750,2695,4142,940
50321,7499,3537,3962,1105,1919,513,1313,2138,511
50322,32856,15823,17033,4787,8816,2220,4686,9384,2963
50323,942,487,455,203,275,9,169,266,20
50325,13023,6503,6520,2212,3670,621,2035,3880,605
50401,31219,14583,16636,4607,7270,2706,4747,7780,4109
50420,406,206,200,59,113,34,54,86,60
50421,3267,1564,1703,503,718,343,404,779,520
50423,3228,1596,1632,490,744,362,422,728,482
50424,1667,836,831,248,351,237,192,323,316
50426,129,68,61,18,31,19,17,30,14
50428,10038,4910,5128,1455,2469,986,1250,2577,1301
50430,634,320,314,123,135,62,100,136,78
50431,266,137,129,51,65,21,40,58,31
50432,181,86,95,28,45,13,39,34,22
50433,327,172,155,48,97,27,46,88,21
50434,401,205,196,59,99,47,39,102,55
50435,758,407,351,126,223,58,95,190,66
50436,6170,3113,3057,1174,1484,455,1055,1395,607
50438,4040,1942,2098,586,950,406,632,969,497
50439,360,171,189,46,109,16,60,99,30
50440,609,320,289,101,154,65,107,106,76
50441,5631,2713,2918,759,1372,582,757,1281,880
50444,470,229,241,73,114,42,60,109,72
50446,513,270,243,76,153,41,74,119,50
50447,1273,626,647,211,307,108,185,270,192
50448,751,357,394,85,204,68,124,199,71
50449,955,489,466,179,230,80,154,185,127
50450,3066,1434,1632,434,692,308,432,694,506
50451,641,330,311,106,159,65,98,139,74
50452,888,429,459,141,185,103,144,183,132
50453,579,291,288,75,148,68,86,144,58
50454,106,49,57,0,24,25,13,19,25
50455,578,319,259,133,152,34,95,131,33
50456,1790,895,895,305,439,151,216,450,229
50457,418,212,206,56,107,49,48,98,60
50458,2170,1113,1057,351,553,209,277,525,255
50459,3048,1499,1549,405,746,348,336,703,510
50460,410,226,184,94,102,30,63,98,23
50461,5572,2691,2881,833,1226,632,814,1178,889
50464,703,367,336,111,168,88,84,142,110
50465,270,128,142,40,60,28,39,48,55
50466,1868,917,951,365,361,191,283,406,262
50468,1787,889,898,310,426,153,275,442,181
50469,1636,811,825,282,369,160,253,353,219
50470,278,142,136,37,70,35,27,63,46
50471,803,379,424,133,171,75,156,180,88
50472,2267,1073,1194,398,505,170,353,511,330
50473,384,191,193,53,92,46,50,102,41
50475,1582,760,822,236,339,185,209,352,261
50476,834,405,429,112,181,112,101,175,153
50477,376,166,210,51,92,23,97,80,33
50478,945,458,487,136,223,99,133,189,165
50479,688,352,336,97,169,86,80,148,108
50480,1123,535,588,171,224,140,159,225,204
50482,883,456,427,163,215,78,120,210,97
50483,847,446,401,139,197,110,106,184,111
50484,480,236,244,66,124,46,68,107,69
50501,30369,15093,15276,5130,7289,2674,4460,6895,3921
50510,1254,653,601,247,304,102,150,286,165
50511,7615,3630,3985,1122,1766,742,1137,1727,1121
50514,1633,778,855,225,370,183,242,369,244
50515,379,208,171,70,91,47,46,78,47
50516,869,427,442,163,213,51,156,223,63
50517,1229,581,648,179,253,149,191,259,198
50518,469,245,224,87,118,40,75,118,31
50519,608,320,288,81,147,92,58,132,98
50520,201,106,95,26,58,22,32,44,19
50521,93,48,45,11,18,19,9,17,19
50522,890,444,446,106,237,101,101,221,124
50523,697,348,349,100,157,91,117,151,81
50524,560,291,269,115,136,40,88,134,47
50525,3914,1986,1928,608,925,453,490,864,574
50527,312,145,167,44,61,40,65,52,50
50528,521,283,238,88,138,57,73,111,54
50529,908,415,493,164,191,60,163,257,73
50530,1287,616,671,194,280,142,207,272,192
50531,297,150,147,46,70,34,44,72,31
50532,1006,498,508,145,238,115,129,247,132
50533,4309,2075,2234,656,1010,409,645,978,611
50535,967,485,482,150,240,95,163,201,118
50536,4641,2248,2393,795,993,460,639,981,773
50538,595,287,308,76,149,62,82,144,82
50539,651,310,341,95,146,69,109,133,99
50540,1247,605,642,152,294,159,175,263,204
50541,998,491,507,150,238,103,148,251,108
50542,1043,531,512,155,238,138,153,217,142
50543,1509,734,775,261,313,160,217,322,236
50544,602,299,303,98,151,50,72,154,77
50545,347,185,162,85,65,35,58,68,36
50546,628,311,317,120,145,46,128,132,57
50548,5858,2791,3067,850,1274,667,797,1300,970
50551,132,76,56,20,41,15,15,32,9
50552,75,42,33,4,25,13,0,17,16
50554,1925,935,990,266,459,210,246,431,313
50556,332,160,172,30,71,59,36,62,74
50557,734,399,335,112,191,96,81,164,90
50558,706,345,361,113,171,61,119,158,84
50559,376,173,203,47,75,51,59,70,74
50560,704,366,338,115,163,88,95,157,86
50561,651,343,308,123,150,70,79,138,91
50562,603,301,302,121,116,64,98,122,82
50563,2754,1309,1445,425,611,273,389,649,407
50565,578,269,309,47,153,69,97,122,90
50566,465,218,247,77,90,51,77,101,69
50567,248,130,118,39,62,29,28,56,34
50568,1487,727,760,236,338,153,228,324,208
50569,876,431,445,137,241,53,138,237,70
50570,384,187,197,77,91,19,83,91,23
50571,467,260,207,80,119,61,49,90,68
50573,69,43,26,14,25,4,3,18,5
50574,2455,1165,1290,373,525,267,331,523,436
50575,1102,527,575,154,227,146,129,221,225
50576,436,214,222,69,125,20,63,120,39
50577,534,301,233,132,133,36,77,95,61
50578,731,358,373,102,174,82,111,154,108
50579,2980,1642,1338,358,937,347,301,571,466
50581,1139,541,598,164,223,154,148,261,189
50582,320,163,157,49,78,36,53,70,34
50583,3164,1503,1661,410,714,379,370,683,608
50585,1189,616,573,152,313,151,142,243,188
50586,411,202,209,69,88,45,54,98,57
50588,12215,6112,6103,2299,2845,968,2076,2615,1412
50590,1004,502,502,152,241,109,151,219,132
50591,311,157,154,24,82,51,19,65,70
50592,101,56,45,8,41,7,9,26,10
50593,85,38,47,12,15,11,14,26,7
50594,369,195,174,70,94,31,41,79,54
50595,9408,4543,4865,1356,2282,905,1369,2217,1279
50597,1375,670,705,217,303,150,201,295,209
50598,1007,508,499,197,230,81,175,193,131
50599,419,205,214,26,111,68,55,87,72
50601,2828,1371,1457,407,629,335,365,629,463
50602,1703,809,894,251,362,196,227,370,297
50603,597,317,280,82,172,63,88,113,79
50604,1876,895,981,257,415,223,264,394,323
50605,153,76,77,23,41,12,26,26,25
50606,1147,560,587,204,250,106,194,253,140
50607,568,316,252,87,158,71,72,118,62
50609,532,289,243,110,127,52,70,119,54
50611,467,218,249,68,102,48,90,109,50
50612,386,213,173,54,109,50,33,107,33
50613,38981,18388,20593,6571,9435,2382,8148,8964,3481
50616,10580,4942,5638,1440,2387,1115,1543,2456,1639
50619,2498,1257,1241,411,604,242,348,587,306
50621,1567,752,815,239,357,156,235,362,218
50622,2944,1417,1527,442,741,234,436,802,289
50623,126,64,62,23,29,12,18,32,12
50624,1389,704,685,229,333,142,206,338,141
50625,1179,578,601,177,288,113,196,254,151
50626,1753,901,852,355,437,109,314,439,99
50627,3969,1970,1999,698,901,371,519,877,603
50628,1365,698,667,181,302,215,174,279,214
50629,2254,1185,1069,426,625,134,330,553,186
50630,1927,955,972,299,460,196,296,452,224
50631,152,72,80,13,42,17,20,36,24
50632,1278,641,637,220,335,86,197,303,137
50633,402,181,221,49,111,21,50,106,65
50634,755,359,396,103,193,63,136,173,87
50635,1698,795,903,239,378,178,243,379,281
50636,1981,922,1059,233,435,254,255,434,370
50638,3253,1520,1733,457,672,391,430,689,614
50641,2231,1155,1076,551,487,117,449,484,143
50642,537,261,276,63,158,40,88,129,59
50643,2689,1297,1392,439,622,236,421,693,278
50644,8744,4275,4469,1437,2065,773,1217,2154,1098
50645,1246,637,609,198,348,91,181,321,107
50647,1763,858,905,228,461,169,279,425,201
50648,3777,1876,1901,661,891,324,619,901,381
50649,25,9,16,2,5,2,2,6,8
50650,784,393,391,133,185,75,124,179,88
50651,3687,1814,1873,632,832,350,503,899,471
50652,167,77,90,32,33,12,37,36,17
50653,673,353,320,110,169,74,83,147,90
50654,602,293,309,99,141,53,111,132,66
50655,807,390,417,127,187,76,127,180,110
50658,2481,1244,1237,380,558,306,376,543,318
50659,5741,2863,2878,923,1339,601,734,1303,841
50660,1264,645,619,201,354,90,190,311,118
50662,7616,3615,4001,1073,1769,773,1032,1785,1184
50665,2947,1441,1506,431,710,300,430,690,386
50666,929,480,449,152,249,79,114,234,101
50667,212,106,106,23,55,28,35,48,23
50668,1231,591,640,201,278,112,168,305,167
50669,2624,1262,1362,372,599,291,358,585,419
50670,1934,990,944,267,529,194,239,491,214
50671,285,121,164,33,49,39,78,55,31
50672,595,298,297,93,135,70,95,136,66
50673,216,111,105,55,39,17,40,42,23
50674,3726,1781,1945,558,870,353,543,853,549
50675,2443,1203,1240,332,567,304,286,549,405
50676,2116,995,1121,333,475,187,397,481,243
50677,11407,5489,5918,2035,2494,960,1966,2628,1324
50680,1154,575,579,186,261,128,137,252,190
50681,442,225,217,75,110,40,74,101,42
50682,1466,733,733,241,371,121,197,357,179
50701,29673,14377,15296,4313,7797,2267,4283,7946,3067
50702,19342,9268,10074,2831,4588,1849,2590,4587,2897
50703,20948,9996,10952,3612,4907,1477,3430,5434,2088
50706,1026,513,513,152,293,68,160,274,79
50707,8245,4114,4131,1408,2129,577,1234,2120,777
50801,9218,4351,4867,1416,2057,878,1398,2202,1267
50830,1832,878,954,256,433,189,273,456,225
50833,2658,1280,1378,414,592,274,371,599,408
50835,133,82,51,31,29,22,4,36,11
50836,510,256,254,50,117,89,61,117,76
50837,445,249,196,88,119,42,44,99,53
50840,683,311,372,107,139,65,87,162,123
50841,3015,1419,1596,382,643,394,377,668,551
50843,660,352,308,97,174,81,81,127,100
50845,799,411,388,143,184,84,94,208,86
50846,1235,598,637,166,266,166,138,261,238
50847,107,51,56,9,37,5,12,29,15
50848,475,255,220,79,124,52,45,108,67
50849,2928,1370,1558,388,603,379,404,625,529
50851,2238,1104,1134,344,513,247,318,512,304
50853,823,392,431,115,198,79,129,201,101
50854,2273,1077,1196,309,455,313,266,460,470
50857,423,231,192,60,131,40,53,95,44
50858,956,487,469,163,231,93,163,220,86
50859,530,248,282,86,119,43,102,130,50
50860,353,158,195,62,76,20,70,81,44
50861,304,166,138,55,67,44,34,65,39
50862,171,77,94,23,23,31,28,33,33
50863,334,135,199,26,62,47,43,92,64
50864,2314,1102,1212,362,471,269,346,513,353
51001,2213,1089,1124,354,493,242,291,500,333
51002,2911,1447,1464,479,746,222,462,664,338
51003,1638,793,845,294,395,104,327,362,156
51004,1153,562,591,161,273,128,153,258,180
51005,1692,866,826,302,357,207,221,334,271
51006,1158,560,598,153,264,143,160,238,200
51007,600,342,258,111,165,66,56,143,59
51008,95,49,46,5,28,16,12,21,13
51010,495,272,223,67,145,60,59,106,58
51011,94,52,42,15,24,13,12,18,12
51012,6622,3240,3382,939,1660,641,867,1539,976
51014,825,435,390,151,199,85,105,201,84
51016,1453,727,726,238,347,142,197,331,198
51018,533,256,277,77,127,52,79,133,65
51019,903,419,484,124,201,94,153,212,119
51020,683,336,347,83,147,106,86,157,104
51022,813,386,427,120,193,73,178,163,86
51023,3006,1465,1541,481,699,285,459,676,406
51024,2003,1012,991,341,506,165,330,486,175
51025,2131,997,1134,295,468,234,333,452,349
51026,1000,506,494,173,266,67,150,237,107
51027,1395,715,680,261,321,133,245,311,124
51028,2078,1019,1059,338,443,238,288,462,309
51029,264,152,112,52,61,39,15,59,38
51030,1641,775,866,240,469,66,315,440,111
51031,11951,5819,6132,2014,2893,912,1980,2808,1344
51033,515,271,244,65,124,82,57,119,68
51034,2198,1052,1146,313,469,270,270,463,413
51035,1816,881,935,295,398,188,264,375,296
51036,574,329,245,90,184,55,63,127,55
51037,438,216,222,49,85,82,54,99,69
51038,1534,791,743,270,347,174,219,353,171
51039,2469,1239,1230,438,590,211,387,586,257
51040,3601,1614,1987,385,818,411,560,762,665
51041,6515,3041,3474,1235,1353,453,1420,1380,674
51044,266,139,127,47,73,19,40,65,22
51045,69,44,25,17,22,5,11,14,0
51046,2173,1096,1077,347,492,257,275,429,373
51047,845,420,425,139,204,77,142,183,100
51048,585,283,302,68,146,69,104,128,70
51049,644,316,328,85,161,70,103,150,75
51050,2926,1469,1457,525,652,292,485,604,368
51051,78,33,45,7,19,7,11,15,19
51052,1134,586,548,190,314,82,159,290,99
51053,1268,650,618,224,325,101,192,301,125
51054,4063,2068,1995,846,1007,215,692,1057,246
51055,1325,620,705,221,288,111,218,340,147
51056,546,277,269,86,140,51,77,124,68
51058,1005,480,525,127,223,130,139,184,202
51059,292,155,137,48,69,38,23,78,36
51060,652,313,339,76,133,104,80,129,130
51061,558,272,286,80,141,51,97,129,60
51062,678,373,305,114,189,70,91,166,48
51063,1058,540,518,198,243,99,128,256,134
51101,547,224,323,47,115,62,56,134,133
51103,17721,8906,8815,3591,4251,1064,2883,4369,1563
51104,22232,10506,11726,3494,5443,1569,3648,5645,2433
51105,12218,6304,5914,2297,3307,700,2089,2974,851
51106,26855,12868,13987,4324,6605,1939,4588,6640,2759
51108,5335,2684,2651,860,1407,417,742,1479,430
51109,2974,1448,1526,437,822,189,465,721,340
51111,120,50,70,9,35,6,21,49,0
51201,6258,3080,3178,992,1515,573,933,1450,795
51230,490,248,242,107,110,31,93,114,35
51231,246,110,136,29,47,34,46,59,31
51232,932,479,453,147,239,93,120,211,122
51234,1206,635,571,224,287,124,171,270,130
51235,1089,596,493,253,274,69,188,234,71
51237,1846,902,944,278,391,233,248,363,333
51238,1241,627,614,235,279,113,238,264,112
51239,2978,1480,1498,570,676,234,516,644,338
51240,1781,893,888,336,390,167,306,395,187
51241,1713,870,843,303,417,150,271,410,162
51242,198,91,107,24,56,11,34,48,25
51243,894,435,459,134,213,88,148,193,118
51244,39,18,21,6,11,1,8,13,0
51245,1244,600,644,167,281,152,139,269,236
51246,3755,1805,1950,564,828,413,547,808,595
51247,4304,2077,2227,648,1043,386,710,960,557
51248,1935,931,1004,333,400,198,266,400,338
51249,3741,1714,2027,518,827,369,616,802,609
51250,7443,3640,3803,1665,1464,511,1743,1383,677
51301,12857,6098,6759,1811,3110,1177,1810,3168,1781
51331,1021,503,518,95,272,136,100,239,179
51333,581,265,316,72,159,34,110,164,42
51334,8061,3913,4148,1298,1840,775,1228,1803,1117
51338,1143,610,533,211,335,64,164,257,112
51341,36,16,20,6,10,0,7,13,0
51342,1241,592,649,179,292,121,178,291,180
51343,297,156,141,54,89,13,28,99,14
51344,112,63,49,26,27,10,12,25,12
51345,468,231,237,52,117,62,87,103,47
51346,2896,1441,1455,526,637,278,431,628,396
51347,1424,706,718,197,353,156,176,331,211
51349,40,12,28,0,12,0,0,17,11
51350,460,233,227,77,102,54,60,91,76
51351,4157,1989,2168,573,958,458,587,989,592
51354,1152,574,578,225,261,88,209,236,133
51355,853,395,458,69,211,115,81,186,191
51357,746,353,393,122,165,66,119,181,93
51358,1365,646,719,168,306,172,195,320,204
51360,7952,3838,4114,1065,1884,889,997,1964,1153
51363,153,80,73,13,43,24,18,42,13
51364,737,387,350,102,212,73,85,180,85
51365,436,206,230,65,110,31,80,110,40
51366,490,268,222,106,117,45,70,103,49
51401,12206,5834,6372,1952,2792,1090,1897,2779,1696
51430,921,490,431,173,212,105,131,207,93
51431,475,243,232,84,98,61,76,90,66
51433,747,401,346,120,207,74,96,164,86
51436,909,476,433,167,232,77,129,199,105
51439,1085,554,531,160,244,150,150,224,157
51440,445,234,211,94,113,27,73,95,43
51441,420,212,208,53,118,41,57,109,42
51442,8893,4441,4452,1589,2108,744,1341,2011,1100
51443,1922,939,983,304,494,141,280,507,196
51444,290,147,143,64,74,9,53,75,15
51445,3223,1575,1648,550,737,288,460,724,464
51446,595,304,291,91,137,76,77,136,78
51447,258,147,111,43,77,27,30,62,19
51448,661,341,320,85,181,75,93,135,92
51449,2236,1068,1168,321,461,286,302,472,394
51450,1796,834,962,235,354,245,232,394,336
51451,107,63,44,7,35,21,10,15,19
51452,207,119,88,60,51,8,29,43,16
51453,859,410,449,122,217,71,139,215,95
51454,1575,810,765,298,362,150,221,357,187
51455,2363,1110,1253,327,518,265,359,525,369
51458,1756,863,893,275,389,199,242,357,294
51459,22,12,10,3,9,0,7,3,0
51461,1194,609,585,198,266,145,144,275,166
51462,1215,654,561,194,324,136,154,268,139
51463,642,334,308,122,132,80,94,138,76
51465,840,437,403,157,196,84,133,175,95
51466,1105,543,562,187,238,118,161,218,183
51467,580,290,290,77,135,78,94,123,73
51501,34242,16833,17409,5730,9030,2073,5518,8889,3002
51502,105,48,57,40,8,0,36,21,0
51503,33837,16238,17599,5079,8307,2852,5096,8490,4013
51510,3248,1616,1632,506,860,250,427,886,319
51520,325,164,161,46,95,23,66,79,16
51521,2175,1060,1115,328,502,230,269,535,311
51523,358,181,177,50,85,46,36,79,62
51525,1099,546,553,168,267,111,169,264,120
51526,1719,884,835,254,497,133,215,461,159
51527,790,392,398,142,166,84,166,162,70
51528,1027,523,504,133,278,112,124,249,131
51529,1834,921,913,310,421,190,213,406,294
51530,924,489,435,137,220,132,85,188,162
51531,933,435,498,127,166,142,106,178,214
51532,797,402,395,113,207,82,122,182,91
51533,1041,540,501,191,250,99,116,254,131
51534,8576,4348,4228,1527,2261,560,1277,2253,698
51535,2073,996,1077,276,463,257,249,496,332
51536,524,270,254,78,132,60,60,128,66
51537,6938,3308,3630,1025,1566,717,1043,1603,984
51540,542,250,292,70,136,44,99,151,42
51541,340,167,173,36,90,41,41,80,52
51542,850,454,396,98,275,81,84,249,63
51543,432,205,227,71,90,44,77,99,51
51544,735,377,358,120,196,61,116,174,68
51545,497,245,252,72,125,48,74,105,73
51546,2970,1453,1517,522,690,241,464,727,326
51548,515,286,229,90,157,39,80,133,16
51549,589,310,279,129,136,45,111,123,45
51550,48,26,22,7,10,9,9,9,4
51551,1826,898,928,281,445,172,259,439,230
51552,322,163,159,58,78,27,47,85,27
51553,911,452,459,133,248,71,129,254,76
51554,215,119,96,51,46,22,31,49,16
51555,5458,2704,2754,868,1337,499,715,1366,673
51556,438,234,204,62,118,54,35,106,63
51557,926,458,468,135,231,92,142,236,90
51558,673,331,342,101,154,76,100,154,88
51559,1701,784,917,273,387,124,316,449,152
51560,2043,999,1044,313,481,205,284,473,287
51561,1439,698,741,180,392,126,231,379,131
51562,505,243,262,66,124,53,113,115,34
51563,908,440,468,166,219,55,183,209,76
51564,561,269,292,71,126,72,78,128,86
51565,558,271,287,71,125,75,97,107,83
51566,7615,3556,4059,1037,1870,649,1149,1802,1108
51570,1154,595,559,200,282,113,179,256,124
51571,596,310,286,89,160,61,70,151,65
51572,469,234,235,58,108,68,54,101,80
51573,1205,568,637,161,290,117,173,289,175
51574,13,5,8,0,3,2,0,4,4
51575,631,327,304,124,174,29,81,152,71
51576,1629,817,812,313,407,97,283,414,115
51577,1338,675,663,236,311,128,198,311,154
51578,127,58,69,25,27,6,20,32,17
51579,2443,1198,1245,401,560,237,340,554,351
51601,6193,2837,3356,775,1360,702,783,1421,1152
51630,211,98,113,28,44,26,25,52,36
51631,583,287,296,89,146,52,91,152,53
51632,7285,3960,3325,1158,2205,597,880,1582,863
51636,501,245,256,61,122,62,73,117,66
51637,319,163,156,46,80,37,45,74,37
51638,1579,806,773,225,406,175,241,356,176
51639,801,395,406,127,184,84,105,166,135
51640,1850,911,939,262,459,190,236,450,253
51645,293,169,124,50,80,39,25,68,31
51646,801,394,407,121,183,90,112,189,106
51647,387,203,184,78,84,41,70,79,35
51648,264,139,125,31,67,41,25,73,27
51649,346,170,176,68,78,24,59,74,43
51650,392,209,183,78,88,43,40,91,52
51652,2024,1006,1018,326,486,194,276,457,285
51653,1386,653,733,185,324,144,170,323,240
51654,532,263,269,88,137,38,89,134,46
52001,43965,20802,23163,6777,10401,3624,7090,10428,5645
52002,11467,5656,5811,1967,2886,803,1890,2982,939
52003,13167,6364,6803,2045,3282,1037,1961,3365,1477
52030,467,245,222,118,100,27,88,111,23
52031,4510,2279,2231,732,1083,464,628,1070,533
52032,1280,699,581,206,391,102,152,324,105
52033,2940,1493,1447,476,768,249,430,680,337
52035,1023,494,529,125,272,97,153,244,132
52036,183,99,84,31,44,24,13,52,19
52037,1181,605,576,186,305,114,179,281,116
52038,566,279,287,90,132,57,112,116,59
52039,1067,581,486,192,273,116,123,297,66
52040,5362,2647,2715,934,1305,408,793,1331,591
52041,1791,895,896,375,399,121,341,383,172
52042,1718,845,873,293,417,135,272,367,234
52043,2409,1134,1275,292,538,304,321,528,426
52044,208,117,91,37,63,17,47,34,10
52045,2306,1213,1093,447,603,163,421,527,145
52046,2100,1070,1030,402,523,145,368,498,164
52047,804,403,401,144,189,70,116,191,94
52048,460,225,235,78,123,24,77,116,42
52049,1322,661,661,154,340,167,160,295,206
52050,551,272,279,79,129,64,81,141,57
52052,3238,1577,1661,440,734,403,414,757,490
52053,1171,615,556,229,316,70,209,258,89
52054,1008,517,491,141,277,99,151,244,96
52056,270,124,146,34,58,32,55,60,31
52057,8024,3904,4120,1302,1902,700,1258,1842,1020
52060,8746,4158,4588,1351,2002,805,1232,2112,1244
52064,953,481,472,144,243,94,148,243,81
52065,1039,561,478,208,271,82,144,231,103
52066,43,21,22,2,7,12,0,11,11
52068,2924,1424,1500,493,754,177,576,761,163
52069,1529,734,795,207,383,144,236,371,188
52070,1171,578,593,151,302,125,148,279,166
52071,135,71,64,23,34,14,23,29,12
52072,365,188,177,63,119,6,80,89,8
52073,1544,798,746,296,361,141,236,365,145
52074,327,171,156,74,76,21,58,80,18
52075,190,97,93,31,47,19,30,48,15
52076,2380,1129,1251,367,524,238,387,540,324
52077,455,241,214,95,103,43,55,107,52
52078,965,464,501,185,223,56,210,234,57
52079,766,422,344,155,227,40,92,204,48
52101,13752,6602,7150,2422,3019,1161,2613,2974,1563
52132,1844,943,901,350,475,118,329,402,170
52133,658,343,315,100,159,84,102,151,62
52134,420,198,222,73,96,29,76,90,56
52135,980,495,485,164,226,105,150,204,131
52136,6202,2991,3211,882,1508,601,960,1380,871
52140,556,303,253,86,128,89,70,127,56
52141,1468,736,732,237,353,146,219,307,206
52142,1966,1026,940,424,469,133,327,384,229
52144,1489,754,735,219,348,187,253,330,152
52146,924,475,449,91,265,119,124,204,121
52147,1335,706,629,258,337,111,199,291,139
52151,2293,1142,1151,333,545,264,322,524,305
52154,1109,571,538,162,293,116,173,266,99
52155,1399,734,665,257,306,171,200,305,160
52156,691,349,342,96,178,75,90,146,106
52157,1896,938,958,270,502,166,266,459,233
52158,253,131,122,32,61,38,23,67,32
52159,2385,1202,1183,385,561,256,326,563,294
52160,903,449,454,143,201,105,169,182,103
52161,1385,711,674,238,343,130,172,303,199
52162,3449,1778,1671,555,953,270,464,809,398
52163,297,157,140,45,72,40,27,47,66
52164,259,138,121,47,56,35,43,58,20
52165,909,484,425,176,227,81,134,207,84
52166,32,10,22,2,6,2,10,7,5
52168,365,200,165,66,82,52,31,79,55
52169,427,205,222,63,97,45,71,106,45
52170,570,292,278,100,146,46,82,141,55
52171,1259,635,624,211,285,139,180,293,151
52172,6290,3046,3244,969,1460,617,946,1404,894
52175,3619,1810,1809,545,898,367,484,791,534
52201,1164,600,564,194,317,89,156,320,88
52202,1033,527,506,183,288,56,172,263,71
52203,1766,853,913,260,407,186,210,412,291
52205,8039,4570,3469,1068,2897,605,960,1672,837
52206,1593,816,777,314,404,98,272,391,114
52207,459,225,234,76,105,44,71,98,65
52208,3588,1782,1806,604,848,330,498,779,529
52209,1092,559,533,166,280,113,141,244,148
52210,716,355,361,96,211,48,122,175,64
52211,2577,1279,1298,382,644,253,343,630,325
52212,304,170,134,36,91,43,29,71,34
52213,3877,2000,1877,719,1035,246,593,983,301
52214,3367,1713,1654,492,932,289,505,845,304
52215,892,468,424,129,274,65,144,200,80
52216,1500,744,756,239,339,166,159,344,253
52217,555,279,276,83,115,81,67,113,96
52218,1696,837,859,248,424,165,287,383,189
52219,103,48,55,16,18,14,10,33,12
52220,110,44,66,6,30,8,39,27,0
52221,202,115,87,32,57,26,20,36,31
52222,736,350,386,93,183,74,121,178,87
52223,1371,716,655,186,363,167,199,289,167
52224,1999,993,1006,324,445,224,270,470,266
52225,470,233,237,89,105,39,81,118,38
52226,116,60,56,18,35,7,26,22,8
52227,1765,915,850,333,497,85,255,469,126
52228,1592,846,746,316,384,146,254,363,129
52229,764,349,415,107,178,64,158,181,76
52231,398,186,212,62,95,29,70,102,40
52232,229,120,109,41,60,19,29,55,25
52233,6079,3047,3032,904,1806,337,804,1809,419
52235,15,9,6,7,2,0,3,3,0
52236,409,190,219,49,83,58,43,121,55
52237,1733,871,862,336,431,104,304,414,144
52240,30472,15091,15381,5366,8417,1308,5708,7892,1781
52241,15252,7660,7592,2200,5020,440,2125,4743,724
52242,2477,1113,1364,1055,58,0,1343,21,0
52245,18689,9118,9571,3393,4715,1010,3341,4859,1371
52246,19841,9711,10130,2812,6204,695,2982,6087,1061
52247,5684,2634,3050,1083,1172,379,1118,1336,596
52248,1872,896,976,234,480,182,288,445,243
52249,1057,502,555,160,212,130,180,211,164
52251,576,300,276,107,140,53,77,133,66
52253,2978,1542,1436,603,766,173,493,737,206
52254,976,467,509,147,247,73,154,227,128
52255,1226,604,622,182,292,130,178,315,129
52257,197,119,78,53,57,9,26,36,16
52301,4201,2015,2186,601,1053,361,640,1049,497
52302,28455,13977,14478,4427,7577,1973,4287,7713,2478
52305,542,278,264,87,143,48,65,146,53
52306,1836,919,917,289,470,160,257,440,220
52307,187,92,95,36,35,21,33,32,30
52308,85,45,40,19,20,6,14,19,7
52309,462,255,207,87,122,46,52,111,44
52310,6358,2997,3361,942,1476,579,1041,1507,813
52312,82,45,37,13,24,8,10,20,7
52313,464,247,217,70,144,33,70,105,42
52314,5181,2422,2759,976,1146,300,1168,1205,386
52315,1248,648,600,215,301,132,172,250,178
52316,1768,853,915,290,378,185,249,382,284
52317,6402,3328,3074,1076,2060,192,922,1957,195
52318,1175,583,592,193,286,104,205,266,121
52320,1258,654,604,198,339,117,154,296,154
52321,524,234,290,75,100,59,103,109,78
52322,2318,1220,1098,438,588,194,243,606,249
52323,977,484,493,176,224,84,147,226,120
52324,1500,759,741,239,439,81,246,410,85
52325,741,388,353,139,200,49,122,191,40
52326,566,280,286,90,149,41,82,151,53
52327,2875,1428,1447,442,774,212,434,786,227
52328,1315,738,577,309,363,66,222,300,55
52329,824,425,399,135,197,93,120,200,79
52330,945,483,462,168,238,77,167,196,99
52332,2067,1059,1008,372,559,128,325,519,164
52333,6055,3216,2839,1397,1437,382,1026,1432,381
52334,275,131,144,12,98,21,51,77,16
52335,648,315,333,93,158,64,99,151,83
52336,2315,1175,1140,394,626,155,340,589,211
52337,857,423,434,126,215,82,126,223,85
52338,2856,1492,1364,525,807,160,412,802,150
52339,4189,2064,2125,791,883,390,615,1003,507
52340,1170,558,612,143,380,35,152,396,64
52341,973,468,505,130,264,74,123,274,108
52342,3557,1719,1838,610,825,284,546,819,473
52345,1046,553,493,218,287,48,168,266,59
52346,1072,525,547,155,281,89,174,273,100
52347,1510,756,754,246,373,137,222,342,190
52348,75,37,38,16,17,4,12,20,6
52349,7321,3656,3665,1176,1747,733,955,1731,979
52351,1154,587,567,254,306,27,219,318,30
52352,1882,894,988,320,446,128,362,457,169
52353,9188,4294,4894,1300,2079,915,1396,2115,1383
52354,346,160,186,42,82,36,63,101,22
52355,345,184,161,55,94,35,44,79,38
52356,2387,1165,1222,367,543,255,308,549,365
52358,3380,1656,1724,465,930,261,485,924,315
52359,243,121,122,34,67,20,25,70,27
52361,3963,1907,2056,627,970,310,652,952,452
52362,1112,520,592,130,274,116,183,266,143
52401,2308,1157,1151,242,721,194,296,554,301
52402,39995,19488,20507,6370,10540,2578,6287,10683,3537
52403,24824,11955,12869,3792,6200,1963,3498,6470,2901
52404,32066,15774,16292,5147,8350,2277,4995,8291,3006
52405,25034,12195,12839,3933,6467,1795,3524,6635,2680
52411,5536,2779,2757,981,1543,255,981,1537,239
52501,30636,14843,15793,4623,7429,2791,4359,7473,3961
52530,965,467,498,134,206,127,105,220,173
52531,6009,2904,3105,981,1340,583,904,1303,898
52533,1262,656,606,215,345,96,180,293,133
52534,235,126,109,42,67,17,22,73,14
52535,1156,583,573,144,315,124,121,306,146
52536,919,467,452,121,252,94,122,229,101
52537,6671,3293,3378,1080,1571,642,998,1533,847
52540,1492,772,720,220,409,143,187,370,163
52542,403,224,179,77,93,54,38,78,63
52543,294,157,137,56,66,35,37,79,21
52544,8360,3857,4503,1229,1781,847,1182,1989,1332
52548,46,25,21,6,17,2,6,13,2
52549,715,372,343,112,183,77,126,147,70
52550,678,308,370,82,169,57,132,156,82
52551,144,72,72,0,36,36,17,35,20
52552,1013,519,494,191,234,94,195,208,91
52553,1818,915,903,280,510,125,260,441,202
52554,1338,619,719,167,330,122,216,340,163
52555,408,211,197,83,88,40,56,108,33
52556,12410,6093,6317,1841,3417,835,1759,3232,1326
52560,584,289,295,61,139,89,72,117,106
52561,982,492,490,165,244,83,157,219,114
52562,71,33,38,8,18,7,14,15,9
52563,1649,806,843,266,388,152,260,399,184
52565,2077,1037,1040,305,490,242,268,465,307
52566,134,74,60,21,45,8,20,31,9
52567,613,289,324,102,159,28,120,160,44
52568,79,41,38,5,23,13,10,19,9
52569,499,252,247,45,123,84,55,91,101
52570,998,528,470,210,199,119,155,195,120
52571,1396,666,730,169,331,166,186,331,213
52572,1158,591,567,164,289,138,179,252,136
52573,272,145,127,41,67,37,47,57,23
52574,1049,530,519,150,289,91,191,238,90
52576,582,296,286,89,160,47,70,137,79
52577,14845,7243,7602,2369,3648,1226,2271,3595,1736
52580,438,198,240,47,112,39,81,93,66
52581,299,166,133,37,81,48,11,79,43
52583,454,228,226,50,82,96,58,91,77
52584,532,264,268,98,105,61,86,105,77
52585,1042,523,519,173,225,125,166,218,135
52586,598,318,280,85,162,71,70,135,75
52588,416,198,218,57,102,39,59,89,70
52590,1092,535,557,146,264,125,140,245,172
52591,3244,1564,1680,545,665,354,402,684,594
52593,166,86,80,32,37,17,22,37,21
52594,346,171,175,51,82,38,52,93,30
52595,333,164,169,52,85,27,49,84,36
52601,30890,14946,15944,4749,7533,2664,4498,7509,3937
52619,855,427,428,151,216,60,146,223,59
52620,778,381,397,125,190,66,118,195,84
52621,671,351,320,99,186,66,83,169,68
52623,1844,896,948,245,480,171,266,473,209
52624,248,127,121,53,44,30,25,49,47
52625,2551,1259,1292,336,630,293,379,589,324
52626,1376,651,725,218,311,122,218,323,184
52627,14007,7114,6893,1910,4022,1182,1811,3364,1718
52630,899,465,434,113,263,89,164,202,68
52631,79,31,48,2,22,7,16,23,9
52632,13726,6498,7228,2094,3292,1112,2046,3449,1733
52635,814,405,409,131,218,56,161,185,63
52637,2539,1185,1354,372,583,230,398,596,360
52638,772,378,394,118,199,61,133,198,63
52639,2382,1215,1167,353,655,207,355,571,241
52640,1482,709,773,212,356,141,192,375,206
52641,12286,6356,5930,1875,3658,823,1703,2967,1260
52644,540,256,284,89,129,38,127,119,38
52645,3063,1488,1575,420,802,266,455,760,360
52646,858,435,423,153,222,60,156,206,61
52647,239,105,134,50,45,10,48,68,18
52649,951,491,460,141,267,83,133,229,98
52650,840,436,404,150,247,39,142,230,32
52651,356,154,202,31,98,25,69,88,45
52652,90,27,63,0,18,9,12,23,28
52653,3842,1863,1979,623,938,302,599,924,456
52654,1694,789,905,272,356,161,287,380,238
52655,4646,2269,2377,686,1191,392,598,1184,595
52656,2601,1254,1347,358,643,253,400,632,315
52658,1175,589,586,154,341,94,204,296,86
52659,1548,765,783,279,319,167,230,357,196
52660,231,120,111,24,70,26,22,52,37
52701,96,46,50,5,19,22,12,25,13
52720,1168,609,559,190,341,78,155,303,101
52721,834,424,410,133,221,70,122,204,84
52722,33727,16367,17360,5230,8996,2141,5024,9219,3117
52726,4467,2201,2266,676,1260,265,756,1220,290
52727,473,256,217,112,114,30,70,114,33
52728,849,434,415,143,220,71,110,224,81
52729,888,457,431,139,245,73,145,202,84
52730,4723,2303,2420,659,1202,442,637,1265,518
52731,1067,493,574,158,234,101,176,253,145
52732,29417,14219,15198,4593,7010,2616,4455,7127,3616
52737,255,126,129,62,49,15,49,66,14
52738,3837,1881,1956,609,975,297,652,919,385
52739,799,417,382,154,194,69,139,162,81
52742,7250,3513,3737,1167,1733,613,1102,1762,873
52745,680,327,353,93,191,43,129,168,56
52746,1029,556,473,223,303,30,115,303,55
52747,1850,887,963,290,411,186,286,461,216
52748,6960,3427,3533,1232,1881,314,1221,1926,386
52749,803,421,382,147,249,25,124,202,56
52750,571,303,268,110,155,38,91,143,34
52751,1111,557,554,196,307,54,172,280,102
52752,506,250,256,89,124,37,85,138,33
52753,4181,2083,2098,629,1126,328,558,1165,375
52754,1437,728,709,265,350,113,220,378,111
52755,1859,944,915,311,503,130,285,462,168
52756,2158,1143,1015,386,578,179,287,607,121
52757,247,126,121,17,80,29,36,56,29
52758,103,56,47,12,34,10,5,33,9
52760,565,277,288,70,151,56,120,114,54
52761,30239,14733,15506,4938,7644,2151,4654,7857,2995
52765,497,259,238,97,115,47,83,110,45
52766,886,453,433,150,252,51,119,249,65
52767,242,113,129,18,43,52,33,27,69
52768,1507,827,680,283,436,108,203,377,100
52769,665,351,314,92,196,63,94,173,47
52772,4947,2441,2506,760,1198,483,703,1186,617
52773,2274,1147,1127,344,591,212,346,590,191
52774,131,70,61,33,30,7,22,36,3
52776,4334,2161,2173,747,1145,269,736,1013,424
52777,1409,683,726,224,316,143,221,337,168
52778,3925,1938,1987,598,1035,305,615,1003,369
52801,973,601,372,49,446,106,21,168,183
52802,11667,5766,5901,2130,2870,766,1892,2925,1084
52803,24214,11793,12421,3933,6406,1454,4062,6285,2074
52804,26836,13018,13818,4366,6491,2161,3848,7030,2940
52806,26140,12610,13530,4325,6695,1590,4346,6865,2319
52807,10405,5055,5350,1424,2971,660,1468,3020,862
53001,1962,1019,943,333,550,136,302,503,138
53002,2279,1216,1063,384,716,116,326,590,147
53003,216,107,109,31,64,12,28,73,8
53004,2774,1439,1335,483,764,192,428,691,216
53005,20237,9906,10331,2997,4679,2230,2748,4898,2685
53006,1708,862,846,263,462,137,268,417,161
53007,1881,878,1003,217,481,180,202,467,334
53010,7412,3675,3737,1133,1959,583,1053,1873,811
53011,1924,995,929,295,548,152,272,496,161
53012,18008,8856,9152,2850,4540,1466,2646,4763,1743
53013,3098,1568,1530,596,730,242,510,719,301
53014,7798,3976,3822,1290,2062,624,1180,1838,804
53015,2613,1342,1271,400,751,191,379,645,247
53016,134,69,65,36,30,3,30,25,10
53017,4806,2476,2330,792,1367,317,731,1333,266
53018,7882,4141,3741,1665,2070,406,1158,2071,512
53019,1814,973,841,359,499,115,279,445,117
53020,3726,1914,1812,565,1066,283,483,1018,311
53021,4083,2077,2006,733,1165,179,642,1136,228
53022,17576,8646,8930,2753,4887,1006,2687,4907,1336
53023,1483,820,663,220,490,110,210,359,94
53024,14321,7155,7166,2272,3961,922,1962,3975,1229
53027,19071,9644,9427,3162,5108,1374,2881,4902,1644
53029,17867,8925,8942,3251,4724,950,3023,4835,1084
53032,4974,2485,2489,802,1344,339,783,1216,490
53033,5357,2818,2539,939,1565,314,661,1562,316
53034,1809,915,894,269,489,157,257,440,197
53035,2138,1082,1056,389,570,123,362,533,161
53036,1934,977,957,304,509,164,285,483,189
53037,6991,3437,3554,1087,1968,382,1072,1982,500
53038,2895,1481,1414,474,788,219,414,753,247
53039,4688,2400,2288,628,1275,497,598,1121,569
53040,6898,3473,3425,1102,1865,506,1064,1794,567
53042,6473,3187,3286,988,1633,566,991,1632,663
53044,1924,964,960,348,485,131,300,478,182
53045,21583,10152,11431,3242,5082,1828,3246,5544,2641
53046,1200,634,566,173,356,105,154,274,138
53047,65,31,34,5,16,10,5,14,15
53048,3389,1742,1647,652,880,210,523,816,308
53049,2549,1264,1285,366,689,209,415,624,246
53050,6661,3340,3321,1024,1712,604,960,1610,751
53051,32415,15642,16773,4609,8240,2793,4493,8493,3787
53057,2046,1098,948,476,456,166,243,416,289
53058,3568,1730,1838,546,913,271,508,986,344
53059,1821,930,891,281,528,121,299,461,131
53061,5181,2577,2604,774,1381,422,681,1307,616
53063,1655,873,782,308,430,135,280,374,128
53065,2190,1115,1075,387,584,144,360,546,169
53066,28139,13845,14294,4268,7580,1997,4178,7362,2754
53069,650,372,278,83,220,69,48,198,32
53070,4741,2384,2357,810,1176,398,785,1143,429
53072,20684,10239,10445,2856,5953,1430,2634,6050,1761
53073,14878,7925,6953,2372,4491,1062,2168,3409,1376
53074,12190,6034,6156,1818,3313,903,1807,3114,1235
53075,4182,2062,2120,841,943,278,936,903,281
53076,3010,1581,1429,540,871,170,456,831,142
53078,1905,1011,894,333,529,149,308,450,136
53079,1477,733,744,221,390,122,227,391,126
53080,5819,3025,2794,1045,1630,350,794,1632,368
53081,43723,21663,22060,7024,11315,3324,6384,10613,5063
53083,19499,9552,9947,2943,5183,1426,2887,5296,1764
53085,10273,5040,5233,1459,2641,940,1453,2641,1139
53086,7411,3622,3789,1081,2092,449,1264,1942,583
53088,271,126,145,48,64,14,66,52,27
53089,15838,7812,8026,2619,4197,996,2498,4385,1143
53090,19986,10115,9871,3474,5455,1186,3158,5317,1396
53091,1957,988,969,300,533,155,309,484,176
53092,20731,10059,10672,3111,5038,1910,3009,5440,2223
53093,1905,971,934,276,540,155,291,505,138
53094,17034,8238,8796,2733,4388,1117,2837,4430,1529
53095,24749,12019,12730,3874,6116,2029,3310,6309,3111
53097,4713,2414,2299,818,1229,367,633,1275,391
53098,11610,5737,5873,1840,2924,973,1684,2749,1440
53103,4041,2106,1935,726,1151,229,594,1136,205
53104,5137,2577,2560,832,1365,380,762,1309,489
53105,27495,13510,13985,4434,7128,1948,4205,7270,2510
53108,3161,1672,1489,460,916,296,378,858,253
53110,18481,8934,9547,2535,4842,1557,2555,4751,2241
53114,2563,1312,1251,499,696,117,428,623,200
53115,15100,7536,7564,2446,3932,1158,2329,3743,1492
53118,6554,3262,3292,1004,1742,516,928,1778,586
53119,5131,2536,2595,832,1471,233,873,1493,229
53120,8738,4348,4390,1283,2383,682,1286,2326,778
53121,15472,7697,7775,2449,4028,1220,2365,3887,1523
53122,6369,2999,3370,897,1374,728,870,1442,1058
53125,2040,1015,1025,247,519,249,204,509,312
53126,6360,3216,3144,1047,1697,472,1014,1658,472
53128,6724,3380,3344,1185,1830,365,1047,1798,499
53129,14043,6706,7337,1856,3140,1710,1690,3531,2116
53130,7577,3609,3968,1048,1887,674,943,1991,1034
53132,29512,15400,14112,4472,9102,1826,3914,8091,2107
53137,1423,721,702,238,382,101,242,347,113
53139,2723,1376,1347,446,743,187,468,667,212
53140,28779,13965,14814,4808,7166,1991,5100,6915,2799
53142,28382,13889,14493,4626,7374,1889,4206,7516,2771
53143,24281,11724,12557,4071,6147,1506,3864,6275,2418
53144,23261,11560,11701,3955,6302,1303,3987,6060,1654
53146,7370,3650,3720,1053,2007,590,1011,2047,662
53147,15028,7413,7615,2195,3948,1270,2096,3860,1659
53148,318,114,204,33,73,8,78,99,27
53149,16921,8614,8307,2992,4722,900,2561,4731,1015
53150,21639,10762,10877,3499,5961,1302,3254,5935,1688
53151,30897,15034,15863,4314,8406,2314,4394,8539,2930
53153,2097,1057,1040,339,616,102,338,583,119
53154,28691,14058,14633,4169,8289,1600,4203,8178,2252
53156,2945,1466,1479,446,789,231,413,801,265
53158,11181,5673,5508,1958,3147,568,1730,3080,698
53167,123,74,49,26,43,5,12,28,9
53168,8272,4230,4042,1444,2340,446,1211,2266,565
53170,2089,1022,1067,380,556,86,379,532,156
53172,20816,10273,10543,3045,5553,1675,3043,5246,2254
53176,138,76,62,36,40,0,15,47,0
53177,7353,4445,2908,1011,3012,422,885,1516,507
53178,2840,1444,1396,387,814,243,372,787,237
53179,4887,2455,2432,879,1319,257,815,1321,296
53181,6564,3231,3333,1006,1719,506,1014,1712,607
53182,8194,3934,4260,1163,2231,540,1282,2306,672
53183,2799,1424,1375,519,786,119,497,831,47
53184,3762,1799,1963,590,933,276,535,889,539
53185,17145,8789,8356,3008,4756,1025,2610,4720,1026
53186,33555,16262,17293,5184,9047,2031,5251,8898,3144
53188,33969,17081,16888,5184,9948,1949,4786,9078,3024
53189,20848,10296,10552,3538,5733,1025,3486,6100,966
53190,18250,8981,9269,4063,3982,936,4304,3650,1315
53191,2353,1165,1188,398,540,227,346,615,227
53192,30,16,14,4,12,0,4,8,2
53195,31,18,13,9,6,3,0,6,7
53202,21018,11444,9574,1550,8463,1431,1120,6048,2406
53203,357,177,180,11,148,18,15,155,10
53204,42331,22940,19391,10052,11307,1581,8395,9198,1798
53205,10697,4915,5782,2610,1725,580,2620,2467,695
53206,33095,14841,18254,7493,5747,1601,7501,8177,2576
53207,36357,18107,18250,4832,10677,2598,4381,10238,3631
53208,35283,16917,18366,7679,8048,1190,7075,9518,1773
53209,48923,22307,26616,8888,10308,3111,8769,13113,4734
53210,30781,13796,16985,6525,6345,926,6788,8525,1672
53211,35280,16887,18393,4684,10379,1824,5195,10295,2903
53212,30836,14221,16615,5699,7110,1412,6376,8404,1835
53213,25878,12122,13756,3609,7136,1377,3453,7831,2472
53214,35504,17534,17970,4766,10156,2612,4637,9541,3792
53215,54914,27143,27771,10441,13654,3048,10041,13188,4542
53216,33470,15211,18259,6606,7040,1565,6178,9691,2390
53217,29339,14160,15179,4372,7042,2746,3830,7890,3459
53218,40431,18361,22070,8057,8327,1977,8256,10836,2978
53219,33866,16002,17864,4152,8788,3062,3800,8998,5066
53220,25122,11609,13513,2943,5993,2673,2960,6535,4018
53221,35669,16955,18714,4823,8958,3174,4346,9485,4883
53222,25023,11325,13698,3085,6007,2233,3172,6781,3745
53223,29757,13583,16174,4136,6922,2525,4175,7771,4228
53224,19720,9292,10428,3892,4578,822,3730,5404,1294
53225,26109,12106,14003,4454,6009,1643,4464,6910,2629
53226,18793,8716,10077,2207,4554,1955,2219,4780,3078
53227,23980,11341,12639,2912,6164,2265,2831,6255,3553
53228,14176,6629,7547,1800,3641,1188,1767,3842,1938
53233,15460,8175,7285,3293,4355,527,4145,2797,343
53235,8875,4329,4546,1173,2445,711,1015,2315,1216
53402,32650,15908,16742,5139,8477,2292,4718,8830,3194
53403,27648,13604,14044,4661,7160,1783,4740,6872,2432
53404,17100,8567,8533,3755,3830,982,3115,3988,1430
53405,25873,12785,13088,4249,6588,1948,3977,6705,2406
53406,22556,10516,12040,3171,5215,2130,2984,5745,3311
53502,2248,1147,1101,373,629,145,327,578,196
53503,1752,908,844,299,512,97,236,484,124
53504,2020,1008,1012,321,475,212,309,472,231
53505,369,185,184,47,101,37,60,90,34
53506,1150,589,561,160,319,110,164,270,127
53507,1984,1030,954,355,559,116,288,535,131
53508,4146,2101,2045,673,1177,251,597,1139,309
53510,1311,651,660,219,305,127,181,328,151
53511,47415,22832,24583,8004,11321,3507,7841,11883,4859
53515,2157,1051,1106,338,565,148,321,572,213
53516,1818,916,902,284,485,147,266,470,166
53517,1616,796,820,231,496,69,272,470,78
53518,1338,681,657,211,352,118,166,334,157
53520,6628,3302,3326,1141,1652,509,1043,1643,640
53521,2991,1491,1500,465,858,168,512,807,181
53522,1091,574,517,183,312,79,161,271,85
53523,4719,2373,2346,725,1242,406,688,1209,449
53525,4009,1989,2020,717,1028,244,635,1026,359
53526,550,291,259,104,128,59,67,136,56
53527,7914,4036,3878,1481,2249,306,1246,2287,345
53528,5030,2541,2489,820,1375,346,735,1399,355
53529,1740,900,840,314,495,91,287,454,99
53530,4374,2144,2230,685,1021,438,644,1017,569
53531,3794,1952,1842,616,1115,221,606,996,240
53532,11483,5646,5837,1937,3173,536,2024,3145,668
53533,6562,3199,3363,979,1666,554,952,1675,736
53534,10886,5555,5331,1667,2984,904,1478,2743,1110
53536,7130,3482,3648,1171,1843,468,1163,1850,635
53537,305,145,160,30,90,25,59,77,24
53538,17483,8614,8869,2706,4603,1305,2395,4721,1753
53540,143,77,66,15,51,11,16,37,13
53541,1036,523,513,164,275,84,173,245,95
53543,1652,830,822,283,409,138,246,413,163
53544,860,435,425,117,252,66,134,207,84
53545,42091,20644,21447,6537,10923,3184,6178,10941,4328
53546,27758,13778,13980,4279,7553,1946,4196,7379,2405
53549,10048,4966,5082,1360,2819,787,1289,2576,1217
53550,1268,636,632,218,323,95,227,300,105
53551,7231,3554,3677,1108,1878,568,1029,1926,722
53553,654,312,342,110,170,32,117,170,55
53554,1045,508,537,170,253,85,170,250,117
53555,7920,3975,3945,1194,2169,612,1117,2088,740
53556,2740,1400,1340,449,733,218,409,693,238
53557,464,234,230,73,120,41,80,112,38
53558,9097,4495,4602,1472,2596,427,1399,2698,505
53559,5436,2724,2712,897,1473,354,876,1457,379
53560,3503,1765,1738,537,982,246,510,983,245
53561,1494,783,711,196,405,182,149,396,166
53562,19436,9382,10054,2641,5718,1023,2631,6006,1417
53563,9291,4672,4619,1625,2465,582,1401,2489,729
53565,4608,2292,2316,784,1158,350,662,1158,496
53566,14771,7117,7654,2157,3683,1277,2087,3674,1893
53569,1108,581,527,214,276,91,174,260,93
53570,2312,1161,1151,370,614,177,339,595,217
53571,193,84,109,18,58,8,28,66,15
53572,8380,4100,4280,1347,2165,588,1274,2285,721
53573,3280,1649,1631,523,823,303,490,744,397
53574,3286,1604,1682,534,794,276,447,826,409
53575,13538,7018,6520,2257,4153,608,2036,3829,655
53576,2255,1095,1160,365,582,148,398,583,179
53577,1449,767,682,266,374,127,187,333,162
53578,5060,2471,2589,756,1372,343,870,1288,431
53579,1868,983,885,318,532,133,267,464,154
53580,640,305,335,118,151,36,142,151,42
53581,10274,4993,5281,1635,2362,996,1514,2274,1493
53582,1155,592,563,200,321,71,176,308,79
53583,5154,2578,2576,812,1317,449,661,1330,585
53585,2101,1078,1023,366,574,138,338,535,150
53586,2245,1128,1117,397,547,184,336,502,279
53587,1298,629,669,203,304,122,206,317,146
53588,3799,1844,1955,580,979,285,596,981,378
53589,19313,9445,9868,3100,5014,1331,2884,5203,1781
53590,25869,12630,13239,4342,6938,1350,4335,7294,1610
53593,12939,6248,6691,2212,3268,768,2148,3601,942
53594,5003,2518,2485,804,1399,315,771,1316,398
53597,13206,6480,6726,2279,3344,857,2159,3452,1115
53598,2156,1079,1077,344,649,86,340,618,119
53703,26543,14171,12372,4659,9089,423,5096,6570,706
53704,43429,21204,22225,5695,13206,2303,5323,13480,3422
53705,30433,14578,15855,4205,8218,2155,4187,8489,3179
53706,5217,2411,2806,2335,76,0,2732,74,0
53711,42148,20716,21432,6570,11779,2367,5804,12181,3447
53713,22967,11506,11461,3442,7309,755,3573,6938,950
53714,16310,8042,8268,2374,4630,1038,1938,4733,1597
53715,10466,5354,5112,1792,3186,376,1987,2489,636
53716,19293,9295,9998,2609,5237,1449,2522,5426,2050
53717,10682,5111,5571,1463,3053,595,1330,3284,957
53718,3536,1786,1750,362,1165,259,382,1114,254
53719,18109,8987,9122,2498,6003,486,2332,6180,610
53801,786,409,377,116,190,103,91,184,102
53803,1129,539,590,180,277,82,185,287,118
53804,1602,821,781,247,421,153,250,356,175
53805,5405,2769,2636,917,1395,457,791,1236,609
53806,1999,1011,988,327,464,220,259,438,291
53807,5157,2541,2616,826,1313,402,837,1250,529
53808,570,281,289,61,150,70,67,137,85
53809,3971,1983,1988,719,887,377,568,901,519
53810,567,286,281,87,143,56,85,132,64
53811,3202,1496,1706,461,773,262,474,774,458
53813,6273,3068,3205,993,1534,541,959,1447,799
53816,609,300,309,72,162,66,84,152,73
53817,47,21,26,6,12,3,7,12,7
53818,13475,7218,6257,3157,3220,841,2332,2803,1122
53820,2966,1531,1435,475,779,277,442,721,272
53821,8360,4264,4096,1637,1880,747,1077,1955,1064
53825,433,214,219,82,96,36,88,110,21
53826,1808,953,855,372,458,123,304,423,128
53827,307,142,165,35,79,28,62,70,33
53901,13703,7050,6653,1995,3911,1144,1863,3289,1501
53910,3442,1652,1790,527,734,391,484,815,491
53911,999,524,475,165,283,76,124,276,75
53913,18088,8781,9307,2775,4701,1305,2705,4662,1940
53916,20906,10214,10692,3129,5353,1732,3087,5241,2364
53919,2637,1295,1342,441,692,162,459,645,238
53920,447,223,224,48,114,61,44,94,86
53922,1141,574,567,181,309,84,172,286,109
53923,2185,1086,1099,383,531,172,391,498,210
53924,1448,741,707,231,360,150,224,335,148
53925,7413,3673,3740,1144,1919,610,1071,1793,876
53926,1387,676,711,254,328,94,284,305,122
53928,39,17,22,6,7,4,6,7,9
53929,2913,1436,1477,462,685,289,443,669,365
53930,1270,635,635,213,314,108,226,294,115
53931,257,128,129,31,75,22,32,67,30
53932,1987,1005,982,340,521,144,280,534,168
53933,4031,2665,1366,497,1861,307,371,685,310
53934,4262,2159,2103,532,977,650,463,994,646
53935,165,76,89,22,39,15,33,34,22
53936,1423,749,674,203,355,191,174,321,179
53937,918,449,469,161,217,71,173,205,91
53939,172,78,94,21,43,14,19,51,24
53940,34,23,11,10,11,2,2,8,1
53941,2742,1410,1332,472,638,300,432,632,268
53943,1072,547,525,170,295,82,198,250,77
53944,1930,991,939,263,540,188,284,468,187
53946,4358,2189,2169,634,1087,468,625,1020,524
53947,129,67,62,6,31,30,12,21,29
53948,7713,3759,3954,1206,1831,722,1127,1849,978
53949,7156,4215,2941,766,2613,836,739,1296,906
53950,4240,2123,2117,576,1068,479,506,1061,550
53951,2305,1182,1123,396,603,183,336,577,210
53952,2974,1493,1481,372,756,365,385,722,374
53953,222,106,116,40,58,8,39,56,21
53954,6494,3319,3175,1060,1686,573,858,1580,737
53955,5528,2871,2657,856,1584,431,736,1457,464
53956,3340,1712,1628,564,843,305,480,747,401
53959,11514,5687,5827,1897,2897,893,1666,2796,1365
53960,3177,1589,1588,510,841,238,504,829,255
53961,801,408,393,118,228,62,99,234,60
53962,39,17,22,2,11,4,7,7,8
53963,13442,7984,5458,2029,5062,893,1653,2531,1274
53964,3046,1533,1513,478,728,327,383,736,394
53965,9065,4450,4615,1291,2273,886,1207,2313,1095
53968,2389,1163,1226,372,566,225,364,555,307
53969,116,65,51,11,39,15,12,32,7
54001,7986,3807,4179,1133,1882,792,1182,1926,1071
54002,4789,2339,2450,756,1213,370,752,1197,501
54003,1015,517,498,152,295,70,150,264,84
54004,2275,1154,1121,377,633,144,373,571,177
54005,3000,1516,1484,537,770,209,483,711,290
54006,739,384,355,98,219,67,111,193,51
54007,1192,644,548,215,342,87,162,308,78
54009,2046,1073,973,310,604,159,294,535,144
54011,6166,3126,3040,1077,1597,452,935,1528,577
54012,774,427,347,154,223,50,117,192,38
54013,2470,1246,1224,446,627,173,410,548,266
54014,2167,1105,1062,313,628,164,313,591,158
54015,1948,967,981,326,527,114,318,503,160
54016,22542,11349,11193,3869,6484,996,3386,6504,1303
54017,12072,6017,6055,2001,3246,770,1977,3020,1058
54020,6400,3193,3207,1151,1687,355,1061,1713,433
54021,5493,2802,2691,962,1497,343,843,1448,400
54022,19341,9124,10217,3462,4837,825,4309,4822,1086
54023,2611,1316,1295,420,760,136,421,733,141
54024,4345,2162,2183,675,1079,408,594,1069,520
54025,4541,2310,2231,841,1292,177,762,1246,223
54026,1511,782,729,220,464,98,255,391,83
54027,922,483,439,148,274,61,114,240,85
54028,1996,987,1009,314,531,142,290,515,204
54082,1402,719,683,182,431,106,213,372,98
54101,2219,1148,1071,361,644,143,336,594,141
54102,982,513,469,136,227,150,127,203,139
54103,600,322,278,83,156,83,75,124,79
54104,1130,595,535,115,252,228,91,275,169
54106,4497,2313,2184,776,1265,272,713,1162,309
54107,3591,1841,1750,610,926,305,520,856,374
54110,5041,2523,2518,820,1316,387,798,1229,491
54111,2196,1103,1093,334,520,249,328,495,270
54112,2363,1216,1147,389,603,224,337,543,267
54113,2464,1268,1196,403,648,217,334,645,217
54114,5071,2560,2511,621,1201,738,556,1152,803
54115,30972,15244,15728,5452,8012,1780,5287,8034,2407
54119,1208,569,639,327,163,79,376,202,61
54120,343,190,153,49,99,42,31,73,49
54121,3261,1651,1610,467,801,383,394,783,433
54123,223,109,114,47,58,4,42,61,11
54124,3738,1874,1864,646,852,376,510,903,451
54125,729,387,342,128,163,96,97,151,94
54126,3642,1846,1796,630,1006,210,645,932,219
54127,31,20,11,6,7,7,0,8,3
54128,1800,905,895,331,414,160,269,420,206
54129,3530,1804,1726,579,933,292,569,888,269
54130,21472,10657,10815,3606,5655,1396,3586,5437,1792
54135,3410,1680,1730,763,683,234,719,740,271
54136,5937,2885,3052,908,1569,408,913,1527,612
54137,1127,591,536,168,312,111,181,258,97
54138,880,450,430,93,191,166,94,188,148
54139,3056,1584,1472,477,855,252,455,730,287
54140,8505,4116,4389,1471,2163,482,1332,2359,698
54141,1910,1029,881,322,586,121,242,520,119
54143,16156,7786,8370,2393,4073,1320,2355,4050,1965
54149,1294,680,614,154,299,227,112,279,223
54150,981,482,499,254,199,29,239,222,38
54151,4022,1978,2044,647,968,363,595,976,473
54152,240,144,96,53,75,16,34,49,13
54153,7237,3570,3667,1141,1809,620,1108,1769,790
54154,5154,2534,2620,837,1264,433,757,1304,559
54155,4073,1881,2192,696,1024,161,791,1158,243
54156,1833,935,898,245,485,205,268,414,216
54157,5460,2598,2862,763,1332,503,759,1306,797
54159,1396,741,655,206,385,150,164,366,125
54160,41,20,21,7,10,3,4,13,4
54161,2697,1400,1297,422,666,312,341,621,335
54162,7307,3713,3594,1327,1875,511,1246,1755,593
54165,7198,3548,3650,1215,1850,483,1206,1825,619
54166,16309,7947,8362,2236,4003,1708,2193,3901,2268
54169,1603,803,800,256,450,97,256,424,120
54170,3792,1986,1806,637,1097,252,561,977,268
54171,2976,1516,1460,564,881,71,490,898,72
54173,3361,1733,1628,579,1026,128,487,1035,106
54174,3118,1547,1571,456,708,383,442,688,441
54175,1016,522,494,115,230,177,80,215,199
54177,3227,1621,1606,438,803,380,464,761,381
54180,1966,989,977,372,517,100,367,514,96
54201,5656,2763,2893,815,1386,562,768,1370,755
54202,1356,659,697,146,329,184,149,338,210
54204,1715,865,850,227,484,154,254,432,164
54205,2195,1075,1120,336,559,180,374,531,215
54207,121,59,62,16,41,2,10,36,16
54208,5826,2925,2901,989,1545,391,962,1454,485
54209,1118,547,571,132,289,126,136,296,139
54210,1022,501,521,117,212,172,108,256,157
54211,195,92,103,17,46,29,21,46,36
54212,1118,570,548,115,309,146,100,297,151
54213,1275,653,622,220,346,87,174,330,118
54214,132,71,61,20,36,15,26,27,8
54215,28,12,16,5,1,6,0,9,7
54216,6077,3124,2953,1001,1560,563,818,1446,689
54217,6491,3282,3209,1146,1688,448,1054,1629,526
54220,40839,19613,21226,5808,10240,3565,5891,9991,5344
54227,1638,873,765,321,470,82,246,434,85
54228,2763,1439,1324,449,744,246,416,663,245
54229,3822,1994,1828,612,1161,221,622,1004,202
54230,4681,2434,2247,810,1280,344,697,1147,403
54232,427,217,210,72,103,42,86,93,31
54234,1653,725,928,144,312,269,128,337,463
54235,17320,8522,8798,2449,4339,1734,2221,4293,2284
54240,18,10,8,0,6,4,4,0,4
54241,16114,8076,8038,2679,4028,1369,2230,3958,1850
54245,2528,1243,1285,399,636,208,421,632,232
54246,658,305,353,77,143,85,104,160,89
54247,2472,1277,1195,423,676,178,367,633,195
54301,25854,13537,12317,4137,7571,1829,3502,6324,2491
54302,30285,15293,14992,4997,8573,1723,4606,7919,2467
54303,27692,13287,14405,4299,7336,1652,4122,7556,2727
54304,30002,14456,15546,4388,7688,2380,4314,7895,3337
54311,27079,13230,13849,4576,7511,1143,4826,7405,1618
54313,31655,15890,15765,5705,8746,1439,5229,9065,1471
54401,30512,15099,15413,4988,7689,2422,4563,7665,3185
54403,24556,12127,12429,4135,6050,1942,3433,5999,2997
54405,2726,1353,1373,422,647,284,391,602,380
54406,3413,1741,1672,620,905,216,505,889,278
54407,1738,898,840,287,458,153,238,459,143
54408,1271,684,587,219,358,107,189,306,92
54409,13642,6637,7005,2177,3160,1300,1885,3297,1823
54410,2193,1088,1105,364,550,174,352,540,213
54411,5293,2676,2617,957,1317,402,982,1191,444
54412,2223,1194,1029,395,617,182,315,518,196
54413,218,119,99,32,61,26,26,40,33
54414,3494,1750,1744,601,867,282,583,838,323
54416,1616,789,827,279,345,165,288,403,136
54417,71,34,37,2,15,17,4,18,15
54418,1284,684,600,244,318,122,183,308,109
54420,1256,647,609,245,321,81,208,317,84
54421,3341,1665,1676,623,795,247,563,737,376
54422,1197,620,577,255,268,97,230,235,112
54423,2033,1028,1005,325,559,144,295,539,171
54424,1790,912,878,238,453,221,230,427,221
54425,1963,1020,943,372,503,145,314,454,175
54426,4185,2165,2020,732,1114,319,688,971,361
54427,1070,559,511,183,283,93,152,259,100
54428,1163,592,571,125,240,227,105,241,225
54430,124,61,63,18,26,17,21,30,12
54433,1880,962,918,294,465,203,275,408,235
54435,2193,1203,990,349,608,246,267,522,201
54436,2300,1169,1131,482,537,150,470,500,161
54437,3129,1552,1577,566,736,250,583,691,303
54440,2884,1479,1405,457,820,202,431,740,234
54441,829,391,438,129,223,39,182,213,43
54442,1250,766,484,451,237,78,167,246,71
54443,2277,1156,1121,373,612,171,374,566,181
54446,2900,1488,1412,555,671,262,476,642,294
54447,525,268,257,78,123,67,56,127,74
54448,3918,1943,1975,614,1005,324,649,985,341
54449,25663,12399,13264,3861,6455,2083,3687,6682,2895
54451,11133,5619,5514,1781,2904,934,1626,2732,1156
54452,19375,9401,9974,2884,4964,1553,2938,4828,2208
54454,1278,664,614,231,345,88,203,308,103
54455,15650,7958,7692,2476,4433,1049,2312,4198,1182
54456,6438,3175,3263,1019,1506,650,961,1452,850
54457,8520,4338,4182,1251,2141,946,1108,2056,1018
54459,1272,694,578,213,337,144,156,279,143
54460,2587,1252,1335,412,558,282,430,565,340
54462,373,192,181,40,98,54,36,92,53
54463,621,332,289,79,161,92,59,143,87
54465,716,369,347,65,176,128,45,164,138
54466,2886,1478,1408,460,741,277,422,689,297
54467,11972,5973,5999,1935,3509,529,2040,3302,657
54469,1924,946,978,327,397,222,267,420,291
54470,1983,985,998,320,446,219,278,447,273
54471,1591,805,786,258,441,106,246,429,111
54473,2522,1285,1237,420,672,193,419,634,184
54474,3702,1853,1849,618,891,344,512,943,394
54475,1589,783,806,236,414,133,249,399,158
54476,14980,7437,7543,2487,4063,887,2356,4067,1120
54479,3762,1907,1855,671,955,281,619,921,315
54480,1264,624,640,227,319,78,230,304,106
54481,37345,18427,18918,6741,9282,2404,6689,8942,3287
54484,4467,2294,2173,743,1242,309,682,1126,365
54485,285,148,137,21,61,66,33,51,53
54486,2484,1225,1259,354,614,257,373,574,312
54487,10004,4948,5056,1327,2420,1201,1251,2451,1354
54488,1222,619,603,251,303,65,240,278,85
54489,1532,784,748,254,411,119,228,369,151
54490,763,409,354,146,205,58,112,180,62
54491,1640,859,781,230,410,219,183,371,227
54493,712,367,345,113,192,62,85,172,88
54494,27735,13594,14141,4371,6953,2270,4138,6919,3084
54495,7846,3820,4026,1189,1947,684,1250,1838,938
54498,2199,1137,1062,397,531,209,363,504,195
54499,3073,1553,1520,544,694,315,414,684,422
54501,20260,9961,10299,3033,5096,1832,2826,5022,2451
54511,1551,797,754,240,371,186,211,353,190
54512,896,447,449,99,203,145,101,201,147
54513,543,296,247,67,149,80,58,116,73
54514,2044,1050,994,317,517,216,245,494,255
54515,585,303,282,79,159,65,77,129,76
54517,136,76,60,13,22,41,9,28,23
54519,1004,517,487,127,243,147,116,254,117
54520,4084,1987,2097,650,937,400,640,932,525
54521,7936,3909,4027,1032,1852,1025,937,1817,1273
54524,663,342,321,87,161,94,80,169,72
54525,239,108,131,24,59,25,28,53,50
54526,853,429,424,136,202,91,132,210,82
54527,1324,704,620,235,324,145,171,302,147
54529,992,494,498,82,296,116,111,259,128
54530,825,465,360,110,264,91,87,173,100
54531,1529,770,759,169,378,223,175,377,207
54534,2868,1403,1465,360,724,319,331,616,518
54536,247,123,124,26,75,22,33,64,27
54537,654,346,308,127,168,51,100,166,42
54538,2608,1316,1292,538,532,246,449,611,232
54539,1584,861,723,176,475,210,138,388,197
54540,986,474,512,108,220,146,109,242,161
54541,1638,808,830,315,325,168,240,349,241
54542,535,295,240,62,126,107,52,102,86
54543,37,15,22,2,7,6,10,12,0
54545,847,462,385,92,187,183,30,192,163
54546,1486,730,756,197,365,168,190,374,192
54547,1816,915,901,185,447,283,181,436,284
54548,5269,2549,2720,582,1160,807,564,1244,912
54550,773,368,405,96,197,75,132,186,87
54552,4885,2357,2528,611,1133,613,640,1104,784
54554,1230,613,617,140,276,197,120,263,234
54555,5510,2766,2744,806,1347,613,709,1304,731
54556,1345,654,691,193,319,142,203,326,162
54557,857,426,431,63,184,179,76,183,172
54558,1936,979,957,217,416,346,160,453,344
54559,781,390,391,169,164,57,131,205,55
54560,633,316,317,70,171,75,76,158,83
54561,104,48,56,10,17,21,4,29,23
54562,1951,992,959,170,450,372,203,340,416
54563,745,381,364,134,188,59,114,166,84
54564,433,237,196,59,105,73,39,90,67
54565,37,16,21,3,5,8,2,11,8
54566,1639,832,807,261,377,194,257,377,173
54568,4788,2347,2441,576,1111,660,545,1085,811
54601,48733,22600,26133,7799,11271,3530,9385,11267,5481
54603,14811,7390,7421,2291,4050,1049,2131,3834,1456
54610,1864,980,884,268,499,213,237,426,221
54611,1213,604,609,210,307,87,221,265,123
54612,4459,2255,2204,704,1191,360,627,1105,472
54613,1729,884,845,201,408,275,169,390,286
54614,2549,1280,1269,424,646,210,419,601,249
54615,10257,5570,4687,1627,3091,852,1301,2235,1151
54616,2458,1199,1259,353,572,274,355,552,352
54618,2240,1145,1095,350,568,227,340,509,246
54619,4156,2069,2087,877,883,309,833,895,359
54621,1008,535,473,173,290,72,156,232,85
54622,2338,1174,1164,315,596,263,301,551,312
54623,1514,786,728,231,375,180,174,391,163
54624,1515,776,739,210,407,159,191,391,157
54625,290,145,145,50,60,35,53,66,26
54626,903,463,440,135,227,101,115,235,90
54627,1897,963,934,278,510,175,258,463,213
54628,1168,592,576,161,282,149,160,284,132
54629,2589,1329,1260,346,752,231,346,633,281
54630,3518,1727,1791,537,902,288,529,883,379
54631,1696,850,846,262,416,172,228,422,196
54632,1233,586,647,166,296,124,220,296,131
54634,3892,1886,2006,667,863,356,667,878,461
54635,1631,876,755,223,463,190,195,401,159
54636,10251,5151,5100,1918,2726,507,1728,2833,539
54637,38,21,17,5,5,11,2,4,11
54638,1536,802,734,268,377,157,258,316,160
54639,2174,1099,1075,371,539,189,357,504,214
54640,80,40,40,11,22,7,9,23,8
54642,1832,952,880,310,476,166,263,415,202
54644,1232,626,606,194,350,82,190,333,83
54645,58,29,29,8,12,9,9,15,5
54646,3655,1865,1790,610,881,374,569,840,381
54648,1662,849,813,308,431,110,302,374,137
54650,20067,9799,10268,3194,5440,1165,3198,5632,1438
54651,1152,591,561,206,281,104,194,260,107
54652,837,416,421,142,186,88,134,181,106
54653,943,544,399,188,271,85,122,236,41
54654,304,158,146,60,69,29,41,71,34
54655,1771,883,888,288,405,190,240,413,235
54656,15700,7854,7846,2466,4135,1253,2371,3860,1615
54657,450,212,238,68,105,39,89,109,40
54658,2664,1379,1285,427,759,193,345,722,218
54659,1274,679,595,262,313,104,210,294,91
54660,14180,7145,7035,2296,3701,1148,2157,3432,1446
54661,2793,1435,1358,426,770,239,365,749,244
54664,1526,785,741,223,389,173,176,376,189
54665,8095,3869,4226,1252,1839,778,1178,1788,1260
54666,2579,1340,1239,428,704,208,403,643,193
54667,3721,1819,1902,606,844,369,570,877,455
54669,7776,3882,3894,1358,1970,554,1243,1991,660
54670,1731,902,829,416,381,105,358,342,129
54701,35765,16565,19200,6220,8128,2217,7058,8538,3604
54703,39541,19794,19747,6756,10672,2366,6702,10050,2995
54720,7309,3536,3773,1215,1773,548,966,1942,865
54721,1430,763,667,251,382,130,210,329,128
54722,3974,1992,1982,737,907,348,699,880,403
54723,1237,672,565,222,351,99,177,306,82
54724,6685,3307,3378,1039,1709,559,939,1677,762
54725,2865,1411,1454,451,724,236,521,684,249
54726,1779,934,845,319,468,147,269,416,160
54727,4354,2263,2091,777,1100,386,620,1035,436
54728,5970,3004,2966,833,1503,668,753,1411,802
54729,27904,13692,14212,4337,7297,2058,4145,7098,2969
54730,4761,2388,2373,749,1249,390,761,1188,424
54731,781,403,378,157,165,81,128,175,75
54732,2798,1399,1399,478,680,241,426,628,345
54733,1385,696,689,234,329,133,216,319,154
54734,816,429,387,142,216,71,107,200,80
54736,4082,2016,2066,720,947,349,693,916,457
54737,438,202,236,56,108,38,67,114,55
54738,2817,1504,1313,485,795,224,385,687,241
54739,3985,2011,1974,699,1116,196,694,1080,200
54740,2145,1095,1050,384,511,200,328,459,263
54741,1480,772,708,244,375,153,254,317,137
54742,4076,2013,2063,614,1094,305,620,1045,398
54745,2170,1095,1075,292,541,262,333,497,245
54746,641,354,287,98,200,56,80,167,40
54747,2424,1259,1165,372,635,252,348,537,280
54748,1205,648,557,200,321,127,151,301,105
54749,987,506,481,174,274,58,138,266,77
54750,1077,560,517,201,278,81,170,269,78
54751,23373,11817,11556,4658,5819,1340,4545,5169,1842
54754,1432,747,685,209,376,162,156,343,186
54755,7084,3496,3588,1139,1769,588,1100,1714,774
54756,976,505,471,137,282,86,125,235,111
54757,3020,1516,1504,474,759,283,467,742,295
54758,4461,2219,2242,675,1125,419,655,1084,503
54759,1528,777,751,193,389,195,174,334,243
54760,32,14,18,5,7,2,3,3,12
54761,1157,587,570,194,260,133,156,245,169
54762,1325,690,635,213,365,112,185,312,138
54763,1028,516,512,169,260,87,156,235,121
54766,1476,714,762,238,346,130,283,322,157
54767,2734,1355,1379,464,689,202,410,706,263
54768,4164,2046,2118,749,932,365,684,928,506
54769,344,182,162,37,103,42,35,88,39
54770,1983,1024,959,312,500,212,256,458,245
54771,3836,1892,1944,709,842,341,676,820,448
54772,1012,528,484,181,273,74,166,254,64
54773,3655,1861,1794,552,976,333,529,829,436
54801,6569,3318,3251,1050,1509,759,809,1507,935
54805,1492,745,747,252,385,108,248,349,150
54806,11754,5655,6099,1901,2877,877,1890,2826,1383
54810,2415,1238,1177,307,637,294,318,571,288
54812,5566,2716,2850,930,1320,466,854,1293,703
54813,679,359,320,129,170,60,92,178,50
54814,2474,1258,1216,449,605,204,382,640,194
54817,2119,1125,994,319,515,291,215,487,292
54819,2679,1343,1336,374,631,338,356,581,399
54820,868,439,429,150,219,70,167,194,68
54821,1420,724,696,152,388,184,147,345,204
54822,3974,1962,2012,622,1017,323,637,1040,335
54824,2262,1160,1102,397,591,172,364,558,180
54826,828,405,423,90,208,107,111,224,88
54827,201,96,105,9,57,30,18,54,33
54828,782,408,374,107,196,105,96,177,101
54829,5362,2726,2636,864,1305,557,705,1243,688
54830,2785,1436,1349,275,619,542,237,601,511
54832,421,203,218,49,82,72,61,87,70
54834,26,18,8,8,7,3,0,6,2
54835,981,519,462,132,280,107,124,214,124
54836,1133,612,521,207,318,87,147,294,80
54837,4007,1940,2067,562,944,434,566,891,610
54838,1065,559,506,79,324,156,113,260,133
54839,312,166,146,46,82,38,40,76,30
54840,4503,2258,2245,695,1148,415,665,1086,494
54841,22,20,2,7,9,4,0,0,2
54842,0,0,0,0,0,0,0,0,0
54843,10889,5441,5448,1676,2613,1152,1556,2609,1283
54844,185,95,90,17,42,36,15,40,35
54845,95,45,50,15,22,8,10,20,20
54846,507,264,243,102,117,45,71,115,57
54847,2054,1046,1008,263,534,249,237,506,265
54848,6708,3234,3474,1064,1552,618,1037,1544,893
54849,1977,1030,947,289,535,206,273,482,192
54850,240,140,100,33,70,37,18,50,32
54853,3771,1865,1906,579,894,392,546,894,466
54854,908,459,449,137,248,74,128,237,84
54855,731,370,361,135,191,44,143,164,54
54856,1505,788,717,242,400,146,201,359,157
54857,111,62,49,24,22,16,7,25,17
54858,1408,685,723,191,313,181,200,309,214
54859,1877,954,923,233,476,245,237,432,254
54861,372,177,195,105,54,18,82,89,24
54862,317,134,183,31,73,30,72,74,37
54864,1335,627,708,190,326,111,221,324,163
54865,540,291,249,83,137,71,62,129,58
54867,471,235,236,54,116,65,62,108,66
54868,15513,7568,7945,2450,3884,1234,2283,3824,1838
54870,1616,854,762,216,427,211,185,371,206
54871,2921,1400,1521,405,687,308,412,727,382
54872,2779,1409,1370,355,677,377,334,609,427
54873,2481,1297,1184,365,612,320,296,577,311
54874,3333,1734,1599,571,935,228,486,886,227
54875,1098,582,516,163,305,114,148,260,108
54876,1554,761,793,187,340,234,199,358,236
54880,30666,14849,15817,4591,7937,2321,4663,7820,3334
54888,1393,711,682,200,369,142,188,344,150
54889,2643,1319,1324,388,661,270,371,658,295
54891,3665,1825,1840,604,907,314,501,935,404
54893,3725,1878,1847,512,861,505,457,836,554
54895,1106,558,548,156,271,131,154,243,151
54896,1520,805,715,211,362,232,142,352,221
54901,36284,18582,17702,6124,10473,1985,6555,8372,2775
54902,22617,10866,11751,3089,5767,2010,2888,5693,3170
54904,18110,8975,9135,2911,4842,1222,2785,5005,1345
54909,2132,1116,1016,383,576,157,307,530,179
54911,28284,13770,14514,4732,7127,1911,4498,7098,2918
54913,9956,5076,4880,1835,2705,536,1602,2750,528
54914,31100,15326,15774,4891,8618,1817,4694,8525,2555
54915,37795,18693,19102,6588,10236,1869,6261,10254,2587
54921,1309,704,605,254,356,94,163,339,103
54922,1545,813,732,273,426,114,242,390,100
54923,8588,4223,4365,1308,2190,725,1293,2067,1005
54927,340,180,160,74,88,18,45,88,27
54928,383,202,181,42,120,40,50,91,40
54929,9146,4427,4719,1327,2241,859,1409,2130,1180
54930,1706,854,852,222,386,246,209,363,280
54932,961,511,450,165,281,65,141,255,54
54933,177,83,94,19,48,16,30,47,17
54934,94,53,41,19,24,10,4,28,9
54935,47859,22932,24927,7544,11971,3417,7195,12594,5138
54937,9676,4696,4980,1418,2560,718,1434,2563,983
54940,4212,2131,2081,594,1112,425,588,1042,451
54941,2858,1449,1409,373,749,327,293,710,406
54942,4801,2439,2362,871,1389,179,882,1294,186
54943,1898,975,923,259,475,241,239,457,227
54944,7528,3882,3646,1297,2147,438,1181,2076,389
54945,3491,1707,1784,488,859,360,480,850,454
54947,2515,1284,1231,396,656,232,319,680,232
54948,362,175,187,43,80,52,46,78,63
54949,3652,1836,1816,611,916,309,584,858,374
54950,2984,1542,1442,509,747,286,409,686,347
54952,22894,11320,11574,3512,6174,1634,3199,6229,2146
54956,37666,18496,19170,5903,10087,2506,5859,10217,3094
54960,2664,1358,1306,311,623,424,275,585,446
54961,13772,7025,6747,2450,3579,996,1992,3391,1364
54962,1044,551,493,153,296,102,144,260,89
54963,6157,3128,3029,943,1648,537,848,1588,593
54964,973,494,479,164,263,67,146,257,76
54965,1229,626,603,158,337,131,153,312,138
54966,2022,1022,1000,362,486,174,289,489,222
54967,360,167,193,57,80,30,44,85,64
54968,3071,1491,1580,412,700,379,359,707,514
54970,2892,1455,1437,417,723,315,385,666,386
54971,10549,5007,5542,1639,2488,880,1763,2505,1274
54974,1565,785,780,271,396,118,256,422,102
54976,43,18,25,4,10,4,10,13,2
54977,1265,636,629,183,319,134,179,317,133
54978,49,26,23,7,18,1,4,12,7
54979,1395,704,691,226,364,114,214,373,104
54980,168,80,88,16,54,10,20,55,13
54981,15136,7834,7302,2368,3712,1754,1853,3635,1814
54982,6900,3461,3439,1005,1619,837,869,1556,1014
54983,4542,2250,2292,746,1149,355,742,1057,493
54984,3140,1549,1591,396,692,461,389,680,522
54985,1082,888,194,210,678,0,78,106,10
54986,4489,2232,2257,654,1180,398,627,1186,444
55001,2674,1308,1366,401,745,162,410,796,160
55003,3154,2281,873,304,1781,196,202,454,217
55005,4018,2124,1894,884,1094,146,716,1060,118
55006,3202,1617,1585,556,820,241,505,777,303
55007,2151,1084,1067,353,558,173,363,547,157
55008,12365,5896,6469,1919,3098,879,2047,3097,1325
55009,7822,3885,3937,1290,1988,607,1247,1979,711
55010,24,11,13,4,7,0,4,9,0
55011,8751,4566,4185,1608,2641,317,1521,2405,259
55012,1594,858,736,272,460,126,264,350,122
55013,4855,2413,2442,840,1272,301,745,1202,495
55014,26339,13768,12571,4945,8046,777,4682,6973,916
55016,30016,15077,14939,5851,8154,1072,5285,8475,1179
55017,693,357,336,129,187,41,102,178,56
55018,899,471,428,170,239,62,135,231,62
55019,1057,554,503,181,299,74,155,285,63
55020,2374,1264,1110,456,699,109,385,623,102
55021,27425,14017,13408,4542,7520,1955,4200,6637,2571
55024,21181,10836,10345,4092,6066,678,3800,5761,784
55025,19722,9701,10021,3134,5453,1114,3167,5443,1411
55026,365,183,182,59,100,24,54,94,34
55027,2641,1377,1264,507,681,189,447,607,210
55030,1116,606,510,175,312,119,141,283,86
55031,1872,964,908,380,466,118,360,445,103
55032,3167,1567,1600,517,863,187,608,804,188
55033,25724,13026,12698,4352,7041,1633,3985,6741,1972
55036,184,101,83,40,52,9,18,52,13
55037,4508,2237,2271,817,1080,340,745,1096,430
55038,10660,5514,5146,2093,3111,310,1796,2989,361
55040,9453,4915,4538,1855,2580,480,1606,2440,492
55041,7474,3697,3777,1136,1811,750,1049,1858,870
55042,7535,3892,3643,1400,2117,375,1213,2071,359
55043,4034,2015,2019,600,1201,214,622,1146,251
55044,34992,17750,17242,7098,9751,901,6648,9655,939
55045,5264,2733,2531,960,1288,485,732,1341,458
55046,2882,1490,1392,502,802,186,459,721,212
55047,2635,1330,1305,417,677,236,378,679,248
55049,2248,1103,1145,367,590,146,400,572,173
55051,9109,4521,4588,1473,2208,840,1368,2170,1050
55052,2098,1051,1047,373,512,166,340,502,205
55053,704,369,335,139,181,49,117,169,49
55055,3794,1824,1970,605,1018,201,627,1064,279
55056,10789,5496,5293,2024,2846,626,1761,2865,667
55057,22081,10721,11360,4673,4894,1154,4879,4856,1625
55060,26303,12905,13398,4518,6586,1801,4179,6756,2463
55063,8277,4160,4117,1366,1982,812,1223,1943,951
55065,937,504,433,186,249,69,137,244,52
55066,18392,8993,9399,2886,4595,1512,2651,4562,2186
55068,20466,10438,10028,4279,5486,673,3671,5646,711
55069,4529,2398,2131,732,1313,353,640,1063,428
55070,5467,2763,2704,1059,1566,138,996,1559,149
55071,5292,2647,2645,897,1401,349,840,1402,403
55072,3936,2330,1606,459,1516,355,407,715,484
55073,2719,1437,1282,482,819,136,369,743,170
55074,890,446,444,155,232,59,166,238,40
55075,20138,9807,10331,3030,5419,1358,3060,5306,1965
55076,18438,8938,9500,3110,4868,960,3006,5335,1159
55077,10705,5515,5190,1889,3078,548,1502,3002,686
55079,7000,3704,3296,1312,2123,269,1106,1938,252
55080,2262,1226,1036,403,643,180,311,550,175
55082,30273,15036,15237,4976,8280,1780,4526,8311,2400
55084,1431,707,724,257,344,106,220,364,140
55085,251,117,134,38,61,18,40,55,39
55087,230,111,119,30,77,4,46,65,8
55088,1595,865,730,307,457,101,210,427,93
55089,1823,962,861,335,504,123,285,463,113
55090,368,184,184,51,101,32,58,103,23
55092,9363,4646,4717,1723,2512,411,1697,2579,441
55101,21544,10693,10851,3992,5711,990,4213,5202,1436
55102,17567,8862,8705,1959,5838,1065,1769,5159,1777
55103,14698,7309,7389,3136,3555,618,2820,3647,922
55104,46169,22206,23963,8268,12020,1918,8257,12819,2887
55105,27543,12615,14928,4192,7150,1273,4872,8108,1948
55106,54880,27031,27849,11193,13361,2477,10450,13533,3866
55107,16352,7870,8482,3043,4094,733,3066,4152,1264
55108,15801,7501,8300,2260,4461,780,2062,4792,1446
55109,30306,14738,15568,4671,7879,2188,4300,7952,3316
55110,40057,19425,20632,6434,10300,2691,6302,10842,3488
55112,45184,21605,23579,6969,11621,3015,7538,12007,4034
55113,38245,17936,20309,4279,9882,3775,4337,10364,5608
55114,1310,679,631,141,462,76,100,455,76
55115,9006,4503,4503,1782,2198,523,1604,2274,625
55116,23600,10551,13049,2608,6178,1765,3092,6622,3335
55117,39716,19045,20671,6817,10089,2139,6686,10672,3313
55118,27317,12911,14406,3657,6644,2610,3570,7097,3739
55119,37719,18256,19463,5897,9990,2369,5870,10226,3367
55120,4676,2218,2458,852,1108,258,735,1337,386
55121,7762,3865,3897,1114,2452,299,1016,2600,281
55122,27868,13321,14547,3929,8276,1116,4166,9007,1374
55123,27404,13657,13747,5364,7742,551,5070,7966,711
55124,46755,22843,23912,8269,12876,1698,7881,13905,2126
55125,40067,19348,20719,6683,11167,1498,6673,12012,2034
55126,25267,12299,12968,4034,6676,1589,3497,7487,1984
55127,17106,8130,8976,2649,4466,1015,2715,5110,1151
55128,27307,13114,14193,4648,7126,1340,4366,8034,1793
55129,6370,3178,3192,1068,1856,254,1093,1837,262
55150,112,53,59,10,36,7,15,32,12
55301,4137,2055,2082,803,1118,134,782,1139,161
55302,6625,3288,3337,1064,1653,571,1027,1592,718
55303,42129,21404,20725,7381,12134,1889,7008,11420,2297
55304,39179,20048,19131,7710,11254,1084,7184,10918,1029
55305,19092,8947,10145,2328,5126,1493,2093,5628,2424
55306,14665,7318,7347,2381,4403,534,2277,4421,649
55307,3682,1801,1881,604,891,306,573,861,447
55308,6366,3229,3137,1324,1697,208,1225,1678,234
55309,12422,6411,6011,2592,3410,409,2273,3368,370
55310,1784,911,873,284,425,202,257,380,236
55311,19808,9874,9934,3731,5559,584,3469,5924,541
55312,1597,783,814,214,432,137,249,397,168
55313,18141,8932,9209,3180,4714,1038,3155,4780,1274
55314,1384,686,698,212,312,162,211,296,191
55315,2448,1282,1166,431,753,98,372,685,109
55316,22512,11313,11199,4463,6232,618,4089,6360,750
55317,17163,8546,8617,3287,4789,470,3097,4927,593
55318,19207,9743,9464,3711,5396,636,3331,5220,913
55319,4348,2255,2093,771,1170,314,701,1141,251
55320,3709,1884,1825,684,982,218,638,988,199
55321,5092,2561,2531,1068,1145,348,1036,1024,471
55322,2705,1392,1313,497,738,157,444,696,173
55324,1194,578,616,157,310,111,186,307,123
55325,4168,2150,2018,728,1075,347,599,983,436
55327,3621,1842,1779,638,1111,93,657,1039,83
55328,7259,3653,3606,1312,1953,388,1190,1930,486
55329,1992,1020,972,387,469,164,344,423,205
55330,26402,13415,12987,5162,7135,1118,4507,7011,1469
55331,17559,8648,8911,2907,4755,986,2889,4840,1182
55332,2116,1024,1092,303,473,248,358,425,309
55333,865,434,431,130,215,89,115,190,126
55334,2975,1448,1527,462,712,274,436,682,409
55335,1877,986,891,316,447,223,294,399,198
55336,8086,3987,4099,1342,2002,643,1272,1923,904
55337,45567,22417,23150,7401,12673,2343,6915,13267,2968
55338,922,483,439,139,253,91,141,203,95
55339,966,498,468,153,250,95,140,223,105
55340,5976,2955,3021,1157,1581,217,1144,1672,205
55341,1056,521,535,201,302,18,200,294,41
55342,2193,1097,1096,330,534,233,328,499,269
55343,24492,11650,12842,2927,7052,1671,2521,7683,2638
55344,13004,6428,6576,1710,4255,463,1563,4235,778
55345,22239,10890,11349,3443,5873,1574,3139,6171,2039
55346,17825,8811,9014,3351,4824,636,2991,5325,698
55347,24094,11875,12219,4627,6479,769,4266,7241,712
55349,3733,1871,1862,653,933,285,648,895,319
55350,17334,8484,8850,2909,4421,1154,2742,4461,1647
55352,6441,3340,3101,1262,1812,266,1116,1657,328
55353,2769,1426,1343,503,707,216,468,631,244
55354,2363,1202,1161,418,608,176,398,555,208
55355,9602,4725,4877,1538,2330,857,1399,2261,1217
55356,4643,2354,2289,766,1303,285,696,1269,324
55357,3496,1806,1690,676,957,173,581,964,145
55358,4506,2325,2181,789,1199,337,740,1052,389
55359,5568,2808,2760,986,1483,339,885,1479,396
55360,1519,775,744,276,415,84,257,389,98
55362,13804,6768,7036,2430,3694,644,2463,3730,843
55363,2813,1503,1310,513,821,169,418,733,159
55364,15089,7786,7303,2358,4559,869,2095,4261,947
55367,929,477,452,157,236,84,126,217,109
55368,2286,1155,1131,381,627,147,393,563,175
55369,33219,16635,16584,5831,9460,1344,5170,9746,1668
55370,740,361,379,99,190,72,94,207,78
55371,12348,6049,6299,2007,3213,829,2050,3199,1050
55372,22827,11446,11381,3936,6688,822,4007,6438,936
55373,4373,2230,2143,816,1291,123,749,1213,181
55374,9452,4966,4486,1957,2721,288,1551,2617,318
55375,1907,1013,894,348,589,76,275,512,107
55376,7511,3679,3832,1406,1976,297,1526,1985,321
55378,21957,11212,10745,4375,6388,449,3936,6285,524
55379,23123,11425,11698,3836,6551,1038,3652,6755,1291
55381,1912,988,924,312,520,156,279,444,201
55382,3808,1976,1832,635,1017,324,595,965,272
55384,1478,693,785,151,377,165,100,323,362
55385,1381,722,659,243,361,118,203,317,139
55386,3500,1728,1772,657,929,142,689,923,160
55387,8614,4194,4420,1394,2235,565,1383,2270,767
55388,4477,2164,2313,751,1123,290,768,1143,402
55389,2456,1250,1206,417,590,243,393,567,246
55390,1840,984,856,341,511,132,255,473,128
55391,15924,7803,8121,2333,4107,1363,2192,4337,1592
55395,2606,1266,1340,421,657,188,423,614,303
55396,2268,1098,1170,327,519,252,310,479,381
55397,2521,1256,1265,450,649,157,426,644,195
55398,10208,5284,4924,2020,2897,367,1840,2716,368
55401,3478,1907,1571,99,1509,299,133,1072,366
55402,143,68,75,10,58,0,6,49,20
55403,14862,8158,6704,821,6436,901,886,4559,1259
55404,26883,14552,12331,4204,9264,1084,4183,6399,1749
55405,16115,8112,8003,1930,5655,527,1896,5442,665
55406,33164,15888,17276,4336,9724,1828,4066,10269,2941
55407,37720,18806,18914,6753,10869,1184,6209,10657,2048
55408,30570,15927,14643,3925,11132,870,3466,9658,1519
55409,21219,10454,10765,2858,6432,1164,2558,6426,1781
55410,18479,8793,9686,1961,5734,1098,2012,6090,1584
55411,31672,15118,16554,7694,6430,994,7920,7187,1447
55412,24941,12020,12921,4865,6167,988,4878,6481,1562
55413,12503,6425,6078,1644,4096,685,1446,3499,1133
55414,23961,12510,11451,4689,7202,619,5195,5446,810
55415,1701,1259,442,283,902,74,80,297,65
55416,27310,13017,14293,2666,8578,1773,2675,8847,2771
55417,24915,12310,12605,2942,7237,2131,2964,7296,2345
55418,30620,15027,15593,3978,8793,2256,3709,8407,3477
55419,17228,8087,9141,2055,4991,1041,2081,5370,1690
55420,21489,10692,10797,2754,6148,1790,2464,5718,2615
55421,25638,12409,13229,3218,6816,2375,3084,6738,3407
55422,27970,13505,14465,3476,7509,2520,3354,7477,3634
55423,34650,16932,17718,4561,9548,2823,4143,9519,4056
55424,9776,4711,5065,1570,2371,770,1520,2520,1025
55425,8883,4508,4375,1101,2736,671,1080,2441,854
55426,25464,12164,13300,3036,7130,1998,2801,7512,2987
55427,23316,11299,12017,3096,6267,1936,2859,6490,2668
55428,30004,14346,15658,4400,7902,2044,4227,7778,3653
55429,26175,12712,13463,4191,6741,1780,3961,6955,2547
55430,20981,10061,10920,3209,5379,1473,3492,5289,2139
55431,18579,8901,9678,2230,4853,1818,2078,5149,2451
55432,30533,14974,15559,4237,8511,2226,4213,8495,2851
55433,34687,16595,18092,5776,9171,1648,5841,9834,2417
55434,27589,13549,14040,4551,7723,1275,4522,8017,1501
55435,11289,4683,6606,986,2200,1497,857,2533,3216
55436,12732,5919,6813,1717,2720,1482,1604,3177,2032
55437,18933,9034,9899,2262,4851,1921,2173,5071,2655
55438,17269,8083,9186,2206,4559,1318,2183,5252,1751
55439,8878,4238,4640,1221,1952,1065,1179,2252,1209
55441,17373,8657,8716,2427,5276,954,2488,5122,1106
55442,13162,6320,6842,2119,3594,607,2081,3936,825
55443,25290,12848,12442,4859,7033,956,4018,7260,1164
55444,15778,7931,7847,2886,4532,513,2773,4558,516
55445,8782,4213,4569,1252,2687,274,1380,2778,411
55446,12433,5899,6534,2060,3409,430,2145,3828,561
55447,23560,11911,11649,3783,6926,1202,3430,6779,1440
55448,26554,13071,13483,4638,7371,1062,4575,7603,1305
55449,11670,6007,5663,2342,3418,247,1917,3425,321
55450,0,0,0,0,0,0,0,0,0
55454,6814,3562,3252,1373,2011,178,1219,1696,337
55455,2148,962,1186,945,17,0,1128,58,0
55601,201,103,98,31,40,32,21,40,37
55602,247,142,105,16,88,38,20,60,25
55603,564,290,274,96,165,29,102,124,48
55604,3370,1648,1722,371,892,385,362,848,512
55605,538,290,248,101,161,28,70,160,18
55606,307,168,139,63,77,28,19,97,23
55607,164,84,80,27,48,9,18,52,10
55609,302,154,148,32,58,64,46,81,21
55612,471,247,224,69,126,52,49,134,41
55613,211,101,110,23,51,27,26,59,25
55614,2818,1448,1370,389,607,452,363,576,431
55615,239,138,101,25,72,41,24,57,20
55616,6747,3316,3431,933,1690,693,885,1655,891
55702,354,192,162,51,107,34,37,85,40
55703,794,436,358,141,231,64,117,188,53
55704,1330,676,654,249,300,127,206,309,139
55705,3421,1702,1719,458,845,399,423,824,472
55706,2055,1029,1026,235,395,399,226,388,412
55707,3251,1664,1587,572,841,251,492,822,273
55708,885,414,471,105,211,98,138,205,128
55709,4328,2222,2106,673,1133,416,593,1089,424
55710,1497,769,728,217,432,120,209,419,100
55711,515,268,247,96,109,63,64,114,69
55712,351,171,180,31,94,46,33,89,58
55713,914,461,453,127,238,96,119,199,135
55716,394,181,213,54,86,41,70,93,50
55717,335,182,153,58,79,45,22,100,31
55718,2802,1447,1355,429,763,255,359,658,338
55719,5903,2854,3049,868,1433,553,749,1429,871
55720,15827,7613,8214,2463,3915,1235,2395,4019,1800
55721,2866,1449,1417,437,732,280,358,807,252
55722,989,514,475,205,235,74,153,212,110
55723,2523,1288,1235,369,624,295,301,594,340
55724,866,428,438,139,236,53,148,207,83
55725,98,58,40,18,31,9,7,23,10
55726,834,422,412,110,177,135,105,192,115
55731,6260,3181,3079,944,1492,745,713,1456,910
55732,1461,748,713,203,388,157,195,370,148
55733,4139,2009,2130,646,1079,284,764,1076,290
55734,6598,3247,3351,966,1618,663,831,1593,927
55735,2032,1036,996,286,533,217,307,482,207
55736,1487,761,726,226,395,140,215,351,160
55738,618,336,282,109,181,46,83,171,28
55741,3112,1595,1517,429,819,347,378,713,426
55742,420,246,174,71,136,39,34,90,50
55744,19825,9783,10042,3087,4847,1849,2776,4985,2281
55746,18088,8704,9384,2610,4326,1768,2487,4383,2514
55748,1258,642,616,189,315,138,175,316,125
55749,292,165,127,37,89,39,27,72,28
55750,2149,1048,1101,255,502,291,252,532,317
55751,1730,899,831,269,503,127,249,441,141
55752,411,208,203,45,110,53,39,118,46
55753,1031,510,521,170,240,100,150,251,120
55756,331,169,162,55,75,39,34,88,40
55757,755,406,349,118,210,78,84,165,100
55758,236,153,83,87,44,22,18,42,23
55760,2800,1444,1356,354,604,486,300,566,490
55763,590,314,276,71,163,80,66,145,65
55764,501,248,253,79,125,44,73,116,64
55765,759,403,356,133,200,70,91,170,95
55767,3891,2334,1557,521,1456,357,405,662,490
55768,2826,1397,1429,409,724,264,424,679,326
55769,2253,1157,1096,333,591,233,279,561,256
55771,1835,964,871,297,446,221,269,415,187
55775,1332,659,673,150,316,193,173,316,184
55779,3489,1884,1605,619,1056,209,483,899,223
55780,132,69,63,36,30,3,30,28,5
55781,373,183,190,39,101,43,50,98,42
55782,422,216,206,68,103,45,71,95,40
55783,2026,1009,1017,264,511,234,297,480,240
55784,99,55,44,12,24,19,6,21,17
55785,258,132,126,51,56,25,45,57,24
55786,282,133,149,48,67,18,40,68,41
55787,283,152,131,37,58,57,13,61,57
55790,1866,950,916,197,463,290,205,452,259
55792,10980,5264,5716,1514,2677,1073,1326,2784,1606
55793,682,352,330,96,180,76,97,172,61
55795,1494,799,695,225,428,146,229,322,144
55796,149,81,68,26,29,26,20,27,21
55797,1312,681,631,256,365,60,226,337,68
55798,776,371,405,106,186,79,119,170,116
55802,2493,1033,1460,156,612,265,167,507,786
55803,16395,8117,8278,2522,4380,1215,2496,4278,1504
55804,14301,6911,7390,2203,3526,1182,2086,3864,1440
55805,11155,5610,5545,1991,3068,551,1821,2920,804
55806,9515,4700,4815,1447,2726,527,1520,2574,721
55807,10371,4927,5444,1642,2499,786,1446,2708,1290
55808,5828,2820,3008,904,1435,481,826,1482,700
55810,8786,4326,4460,1390,2187,749,1187,2280,993
55811,24942,11901,13041,3911,5908,2082,4055,5650,3336
55812,10177,4980,5197,2320,2256,404,2101,2464,632
55901,42174,20154,22020,6772,10961,2421,6189,11887,3944
55902,18720,9207,9513,2886,5084,1237,2743,5241,1529
55904,24416,12671,11745,4061,7152,1458,3678,6439,1628
55906,16191,7809,8382,2491,4125,1193,2506,4377,1499
55909,1562,787,775,261,331,195,232,296,247
55910,1527,830,697,290,400,140,199,355,143
55912,28013,13770,14243,4442,6620,2708,3779,6304,4160
55917,3669,1816,1853,558,904,354,528,848,477
55918,1001,505,496,164,238,103,137,230,129
55919,1354,705,649,246,352,107,200,348,101
55920,5598,2760,2838,1028,1452,280,1017,1533,288
55921,5204,2588,2616,906,1199,483,785,1211,620
55922,1032,534,498,207,230,97,191,198,109
55923,4148,2027,2121,630,1047,350,631,1001,489
55924,1378,735,643,247,367,121,220,291,132
55925,1007,554,453,196,265,93,127,248,78
55926,863,430,433,136,212,82,153,186,94
55927,3373,1664,1709,613,812,239,568,831,310
55929,998,523,475,206,244,73,169,238,68
55931,299,147,152,46,66,35,40,59,53
55932,1782,934,848,354,462,118,290,430,128
55933,250,129,121,58,52,19,46,57,18
55934,2710,1317,1393,436,689,192,471,721,201
55935,752,399,353,148,194,57,111,183,59
55936,1778,887,891,318,434,135,273,414,204
55939,2179,1088,1091,434,426,228,316,461,314
55940,2534,1235,1299,445,598,192,426,585,288
55941,1100,531,569,188,289,54,213,279,77
55943,3004,1476,1528,479,726,271,414,736,378
55944,7263,3612,3651,1308,1886,418,1300,1833,518
55945,1612,806,806,289,395,122,294,370,142
55946,3344,1698,1646,539,848,311,493,780,373
55947,7326,3608,3718,1198,1834,576,1116,1901,701
55949,1945,973,972,302,480,191,291,455,226
55950,154,75,79,23,28,24,19,31,29
55951,1516,762,754,252,365,145,216,346,192
55952,2496,1233,1263,436,609,188,458,585,220
55953,1006,509,497,188,241,80,172,232,93
55954,1514,710,804,193,324,193,217,330,257
55955,941,465,476,151,260,54,161,235,80
55956,1860,931,929,303,461,167,325,433,171
55957,727,372,355,123,189,60,128,182,45
55959,2270,1130,1140,386,599,145,389,616,135
55960,2779,1408,1371,429,781,198,440,733,198
55961,475,226,249,66,127,33,70,102,77
55962,862,448,414,150,209,89,126,189,99
55963,4142,2018,2124,695,1019,304,661,1072,391
55964,4365,2174,2191,804,1020,350,748,1034,409
55965,2272,1169,1103,348,545,276,280,500,323
55967,777,386,391,124,202,60,118,210,63
55969,1419,714,705,261,347,106,233,337,135
55970,891,476,415,169,222,85,133,182,100
55971,2844,1377,1467,422,668,287,389,684,394
55972,4538,2276,2262,880,1061,335,760,1080,422
55973,330,155,175,44,84,27,74,74,27
55974,2267,1116,1151,350,537,229,300,520,331
55975,4826,2386,2440,745,1197,444,739,1166,535
55976,6921,3348,3573,1203,1682,463,1161,1759,653
55977,227,132,95,63,48,21,35,41,19
55979,952,509,443,222,212,75,168,213,62
55981,4105,1985,2120,550,938,497,508,999,613
55982,521,263,258,87,130,46,95,116,47
55983,1418,745,673,255,360,130,200,322,151
55985,2075,1044,1031,338,529,177,360,473,198
55987,34675,16636,18039,5980,8198,2458,6761,7808,3470
55988,216,108,108,40,57,11,39,48,21
55990,936,486,450,153,220,113,123,215,112
55991,1377,703,674,227,387,89,219,373,82
55992,4360,2161,2199,740,1051,370,635,1074,490
56001,38960,19178,19782,7174,9853,2151,7576,8898,3308
56003,12759,6315,6444,2179,3461,675,2007,3497,940
56007,21596,10406,11190,3097,5055,2254,2892,5070,3228
56009,1752,917,835,286,455,176,215,403,217
56010,1262,645,617,218,293,134,166,276,175
56011,6031,2968,3063,1015,1530,423,1046,1463,554
56013,4954,2402,2552,734,1095,573,618,1082,852
56014,852,428,424,127,184,117,123,164,137
56016,1104,581,523,199,287,95,164,279,80
56017,1583,821,762,242,450,129,230,422,110
56019,918,445,473,127,187,131,131,201,141
56020,160,72,88,17,40,15,29,38,21
56021,1016,526,490,193,272,61,174,248,68
56022,141,74,67,24,36,14,20,31,16
56023,589,302,287,80,141,81,84,110,93
56024,2220,1130,1090,418,600,112,367,614,109
56025,478,255,223,78,128,49,76,102,45
56026,1871,951,920,287,488,176,285,429,206
56027,1198,629,569,228,258,143,149,269,151
56028,963,498,465,161,253,84,134,234,97
56029,782,381,401,128,185,68,108,194,99
56031,12781,6189,6592,1963,2927,1299,1793,2958,1841
56032,315,144,171,29,83,32,50,80,41
56033,360,179,181,49,90,40,44,77,60
56034,670,347,323,113,171,63,122,148,53
56035,521,250,271,76,145,29,95,125,51
56036,2101,1085,1016,302,538,245,285,500,231
56037,1613,801,812,270,410,121,288,376,148
56039,1058,544,514,181,285,78,137,270,107
56041,1202,627,575,170,317,140,185,273,117
56042,744,397,347,120,185,92,102,167,78
56043,478,259,219,79,139,41,53,112,54
56044,2032,1065,967,388,518,159,327,478,162
56045,696,357,339,90,172,95,85,152,102
56048,3929,2043,1886,641,1110,292,606,893,387
56050,1363,723,640,232,399,92,198,357,85
56051,801,409,392,116,194,99,96,178,118
56052,741,361,380,95,205,61,118,192,70
56054,1004,497,507,176,233,88,162,225,120
56055,3743,1913,1830,641,933,339,500,893,437
56056,128,75,53,23,31,21,16,25,12
56057,3791,1901,1890,680,918,303,596,850,444
56058,5946,2920,3026,989,1414,517,962,1397,667
56060,532,274,258,93,120,61,83,111,64
56062,3307,1647,1660,590,731,326,499,717,444
56063,2448,1252,1196,366,718,168,393,623,180
56064,130,54,76,22,19,13,33,33,10
56065,2784,1382,1402,466,657,259,397,645,360
56068,1041,549,492,165,265,119,107,243,142
56069,4372,2202,2170,763,1064,375,769,991,410
56071,8636,4216,4420,1526,2068,622,1571,2090,759
56072,2552,1315,1237,435,619,261,340,526,371
56073,17265,8521,8744,2861,4222,1438,2772,4063,1909
56074,1806,932,874,305,487,140,287,429,158
56075,147,79,68,19,33,27,9,37,22
56076,516,248,268,90,125,33,95,129,44
56078,508,268,240,89,140,39,80,114,46
56080,713,361,352,135,183,43,108,190,54
56081,6290,3114,3176,1060,1436,618,977,1372,827
56082,12277,6140,6137,2464,2891,785,2612,2450,1075
56083,1078,577,501,187,285,105,176,217,108
56085,6003,2943,3060,984,1370,589,932,1364,764
56087,3327,1593,1734,487,757,349,518,675,541
56088,2186,1043,1143,335,481,227,293,472,378
56089,213,111,102,32,62,17,27,52,23
56090,641,334,307,94,175,65,82,152,73
56091,398,209,189,57,106,46,56,84,49
56093,12943,6802,6141,2071,3834,897,1998,2942,1201
56096,3198,1599,1599,480,796,323,433,772,394
56097,4273,2091,2182,661,984,446,628,908,646
56098,2440,1214,1226,344,587,283,305,509,412
56101,5962,2836,3126,805,1393,638,810,1465,851
56110,1996,1005,991,371,442,192,287,444,260
56111,499,257,242,73,126,58,74,123,45
56113,305,145,160,34,77,34,52,70,38
56114,389,225,164,67,111,47,41,89,34
56115,1370,715,655,251,330,134,165,330,160
56116,681,362,319,120,179,63,92,157,70
56117,383,213,170,79,97,37,43,85,42
56118,473,272,201,111,124,37,61,113,27
56119,1112,562,550,184,262,116,152,265,133
56120,1253,668,585,213,321,134,173,279,133
56121,644,336,308,86,155,95,68,130,110
56122,679,366,313,134,172,60,88,137,88
56123,665,339,326,78,167,94,72,150,104
56127,515,278,237,95,145,38,77,107,53
56128,1990,971,1019,307,453,211,266,437,316
56129,824,403,421,119,203,81,114,167,140
56131,2431,1192,1239,383,537,272,374,505,360
56132,565,304,261,82,156,66,58,152,51
56134,411,207,204,75,93,39,83,80,41
56136,1209,553,656,173,215,165,175,222,259
56137,1329,670,659,186,343,141,198,267,194
56138,839,439,400,155,217,67,99,168,133
56139,523,281,242,80,125,76,58,108,76
56140,143,69,74,22,30,17,30,33,11
56141,411,192,219,58,101,33,76,96,47
56142,1185,601,584,181,265,155,110,255,219
56143,4842,2455,2387,754,1166,535,622,1076,689
56144,909,430,479,108,203,119,122,197,160
56145,618,313,305,79,160,74,65,140,100
56147,254,138,116,48,78,12,43,63,10
56149,1607,812,795,254,366,192,204,364,227
56150,2841,1403,1438,403,657,343,380,594,464
56151,861,447,414,122,228,97,112,213,89
56152,1577,789,788,229,348,212,176,331,281
56153,247,114,133,22,45,47,25,46,62
56155,485,238,247,71,118,49,83,96,68
56156,6398,3145,3253,1056,1344,745,881,1395,977
56157,649,351,298,112,183,56,89,165,44
56158,354,175,179,58,87,30,69,82,28
56159,3076,1503,1573,553,577,373,492,572,509
56160,276,123,153,32,62,29,53,58,42
56161,488,240,248,80,123,37,89,120,39
56162,283,130,153,48,65,17,50,69,34
56164,5953,2813,3140,929,1312,572,923,1306,911
56165,454,209,245,78,97,34,96,119,30
56166,255,124,131,29,59,36,26,70,35
56167,913,434,479,144,215,75,154,236,89
56168,1085,534,551,189,242,103,196,232,123
56169,805,401,404,136,206,59,142,183,79
56170,709,348,361,123,163,62,125,159,77
56171,1881,905,976,276,449,180,289,427,260
56172,3109,1459,1650,413,653,393,420,690,540
56173,417,223,194,69,110,44,66,82,46
56174,479,265,214,88,129,48,49,108,57
56175,3262,1494,1768,512,641,341,526,728,514
56176,1095,508,587,124,255,129,147,235,205
56177,108,55,53,17,29,9,16,24,13
56178,1842,901,941,257,429,215,252,378,311
56180,1056,524,532,130,247,147,121,233,178
56181,1205,610,595,193,283,134,185,268,142
56183,1509,703,806,196,305,202,194,294,318
56185,595,320,275,112,153,55,83,131,61
56186,443,232,211,78,104,50,72,87,52
56187,12661,6154,6507,1915,3144,1095,2020,2862,1625
56201,22131,10742,11389,3704,5394,1644,3643,5299,2447
56207,380,196,184,78,78,40,58,88,38
56208,3702,2485,1217,410,1685,390,287,488,442
56209,2539,1291,1248,408,673,210,353,643,252
56211,688,360,328,124,157,79,103,142,83
56212,701,389,312,140,159,90,77,139,96
56214,838,424,414,139,183,102,111,166,137
56215,4957,2400,2557,750,1148,502,695,1106,756
56216,847,433,414,171,198,64,154,206,54
56218,688,336,352,88,168,80,120,147,85
56219,1328,677,651,223,294,160,218,239,194
56220,3368,1712,1656,558,729,425,436,661,559
56221,1032,479,553,121,219,139,137,197,219
56222,2221,1089,1132,358,479,252,302,470,360
56223,1615,813,802,249,359,205,222,313,267
56224,375,204,171,65,100,39,62,79,30
56225,794,401,393,134,180,87,103,170,120
56226,281,151,130,58,73,20,51,58,21
56227,215,121,94,39,55,27,21,46,27
56228,1020,515,505,151,251,113,136,235,134
56229,1846,955,891,379,441,135,267,458,166
56230,1009,537,472,199,275,63,139,235,98
56231,465,243,222,89,128,26,70,122,30
56232,2521,1214,1307,359,563,292,361,552,394
56235,607,319,288,67,175,77,73,135,80
56236,464,241,223,80,96,65,70,92,61
56237,662,355,307,116,163,76,77,135,95
56239,561,270,291,99,135,36,121,134,36
56240,1131,509,622,151,218,140,197,219,206
56241,4318,2082,2236,673,971,438,573,1037,626
56243,1794,906,888,324,439,143,321,394,173
56244,1395,739,656,271,370,98,190,334,132
56245,552,305,247,119,143,43,91,108,48
56246,453,229,224,93,100,36,96,97,31
56248,919,458,461,121,219,118,133,215,113
56249,381,204,177,59,88,57,51,74,52
56251,901,460,441,167,229,64,150,220,71
56252,1271,640,631,230,284,126,187,294,150
56253,1119,566,553,172,273,121,172,254,127
56255,466,238,228,72,119,47,80,98,50
56256,2948,1434,1514,425,618,391,358,601,555
56257,533,250,283,46,127,77,72,126,85
56258,14866,7249,7617,2636,3697,916,2757,3497,1363
56260,990,486,504,174,221,91,164,242,98
56262,754,392,362,122,181,89,94,159,109
56263,563,317,246,109,156,52,70,120,56
56264,2395,1177,1218,383,549,245,366,524,328
56265,8000,3864,4136,1243,1863,758,1150,1844,1142
56266,1722,819,903,241,360,218,268,374,261
56267,6759,3184,3575,1226,1474,484,1503,1333,739
56270,1077,582,495,226,267,89,157,264,74
56271,1354,700,654,233,340,127,228,296,130
56273,4123,2091,2032,685,1053,353,567,1027,438
56274,203,103,100,28,45,30,28,43,29
56276,287,161,126,50,69,42,21,62,43
56277,3318,1645,1673,518,798,329,481,734,458
56278,2897,1375,1522,400,565,410,386,636,500
56279,1185,631,554,230,313,88,195,288,71
56280,577,311,266,95,156,60,85,128,53
56281,609,304,305,90,130,84,97,120,88
56282,1638,822,816,306,389,127,282,394,140
56283,7162,3524,3638,1167,1737,620,1033,1695,910
56284,2229,1095,1134,367,481,247,319,475,340
56285,1154,591,563,200,278,113,169,249,145
56287,68,36,32,4,16,16,1,15,16
56288,4667,2329,2338,678,1189,462,693,1136,509
56289,639,327,312,78,167,82,90,144,78
56291,505,269,236,77,112,80,59,90,87
56292,653,323,330,111,138,74,121,130,79
56293,1241,604,637,200,277,127,189,266,182
56294,112,54,58,14,34,6,16,23,19
56295,316,165,151,51,92,22,58,68,25
56296,2332,1128,1204,333,460,335,297,451,456
56297,831,415,416,132,193,90,126,190,100
56301,28961,14698,14263,5842,7604,1252,6085,6609,1569
56303,23633,11792,11841,3751,6454,1587,3600,6233,2008
56304,15674,8041,7633,2604,4533,904,2401,3816,1416
56307,4197,2109,2088,804,976,329,690,972,426
56308,21758,10713,11045,3453,5155,2105,2986,5202,2857
56309,1182,560,622,140,268,152,154,268,200
56310,4993,2556,2437,865,1336,355,878,1232,327
56311,785,361,424,96,162,103,111,170,143
56312,2628,1308,1320,438,625,245,430,562,328
56313,56,27,29,7,14,6,7,13,9
56314,1059,558,501,196,281,81,159,262,80
56315,1538,759,779,233,373,153,263,369,147
56316,1460,745,715,258,351,136,242,315,158
56318,1101,563,538,164,277,122,175,258,105
56319,1127,584,543,157,308,119,165,266,112
56320,7896,4006,3890,1447,1932,627,1274,1888,728
56323,609,291,318,80,134,77,95,139,84
56324,1044,529,515,175,251,103,153,241,121
56325,139,75,64,20,30,25,17,30,17
56326,1371,680,691,211,321,148,191,290,210
56327,780,393,387,138,204,51,132,198,57
56328,160,69,91,28,35,6,30,45,16
56329,6332,3279,3053,1198,1603,478,1028,1439,586
56330,1370,732,638,257,377,98,217,343,78
56331,1863,986,877,389,447,150,304,392,181
56332,1227,620,607,221,317,82,213,303,91
56334,5336,2593,2743,764,1201,628,666,1190,887
56335,169,92,77,20,51,21,21,30,26
56336,1706,896,810,279,443,174,264,363,183
56338,1581,863,718,289,398,176,229,353,136
56339,1129,566,563,182,244,140,147,235,181
56340,2133,1102,1031,391,519,192,364,478,189
56342,2779,1388,1391,334,620,434,307,655,429
56343,892,483,409,149,223,111,106,187,116
56345,14693,7241,7452,2396,3554,1291,2247,3387,1818
56347,6552,3210,3342,1095,1544,571,1152,1431,759
56349,711,381,330,124,189,68,111,155,64
56350,334,186,148,51,98,37,42,70,36
56352,5568,2781,2787,1004,1271,506,925,1217,645
56353,7271,3624,3647,1197,1812,615,1152,1668,827
56354,1111,599,512,174,264,161,111,232,169
56355,491,262,229,70,157,35,85,104,40
56356,36,7,29,0,7,0,10,5,14
56357,797,400,397,121,219,60,143,196,58
56358,3060,1566,1494,546,794,226,515,754,225
56359,3480,1753,1727,654,753,346,530,809,388
56360,3774,1905,1869,589,853,463,518,810,541
56361,2475,1260,1215,392,594,274,363,523,329
56362,5696,2883,2813,982,1338,563,836,1234,743
56364,5314,2714,2600,974,1277,463,919,1147,534
56367,5512,2913,2599,1083,1560,270,929,1398,272
56368,3704,1946,1758,568,1009,369,501,909,348
56369,438,234,204,89,121,24,85,91,28
56371,108,57,51,22,31,4,20,22,9
56373,2526,1332,1194,497,675,160,414,602,178
56374,9944,4867,5077,2471,1973,423,2508,1981,588
56375,833,440,393,159,234,47,138,207,48
56376,171,77,94,25,30,22,41,30,23
56377,12755,6229,6526,2403,3244,582,2296,3383,847
56378,7203,3572,3631,1176,1679,717,1134,1613,884
56379,12671,6214,6457,2187,3305,722,2004,3386,1067
56381,2725,1308,1417,403,590,315,365,582,470
56382,1481,758,723,287,372,99,238,346,139
56384,375,175,200,69,80,26,70,78,52
56385,1043,526,517,192,243,91,182,242,93
56386,894,466,428,121,213,132,125,203,100
56387,6620,3162,3458,855,1875,432,1124,1651,683
56401,27594,13502,14092,4488,6858,2156,4282,6816,2994
56425,5677,2764,2913,1039,1425,300,957,1536,420
56431,8354,4149,4205,1104,1857,1188,945,1851,1409
56433,1503,770,733,186,375,209,178,373,182
56434,88,45,43,14,27,4,15,21,7
56435,2726,1426,1300,442,656,328,331,599,370
56436,292,150,142,52,71,27,50,79,13
56437,1250,627,623,244,259,124,215,279,129
56438,2739,1369,1370,462,656,251,419,613,338
56440,1324,628,696,217,279,132,208,272,216
56441,3396,1645,1751,537,727,381,502,736,513
56442,2097,1076,1021,186,437,453,153,450,418
56443,1429,759,670,192,348,219,166,307,197
56444,3599,1786,1813,456,832,498,472,808,533
56446,1661,841,820,263,401,177,254,368,198
56447,1007,501,506,138,231,132,117,224,165
56448,363,198,165,26,64,108,16,66,83
56449,1438,768,670,251,354,163,214,338,118
56450,933,449,484,90,187,172,128,193,163
56452,1827,908,919,168,396,344,162,410,347
56453,868,438,430,137,210,91,133,204,93
56455,560,248,312,74,112,62,92,130,90
56456,222,123,99,42,69,12,26,59,14
56458,304,160,144,49,70,41,36,72,36
56461,2700,1390,1310,445,702,243,413,651,246
56464,3978,2005,1973,613,900,492,604,830,539
56465,1725,905,820,265,444,196,234,395,191
56466,2800,1390,1410,459,640,291,453,645,312
56467,2216,1138,1078,298,507,333,265,496,317
56468,4541,2355,2186,578,1211,566,490,1146,550
56469,1000,523,477,134,217,172,111,213,153
56470,9652,4776,4876,1493,2147,1136,1289,2197,1390
56472,5100,2460,2640,649,1188,623,756,1189,695
56473,2357,1194,1163,385,616,193,340,613,210
56474,3878,1879,1999,578,880,421,599,849,551
56475,1592,796,796,256,398,142,323,340,133
56477,2795,1408,1387,405,706,297,422,664,301
56479,5352,2667,2685,969,1183,515,780,1270,635
56481,2078,1063,1015,357,500,206,350,466,199
56482,7038,3498,3540,1230,1596,672,1058,1500,982
56484,3597,1820,1777,517,828,475,438,864,475
56501,15099,7344,7755,2274,3589,1481,2161,3572,2022
56510,2337,1116,1221,346,536,234,310,536,375
56511,1603,838,765,261,426,151,218,396,151
56513,180,91,89,28,44,19,29,40,20
56514,3213,1597,1616,505,757,335,454,758,404
56515,2682,1292,1390,311,555,426,280,591,519
56516,345,175,170,64,82,29,67,79,24
56517,303,152,151,43,76,33,42,74,35
56518,330,181,149,70,77,34,62,61,26
56519,338,187,151,43,97,47,59,70,22
56520,4157,1972,2185,621,995,356,624,1017,544
56521,871,418,453,131,223,64,190,196,67
56522,715,378,337,124,170,84,102,150,85
56523,573,274,299,90,132,52,90,135,74
56524,740,382,358,105,169,108,99,169,90
56525,138,76,62,22,35,19,14,25,23
56527,791,400,391,125,203,72,108,197,86
56528,1650,863,787,248,386,229,214,368,205
56529,3042,1456,1586,537,746,173,581,759,246
56531,2204,1056,1148,315,492,249,339,495,314
56533,312,165,147,61,86,18,48,74,25
56534,1096,567,529,153,274,140,158,257,114
56535,1308,626,682,178,255,193,151,258,273
56536,572,284,288,75,159,50,100,140,48
56537,19021,9204,9817,2991,4421,1792,2908,4276,2633
56540,1986,985,1001,300,431,254,249,407,345
56542,2846,1353,1493,427,598,328,402,586,505
56543,308,158,150,48,83,27,56,68,26
56544,4719,2347,2372,766,1150,431,773,1084,515
56545,816,450,366,150,199,101,103,185,78
56546,372,191,181,60,96,35,57,87,37
56547,2362,1207,1155,419,644,144,415,619,121
56548,879,413,466,116,189,108,117,198,151
56549,4120,2118,2002,720,1047,351,602,982,418
56550,447,232,215,83,122,27,66,116,33
56551,2403,1192,1211,326,541,325,274,516,421
56552,461,243,218,96,106,41,70,110,38
56553,355,202,153,84,95,23,51,79,23
56554,2489,1289,1200,381,598,310,326,572,302
56556,1210,628,582,157,289,182,144,265,173
56557,2837,1373,1464,485,597,291,455,613,396
56560,34987,16540,18447,6685,7694,2161,7169,8022,3256
56565,143,54,89,15,32,7,44,39,6
56566,361,200,161,89,78,33,77,58,26
56567,3260,1634,1626,558,701,375,480,724,422
56568,156,84,72,17,34,33,23,33,16
56569,1456,771,685,325,326,120,276,294,115
56570,1282,668,614,189,343,136,152,302,160
56571,1669,863,806,240,400,223,214,376,216
56572,5684,2919,2765,939,1401,579,781,1285,699
56573,5680,2834,2846,969,1322,543,863,1254,729
56574,354,188,166,63,107,18,55,89,22
56575,638,325,313,138,111,76,116,129,68
56576,903,475,428,110,224,141,82,211,135
56578,886,464,422,146,230,88,112,218,92
56579,1187,597,590,189,304,104,187,287,116
56580,905,443,462,142,248,53,167,233,62
56581,350,165,185,50,83,32,62,77,46
56583,180,96,84,29,49,18,23,35,26
56584,1727,835,892,258,347,230,268,337,287
56585,1043,537,506,169,222,146,151,198,157
56586,1765,934,831,298,403,233,188,427,216
56587,1298,686,612,196,320,170,124,310,178
56588,454,246,208,60,105,81,46,86,76
56589,1886,961,925,319,425,217,327,416,182
56590,391,214,177,67,104,43,47,85,45
56592,454,240,214,80,104,56,61,107,46
56594,501,241,260,68,115,58,86,116,58
56601,28537,14080,14457,5196,6968,1916,4948,7086,2423
56621,4337,2123,2214,682,1022,419,727,982,505
56623,3363,1634,1729,422,862,350,483,804,442
56626,444,237,207,80,96,61,75,102,30
56627,361,193,168,42,95,56,37,90,41
56628,1687,850,837,177,388,285,195,363,279
56629,28,16,12,2,7,7,2,6,4
56630,2185,1058,1127,340,478,240,344,482,301
56633,4284,2090,2194,934,871,285,881,982,331
56634,1564,754,810,217,351,186,179,364,267
56636,4836,2391,2445,858,1071,462,857,1059,529
56637,289,150,139,50,72,28,39,74,26
56639,428,213,215,39,104,70,59,101,55
56641,312,163,149,62,61,40,47,59,43
56644,774,415,359,122,206,87,107,161,91
56646,359,195,164,48,95,52,41,81,42
56647,716,386,330,136,177,73,95,187,48
56649,10749,5323,5426,1652,2594,1077,1442,2500,1484
56650,836,447,389,154,189,104,119,163,107
56651,526,262,264,73,116,73,72,119,73
56652,574,341,233,119,135,87,58,118,57
56653,1395,714,681,211,363,140,197,326,158
56654,149,71,78,19,36,16,29,25,24
56655,1415,730,685,137,309,284,113,307,265
56657,274,129,145,14,58,57,18,69,58
56659,174,96,78,40,37,19,19,35,24
56660,315,154,161,54,67,33,33,99,29
56661,1039,514,525,158,211,145,148,204,173
56662,449,263,186,42,122,99,19,98,69
56663,155,89,66,11,48,30,6,41,19
56666,1050,510,540,299,178,33,325,191,24
56667,684,370,314,123,181,66,87,168,59
56669,315,148,167,19,88,41,6,118,43
56670,2103,1007,1096,593,360,54,559,454,83
56671,1906,900,1006,466,371,63,496,430,80
56672,2025,987,1038,214,434,339,265,445,328
56673,843,417,426,121,224,72,168,193,65
56676,1733,875,858,284,422,169,249,427,182
56678,779,407,372,154,204,49,131,184,57
56680,97,53,44,16,18,19,11,23,10
56681,290,152,138,46,65,41,40,62,36
56683,557,269,288,84,130,55,91,138,59
56684,427,238,189,85,107,46,50,100,39
56685,134,74,60,12,23,39,8,25,27
56686,936,485,451,118,254,113,96,232,123
56687,138,62,76,22,33,7,33,29,14
56688,121,72,49,21,26,25,9,25,15
56701,12362,5969,6393,1955,3000,1014,1864,3070,1459
56710,497,232,265,72,111,49,95,118,52
56711,121,75,46,31,44,0,8,38,0
56712,330,174,156,67,83,24,49,74,33
56713,1029,543,486,175,235,133,139,223,124
56714,1446,771,675,248,392,131,224,332,119
56715,399,205,194,58,106,41,72,84,38
56716,9910,4674,5236,1672,2186,816,1702,2275,1259
56720,87,44,43,15,18,11,19,20,4
56721,9026,4554,4472,1734,2230,590,1477,2179,816
56722,410,208,202,60,102,46,59,96,47
56723,1259,639,620,225,327,87,212,301,107
56724,201,119,82,11,66,42,14,39,29
56725,918,491,427,144,265,82,125,203,99
56726,1756,913,843,293,456,164,219,387,237
56727,766,388,378,110,177,101,105,155,118
56728,1601,764,837,224,358,182,231,321,285
56729,209,107,102,23,57,27,32,54,16
56731,98,51,47,14,26,11,15,22,10
56732,1222,590,632,178,256,156,150,270,212
56733,605,310,295,78,159,73,75,134,86
56734,572,299,273,92,131,76,65,129,79
56735,847,437,410,142,183,112,129,175,106
56736,852,422,430,97,218,107,106,201,123
56737,887,432,455,126,225,81,122,224,109
56738,1309,696,613,216,361,119,169,308,136
56741,25,12,13,0,12,0,0,13,0
56742,781,418,363,144,184,90,101,167,95
56744,568,295,273,96,146,53,81,121,71
56748,657,335,322,106,153,76,98,143,81
56750,2671,1332,1339,426,633,273,398,587,354
56751,5786,2946,2840,1000,1469,477,815,1423,602
56754,507,263,244,94,138,31,74,147,23
56755,179,102,77,34,51,17,24,32,21
56756,869,427,442,147,251,29,192,228,22
56757,1095,563,532,185,273,105,142,227,163
56758,403,222,181,77,108,37,46,87,48
56759,269,142,127,39,71,32,35,68,24
56760,409,216,193,66,105,45,68,85,40
56761,556,304,252,108,135,61,64,135,53
56762,2352,1145,1207,333,540,272,285,523,399
56763,5268,2753,2515,1056,1409,288,934,1256,325
57001,2155,1064,1091,346,489,229,317,461,313
57002,900,474,426,154,264,56,136,253,37
57003,1587,792,795,270,427,95,275,411,109
57004,3346,1611,1735,498,768,345,541,737,457
57005,7077,3554,3523,1367,1859,328,1291,1889,343
57006,21178,10661,10517,4385,5164,1112,4386,4620,1511
57010,445,267,178,100,131,36,36,126,16
57012,1152,568,584,200,249,119,174,248,162
57013,4265,2098,2167,696,1034,368,632,964,571
57014,1631,787,844,223,392,172,235,360,249
57015,788,409,379,144,199,66,120,183,76
57016,706,358,348,107,185,66,105,184,59
57017,1322,664,658,221,345,98,230,320,108
57018,1396,685,711,222,358,105,238,332,141
57020,1148,583,565,267,293,23,207,325,33
57021,305,163,142,54,82,27,31,80,31
57022,4220,2088,2132,720,993,375,696,949,487
57024,418,221,197,70,124,27,69,95,33
57025,2666,1322,1344,397,683,242,429,621,294
57026,1359,705,654,234,335,136,229,304,121
57027,37,21,16,11,4,6,7,3,6
57028,3496,1723,1773,592,811,320,555,795,423
57029,2333,1124,1209,341,515,268,316,487,406
57030,2656,1330,1326,439,704,187,408,660,258
57031,683,318,365,122,147,49,121,174,70
57032,2542,1341,1201,513,722,106,409,684,108
57033,3966,2019,1947,779,1017,223,697,1029,221
57034,901,461,440,151,248,62,155,181,104
57035,1057,519,538,170,268,81,172,260,106
57036,817,401,416,99,216,86,113,198,105
57037,1088,569,519,205,248,116,144,223,152
57038,1151,578,573,190,300,88,188,294,91
57039,3302,1621,1681,573,811,237,497,833,351
57040,510,261,249,93,107,61,74,109,66
57041,107,59,48,24,35,0,12,31,5
57042,8372,4099,4273,1499,1856,744,1368,1899,1006
57043,1524,766,758,247,340,179,208,310,240
57044,203,92,111,29,49,14,24,62,25
57045,1163,593,570,167,230,196,115,210,245
57046,658,385,273,116,205,64,59,168,46
57047,269,147,122,47,78,22,39,60,23
57048,961,474,487,166,222,86,164,211,112
57049,4492,2334,2158,767,1292,275,646,1268,244
57050,209,108,101,37,42,29,30,44,27
57051,402,210,192,66,81,63,54,64,74
57052,400,204,196,63,112,29,56,106,34
57053,1942,967,975,282,499,186,279,469,227
57054,510,272,238,83,120,69,77,88,73
57055,1184,648,536,244,345,59,178,332,26
57057,152,85,67,36,40,9,26,35,6
57058,2004,990,1014,322,436,232,303,422,289
57059,1684,857,827,318,343,196,212,330,285
57061,151,94,57,32,47,15,12,32,13
57062,2042,1385,657,271,955,159,202,278,177
57063,907,444,463,130,217,97,133,220,110
57064,2585,1306,1279,521,708,77,465,746,68
57065,439,232,207,76,118,38,57,92,58
57066,1823,884,939,281,388,215,250,376,313
57067,552,294,258,119,147,28,92,142,24
57068,1608,874,734,336,453,85,260,383,91
57069,11366,5452,5914,2120,2806,526,2546,2631,737
57070,1410,662,748,194,304,164,194,293,261
57071,2416,1237,1179,380,650,207,367,611,201
57072,639,351,288,136,170,45,97,147,44
57073,762,399,363,148,171,80,100,157,106
57074,78,32,46,8,17,7,7,28,11
57075,799,444,355,156,225,63,107,195,53
57076,563,269,294,80,126,63,104,124,66
57077,1025,515,510,151,294,70,171,253,86
57078,18028,9046,8982,2681,4952,1413,2733,4310,1939
57103,33062,16350,16712,5804,8760,1786,5331,8991,2390
57104,26067,13678,12389,3898,8298,1482,3496,6486,2407
57105,24290,11339,12951,3566,5561,2212,3680,6157,3114
57106,28016,13534,14482,4598,7667,1269,4418,8252,1812
57107,5086,2566,2520,776,1487,303,857,1388,275
57108,6260,3068,3192,1037,1712,319,1023,1828,341
57110,8266,4043,4223,1525,2190,328,1455,2433,335
57201,23610,11675,11935,4016,5857,1802,3800,5607,2528
57212,1998,973,1025,271,458,244,257,433,335
57213,489,252,237,59,128,65,64,114,59
57214,147,61,86,18,25,18,27,28,31
57216,1176,601,575,180,291,130,147,265,163
57217,301,149,152,36,42,71,28,46,78
57218,355,188,167,61,90,37,55,74,38
57219,648,303,345,72,159,72,88,138,119
57220,856,455,401,139,246,70,112,208,81
57221,817,402,415,170,155,77,137,151,127
57223,1450,742,708,277,361,104,238,341,129
57224,251,135,116,40,72,23,28,64,24
57225,1799,861,938,246,380,235,242,385,311
57226,2016,969,1047,301,446,222,282,454,311
57227,269,162,107,58,54,50,23,57,27
57231,1836,901,935,235,425,241,244,360,331
57232,428,234,194,76,99,59,64,85,45
57233,168,87,81,26,31,30,23,33,25
57234,1293,627,666,180,277,170,185,278,203
57235,796,405,391,140,220,45,136,195,60
57236,408,193,215,68,109,16,87,107,21
57237,648,331,317,75,150,106,81,134,102
57238,548,307,241,133,132,42,76,105,60
57239,266,150,116,47,67,36,22,58,36
57241,876,439,437,191,197,51,193,181,63
57242,361,197,164,52,81,64,47,65,52
57243,598,312,286,104,161,47,93,150,43
57244,134,61,73,14,41,6,30,39,4
57245,93,45,48,23,19,3,15,28,5
57246,199,106,93,35,50,21,30,47,16
57247,274,155,119,43,70,42,31,52,36
57248,812,383,429,132,176,75,161,146,122
57249,1133,568,565,169,271,128,141,243,181
57251,165,94,71,16,45,33,26,28,17
57252,5072,2444,2628,778,1160,506,735,1176,717
57255,587,307,280,92,151,64,84,139,57
57256,72,35,37,5,22,8,13,15,9
57257,863,418,445,196,163,59,222,178,45
57258,218,118,100,38,51,29,28,55,17
57259,578,303,275,87,162,54,81,146,48
57260,951,453,498,127,203,123,125,189,184
57261,468,235,233,57,107,71,80,90,63
57262,4666,2247,2419,823,1047,377,851,1049,519
57263,539,277,262,68,159,50,84,109,69
57264,204,102,102,29,53,20,25,49,28
57265,235,126,109,33,56,37,37,42,30
57266,647,339,308,118,159,62,109,125,74
57268,416,214,202,65,88,61,56,85,61
57269,399,205,194,63,83,59,50,101,43
57270,630,308,322,116,103,89,93,138,91
57271,442,215,227,88,88,39,87,84,56
57272,204,112,92,25,55,32,22,41,29
57273,1336,625,711,231,270,124,246,280,185
57274,2987,1480,1507,412,704,364,385,634,488
57276,1203,592,611,192,309,91,199,285,127
57278,699,358,341,129,155,74,100,136,105
57279,1229,582,647,167,274,141,188,260,199
57301,17308,8318,8990,2976,3998,1344,2806,4070,2114
57311,1509,745,764,265,363,117,279,357,128
57312,539,272,267,73,139,60,78,126,63
57313,1212,594,618,171,274,149,133,270,215
57314,671,338,333,106,172,60,100,143,90
57315,1076,555,521,181,239,135,130,219,172
57317,721,369,352,130,154,85,96,145,111
57319,1234,614,620,189,282,143,166,242,212
57321,557,283,274,98,131,54,90,125,59
57322,327,172,155,51,80,41,45,81,29
57323,335,185,150,57,84,44,31,63,56
57324,385,194,191,50,113,31,53,103,35
57325,3158,1524,1634,568,692,264,543,717,374
57328,1306,645,661,209,270,166,200,233,228
57329,259,147,112,56,73,18,28,57,27
57330,767,379,388,141,175,63,155,166,67
57331,477,236,241,64,130,42,89,101,51
57332,855,433,422,140,181,112,119,174,129
57334,902,433,469,150,208,75,173,202,94
57335,287,140,147,43,60,37,46,47,54
57337,200,97,103,27,37,33,36,37,30
57339,1505,783,722,429,305,49,345,310,67
57340,299,170,129,57,82,31,35,65,29
57341,169,88,81,26,43,19,24,32,25
57342,666,348,318,113,157,78,94,118,106
57344,216,113,103,47,46,20,31,52,20
57345,1369,675,694,197,306,172,184,267,243
57346,126,79,47,36,30,13,14,23,10
57348,541,285,256,72,145,68,81,119,56
57349,1771,866,905,258,398,210,250,369,286
57350,14045,6858,7187,2208,3260,1390,2006,3180,2001
57353,929,469,460,171,210,88,178,192,90
57355,1380,698,682,230,308,160,208,277,197
57356,1981,951,1030,385,417,149,443,401,186
57358,45,25,20,3,20,2,1,11,8
57359,931,478,453,183,209,86,167,186,100
57361,318,155,163,89,57,9,85,63,15
57362,2187,1048,1139,282,459,307,237,425,477
57363,1131,594,537,213,291,90,180,268,89
57364,62,35,27,12,12,11,0,9,18
57365,475,254,221,89,139,26,65,120,36
57366,2526,1226,1300,386,524,316,348,518,434
57367,187,100,87,27,46,27,20,48,19
57368,1214,674,540,270,278,126,149,264,127
57369,2741,1339,1402,470,581,288,432,589,381
57370,795,389,406,161,175,53,164,182,60
57371,320,185,135,62,67,56,23,67,45
57373,505,256,249,100,112,44,84,104,61
57374,413,191,222,58,86,47,83,99,40
57375,764,372,392,107,175,90,121,166,105
57376,1209,581,628,152,258,171,135,238,255
57379,90,50,40,11,26,13,10,20,10
57380,3362,1595,1767,635,670,290,617,713,437
57381,670,327,343,80,159,88,104,158,81
57382,1680,811,869,221,351,239,189,348,332
57383,799,391,408,115,142,134,111,148,149
57384,906,471,435,143,216,112,114,215,106
57385,1480,760,720,217,346,197,183,335,202
57386,242,118,124,47,52,19,53,46,25
57401,28909,13789,15120,4365,7039,2385,4616,7009,3495
57420,97,53,44,8,29,16,14,16,14
57421,138,79,59,35,32,12,18,37,4
57422,302,157,145,39,69,49,41,64,40
57424,366,166,200,39,90,37,79,93,28
57426,76,43,33,19,22,2,10,21,2
57427,523,267,256,68,144,55,90,121,45
57428,821,391,430,102,146,143,98,169,163
57430,2420,1162,1258,356,531,275,356,514,388
57432,484,237,247,79,98,60,73,109,65
57433,410,205,205,40,110,55,38,111,56
57434,596,322,274,100,150,72,71,129,74
57435,301,155,146,41,61,53,28,81,37
57436,729,359,370,127,163,69,125,168,77
57437,1773,854,919,195,360,299,205,324,390
57438,1689,819,870,282,354,183,281,330,259
57440,661,326,335,114,152,60,126,144,65
57441,661,339,322,108,165,66,95,165,62
57442,1684,824,860,224,371,229,220,356,284
57445,1939,924,1015,287,442,195,316,439,260
57446,599,302,297,103,140,59,84,128,85
57448,435,194,241,52,89,53,49,88,104
57449,204,121,83,31,70,20,22,46,15
57450,928,456,472,130,210,116,127,214,131
57451,1570,760,810,296,293,171,241,333,236
57452,345,181,164,45,77,59,40,60,64
57454,570,287,283,69,150,68,62,131,90
57455,168,98,70,27,37,34,11,33,26
57456,990,501,489,152,218,131,119,220,150
57457,115,51,64,8,27,16,16,24,24
57460,378,208,170,67,104,37,56,91,23
57461,483,264,219,100,119,45,85,96,38
57462,741,372,369,100,215,57,94,209,66
57465,350,189,161,62,79,48,59,67,35
57466,191,102,89,40,44,18,20,45,24
57467,328,175,153,56,74,45,56,67,30
57468,260,139,121,37,66,36,26,45,50
57469,3862,2019,1843,595,978,446,454,759,630
57470,189,97,92,29,42,26,31,28,33
57471,686,345,341,94,153,98,122,134,85
57472,1135,566,569,169,242,155,133,239,197
57473,165,87,78,16,40,31,13,37,28
57474,363,199,164,82,93,24,61,86,17
57475,166,82,84,10,28,44,18,33,33
57476,456,236,220,83,101,52,58,102,60
57477,160,81,79,19,40,22,23,31,25
57479,616,325,291,133,163,29,97,153,41
57481,696,361,335,131,155,75,111,160,64
57501,15670,7410,8260,2423,3865,1122,2564,4084,1612
57520,154,73,81,17,27,29,17,33,31
57521,176,69,107,13,48,8,44,48,15
57522,483,249,234,72,124,53,66,101,67
57523,1136,544,592,153,249,142,161,221,210
57526,181,93,88,44,36,13,28,41,19
57528,863,416,447,135,184,97,124,218,105
57529,611,322,289,99,187,36,90,155,44
57531,271,139,132,36,79,24,43,63,26
57532,2692,1361,1331,456,720,185,387,730,214
57533,2012,977,1035,290,426,261,245,394,396
57534,178,102,76,25,61,16,31,39,6
57536,614,284,330,75,159,50,130,124,76
57537,133,66,67,15,30,21,26,33,8
57538,291,139,152,40,48,51,53,48,51
57540,137,74,63,11,42,21,17,26,20
57541,176,85,91,33,37,15,37,30,24
57542,111,57,54,10,27,20,19,26,9
57543,901,445,456,156,188,101,118,185,153
57544,471,249,222,90,115,44,68,115,39
57547,145,64,81,9,34,21,26,37,18
57548,1221,602,619,309,247,46,314,268,37
57551,2421,1178,1243,464,520,194,458,519,266
57552,574,293,281,85,137,71,84,127,70
57553,171,86,85,31,38,17,26,40,19
57555,3648,1811,1837,868,766,177,800,876,161
57559,841,422,419,128,201,93,120,187,112
57560,457,222,235,96,104,22,118,89,28
57562,65,33,32,10,17,6,15,13,4
57563,182,106,76,25,69,12,31,37,8
57564,1129,582,547,175,277,130,175,252,120
57566,1104,465,639,255,195,15,348,211,80
57567,1597,772,825,243,365,164,256,360,209
57568,757,380,377,106,183,91,98,152,127
57569,534,269,265,75,122,72,76,114,75
57570,2100,1012,1088,559,411,42,570,470,48
57571,51,29,22,3,15,11,5,11,6
57572,1880,934,946,488,361,85,468,388,90
57574,187,76,111,15,50,11,44,62,5
57576,267,155,112,39,83,33,33,56,23
57577,1052,544,508,303,201,40,273,195,40
57578,47,22,25,4,5,13,5,12,8
57579,1313,674,639,260,287,127,239,265,135
57580,4717,2320,2397,844,996,480,685,1019,693
57584,144,64,80,18,26,20,25,23,32
57585,239,117,122,39,52,26,31,62,29
57601,4187,1980,2207,646,846,488,603,960,644
57620,557,299,258,95,138,66,65,116,77
57621,367,170,197,83,72,15,105,74,18
57622,365,214,151,125,83,6,76,69,6
57623,932,431,501,183,190,58,242,196,63
57625,4089,2016,2073,1027,851,138,1010,863,200
57626,1060,522,538,178,237,107,180,243,115
57628,91,46,45,17,21,8,17,17,11
57631,370,190,180,53,99,38,50,93,37
57632,673,327,346,105,139,83,84,128,134
57633,587,285,302,87,137,61,105,125,72
57634,121,53,68,13,25,15,20,33,15
57636,111,75,36,15,50,10,5,27,4
57638,2080,991,1089,263,469,259,283,451,355
57640,238,119,119,21,67,31,28,51,40
57641,336,160,176,37,87,36,63,64,49
57642,2223,1113,1110,506,468,139,490,470,150
57644,294,151,143,48,67,36,43,61,39
57645,188,110,78,38,49,23,28,35,15
57646,257,128,129,22,65,41,35,51,43
57648,457,224,233,72,91,61,60,82,91
57649,247,113,134,28,56,29,53,55,26
57650,56,36,20,6,16,14,2,14,4
57651,172,76,96,36,31,9,47,35,14
57652,460,183,277,97,72,14,125,114,38
57653,198,100,98,30,39,31,34,44,20
57656,959,459,500,185,199,75,202,224,74
57657,117,56,61,8,34,14,19,26,16
57658,491,252,239,125,115,12,123,88,28
57660,61,38,23,22,11,5,4,13,6
57661,235,107,128,50,45,12,66,57,5
57701,39526,19573,19953,7049,10088,2436,6583,10074,3296
57702,29418,14482,14936,4514,7565,2403,4010,7843,3083
57703,10603,5325,5278,1946,2802,577,1858,2827,593
57706,4591,2460,2131,1183,1270,7,1054,1064,13
57714,862,445,417,239,192,14,223,171,23
57716,414,205,209,66,119,20,89,88,32
57717,6731,3325,3406,1165,1603,557,1065,1613,728
57718,4864,2455,2409,907,1306,242,775,1362,272
57719,4100,2115,1985,851,1102,162,733,1091,161
57720,645,321,324,101,163,57,98,145,81
57722,459,202,257,59,108,35,105,107,45
57724,235,153,82,74,65,14,21,45,16
57725,116,63,53,7,31,25,3,20,30
57729,96,46,50,7,29,10,19,20,11
57730,4910,2543,2367,796,1166,581,558,1142,667
57732,2245,1108,1137,330,608,170,267,627,243
57735,1373,710,663,185,331,194,141,321,201
57736,128,76,52,42,20,14,22,17,13
57737,49,20,29,0,13,7,7,16,6
57738,178,73,105,8,34,31,37,44,24
57742,163,94,69,32,42,20,20,37,12
57744,1724,916,808,314,461,141,210,477,121
57745,1847,899,948,298,449,152,303,492,153
57747,5781,3065,2716,870,1312,883,653,1311,752
57748,388,183,205,100,65,18,90,91,24
57750,332,173,159,61,89,23,50,85,24
57751,704,351,353,120,157,74,112,168,73
57752,2166,1139,1027,520,510,109,526,426,75
57754,3682,1923,1759,643,980,300,493,933,333
57755,129,52,77,7,37,8,34,31,12
57756,709,372,337,190,142,40,166,149,22
57758,110,63,47,21,19,23,14,15,18
57759,523,284,239,166,86,32,127,79,33
57760,1336,647,689,204,302,141,212,322,155
57761,1142,568,574,190,264,114,168,246,160
57762,535,269,266,101,125,43,97,128,41
57763,310,153,157,21,68,64,26,66,65
57764,1738,830,908,524,268,38,494,346,68
57765,90,52,38,24,24,4,13,20,5
57766,264,128,136,35,79,14,32,72,32
57767,98,50,48,7,41,2,9,34,5
57769,3270,1573,1697,494,882,197,649,877,171
57770,5355,2696,2659,1530,944,222,1337,1141,181
57772,1446,739,707,346,361,32,370,293,44
57773,271,158,113,54,74,30,25,61,27
57774,101,49,52,21,21,7,21,23,8
57775,259,143,116,64,58,21,34,57,25
57777,147,88,59,21,45,22,11,30,18
57778,75,34,41,4,24,6,17,18,6
57779,127,73,54,27,39,7,11,38,5
57780,184,93,91,38,34,21,33,38,20
57783,12939,6149,6790,2022,3120,1007,2250,3056,1484
57785,9209,4445,4764,1322,2238,885,1360,2307,1097
57787,294,182,112,82,71,29,30,77,5
57788,635,362,273,110,200,52,73,132,68
57790,1039,492,547,140,244,108,161,244,142
57791,115,53,62,18,23,12,18,26,18
57792,95,55,40,12,27,16,11,18,11
57793,1676,882,794,335,423,124,280,397,117
57794,508,269,239,138,123,8,126,107,6
57799,34,18,16,5,13,0,6,10,0
58001,290,151,139,57,77,17,52,59,28
58004,317,181,136,61,87,33,39,72,25
58005,447,240,207,63,134,43,60,118,29
58006,553,263,290,81,113,69,102,107,81
58007,170,88,82,26,46,16,23,36,23
58008,269,128,141,47,52,29,60,50,31
58009,74,34,40,10,13,11,5,24,11
58011,418,226,192,70,102,54,36,98,58
58012,2058,1033,1025,356,546,131,338,514,173
58013,159,92,67,19,42,31,12,27,28
58015,345,176,169,61,97,18,53,100,16
58016,206,112,94,38,50,24,26,39,29
58017,447,225,222,54,126,45,68,102,52
58018,285,139,146,41,76,22,44,60,42
58021,456,225,231,54,138,33,79,122,30
58027,1484,736,748,197,380,159,212,332,204
58029,152,70,82,26,24,20,31,38,13
58030,798,374,424,124,194,56,155,188,81
58031,501,274,227,90,145,39,61,128,38
58032,759,393,366,109,185,99,117,167,82
58033,419,217,202,57,99,61,53,90,59
58035,333,185,148,73,77,35,33,67,48
58036,307,167,140,47,86,34,38,66,36
58038,324,163,161,36,85,42,48,71,42
58039,97,48,49,12,29,7,19,20,10
58040,853,449,404,161,222,66,120,211,73
58041,1792,872,920,257,418,197,240,373,307
58042,1347,673,674,241,379,53,250,371,53
58043,231,116,115,26,47,43,27,51,37
58045,2292,1174,1118,382,560,232,312,504,302
58046,568,295,273,108,122,65,84,119,70
58047,2141,1078,1063,374,616,88,407,579,77
58048,491,257,234,82,113,62,56,110,68
58049,359,194,165,66,91,37,45,79,41
58051,1416,700,716,238,360,102,254,350,112
58052,603,297,306,88,150,59,98,136,72
58053,1340,699,641,206,313,180,174,234,233
58054,3377,1751,1626,536,836,379,412,769,445
58056,174,89,85,20,46,23,25,31,29
58057,151,79,72,18,34,27,13,28,31
58058,126,62,64,14,35,13,17,29,18
58059,991,526,465,207,262,57,170,242,53
58060,1472,755,717,250,362,143,243,308,166
58061,432,242,190,74,126,42,61,83,46
58062,210,102,108,16,50,36,32,36,40
58063,367,206,161,79,109,18,51,78,32
58064,521,258,263,56,133,69,79,103,81
58067,337,189,148,73,87,29,30,72,46
58068,374,210,164,77,89,44,50,65,49
58069,230,132,98,30,70,32,18,58,22
58071,425,218,207,62,120,36,61,94,52
58072,8331,4007,4324,1244,1917,846,1258,1830,1236
58075,10192,5356,4836,2319,2345,692,1679,2162,995
58077,657,339,318,111,175,53,106,160,52
58078,14702,7306,7396,2480,4119,707,2490,4134,772
58079,521,250,271,74,130,46,97,122,52
58081,980,518,462,186,246,86,157,210,95
58102,31905,16575,15330,5802,8914,1859,5338,7515,2477
58103,47524,23387,24137,6690,14222,2475,7006,13398,3733
58104,15597,7705,7892,2779,4361,565,2718,4336,838
58201,32452,16145,16307,5172,8933,2040,4757,8512,3038
58202,2452,1334,1118,1155,179,0,1023,95,0
58203,16240,8407,7833,2965,4747,695,2794,4138,901
58204,4832,2608,2224,1347,1261,0,1048,1163,13
58210,419,220,199,57,96,67,45,86,68
58212,608,302,306,96,121,85,96,105,105
58213,311,157,154,53,78,26,59,73,22
58214,425,225,200,69,108,48,44,122,34
58216,200,94,106,24,42,28,45,32,29
58218,746,377,369,111,202,64,121,173,75
58219,63,36,27,15,13,8,10,12,5
58220,2569,1251,1318,361,605,285,324,595,399
58222,363,185,178,49,93,43,56,77,45
58223,211,115,96,33,53,29,23,43,30
58224,41,17,24,0,9,8,0,14,10
58225,1169,598,571,163,314,121,156,272,143
58227,622,301,321,79,157,65,86,148,87
58228,1063,571,492,188,318,65,151,291,50
58229,159,87,72,38,34,15,10,33,29
58230,787,403,384,114,172,117,108,163,113
58231,566,269,297,75,118,76,95,130,72
58233,326,147,179,39,86,22,65,77,37
58235,564,287,277,87,161,39,107,125,45
58236,32,17,15,5,4,8,2,4,9
58237,5911,2940,2971,944,1460,536,808,1432,731
58238,186,91,95,13,59,19,21,46,28
58239,101,65,36,27,28,10,10,15,11
58240,1361,676,685,213,332,131,205,287,193
58241,207,122,85,46,64,12,31,41,13
58243,640,309,331,93,159,57,99,160,72
58244,277,150,127,39,67,44,37,61,29
58249,2962,1463,1499,405,684,374,359,608,532
58250,322,187,135,70,81,36,27,64,44
58251,2096,1035,1061,338,525,172,305,520,236
58254,682,314,368,69,148,97,111,135,122
58255,26,11,15,5,6,0,8,7,0
58256,986,527,459,192,291,44,163,234,62
58257,2282,1127,1155,395,491,241,420,403,332
58258,270,151,119,53,71,27,42,61,16
58259,552,295,257,53,141,101,36,111,110
58260,257,120,137,39,53,28,47,58,32
58261,1035,522,513,140,272,110,132,238,143
58262,204,100,104,19,33,48,17,30,57
58265,595,307,288,96,163,48,76,141,71
58266,257,150,107,56,57,37,32,40,35
58267,1532,760,772,213,373,174,182,347,243
58269,253,111,142,27,46,38,35,42,65
58270,2106,1024,1082,321,448,255,261,462,359
58271,791,400,391,120,220,60,127,196,68
58272,302,154,148,36,75,43,40,57,51
58273,219,114,105,19,61,34,24,46,35
58274,1157,599,558,221,265,113,135,279,144
58275,759,369,390,109,204,56,136,205,49
58276,699,376,323,129,181,66,89,154,80
58277,267,144,123,31,75,38,31,60,32
58278,1938,1001,937,389,521,91,334,534,69
58281,132,67,65,13,42,12,20,34,11
58282,1565,754,811,219,370,165,231,350,230
58301,9894,4799,5095,1543,2278,978,1466,2358,1271
58310,254,132,122,41,68,23,41,53,28
58311,194,97,97,42,42,13,46,31,20
58313,68,42,26,16,14,12,2,12,12
58316,6485,3253,3232,1560,1413,280,1476,1478,278
58317,296,152,144,34,75,43,37,65,42
58318,3924,1941,1983,653,858,430,512,835,636
58321,208,118,90,22,42,54,16,32,42
58323,60,30,30,9,18,3,4,26,0
58324,1648,796,852,223,385,188,194,354,304
58325,180,105,75,42,37,26,11,36,28
58327,431,231,200,95,104,32,65,113,22
58329,3094,1509,1585,682,627,200,681,697,207
58330,498,269,229,64,102,103,55,94,80
58331,165,78,87,24,33,21,24,37,26
58332,395,216,179,50,86,80,35,76,68
58335,1629,818,811,488,296,34,448,322,41
58338,127,72,55,11,44,17,15,23,17
58341,2926,1413,1513,365,606,442,285,629,599
58343,93,56,37,14,20,22,4,12,21
58344,1073,503,570,139,217,147,133,234,203
58345,163,80,83,12,42,26,15,39,29
58346,781,393,388,135,180,78,124,171,93
58348,1016,527,489,136,239,152,95,177,217
58351,554,291,263,81,140,70,64,131,68
58352,488,242,246,59,113,70,60,94,92
58353,28,17,11,5,10,2,0,9,2
58355,116,57,59,12,22,23,16,23,20
58356,2011,980,1031,301,446,233,242,435,354
58357,276,145,131,54,57,34,41,59,31
58359,19,14,5,6,8,0,0,5,0
58361,250,146,104,51,61,34,17,52,35
58362,182,95,87,31,49,15,35,37,15
58363,116,55,61,19,22,14,20,32,9
58365,449,231,218,71,103,57,63,98,57
58366,1054,537,517,191,235,111,151,233,133
58367,1858,862,996,305,388,169,306,442,248
58368,4071,1944,2127,567,879,498,570,886,671
58369,992,516,476,205,258,53,194,222,60
58370,1295,632,663,332,269,31,355,272,36
58372,151,79,72,22,37,20,21,42,9
58374,699,343,356,112,158,73,108,133,115
58377,412,204,208,67,101,36,77,91,40
58379,296,162,134,88,64,10,66,58,10
58380,456,211,245,58,117,36,59,91,95
58381,371,188,183,84,80,24,73,85,25
58382,207,118,89,34,58,26,15,51,23
58384,694,371,323,115,179,77,92,143,88
58385,186,108,78,31,57,20,16,41,21
58386,131,78,53,21,39,18,14,30,9
58401,18061,8710,9351,2804,4342,1564,2570,4511,2270
58413,1236,575,661,114,203,258,126,210,325
58415,201,108,93,25,56,27,31,39,23
58416,507,242,265,53,121,68,69,101,95
58418,448,237,211,70,95,72,50,92,69
58420,301,155,146,52,90,13,54,73,19
58421,3109,1529,1580,446,731,352,446,680,454
58422,244,137,107,48,65,24,27,56,24
58423,87,46,41,6,28,12,10,17,14
58424,337,161,176,31,82,48,46,95,35
58425,1540,748,792,205,349,194,194,317,281
58426,271,150,121,62,76,12,30,69,22
58428,288,150,138,43,68,39,35,57,46
58429,314,164,150,46,74,44,45,65,40
58430,125,72,53,19,30,23,21,20,12
58431,158,84,74,16,42,26,20,36,18
58433,1257,618,639,209,282,127,171,251,217
58436,2281,1077,1204,365,452,260,336,496,372
58438,832,408,424,132,180,96,144,157,123
58439,87,52,35,24,16,12,9,17,9
58440,233,121,112,36,67,18,39,41,32
58441,481,247,234,95,108,44,93,89,52
58442,554,259,295,38,116,105,44,102,149
58443,320,163,157,49,73,41,49,61,47
58444,353,188,165,57,66,65,35,69,61
58445,170,87,83,29,40,18,27,38,18
58448,409,224,185,54,101,69,41,79,65
58451,222,98,124,32,42,24,40,43,41
58454,332,190,142,37,89,64,26,63,53
58455,269,134,135,36,52,46,28,50,57
58456,653,339,314,87,145,107,65,106,143
58458,1482,731,751,253,331,147,223,302,226
58460,304,149,155,18,57,74,24,63,68
58461,470,233,237,55,94,84,59,98,80
58463,773,371,402,69,181,121,72,183,147
58464,305,159,146,45,57,57,35,47,64
58466,420,211,209,50,95,66,54,87,68
58467,758,380,378,112,156,112,103,143,132
58472,366,187,179,38,108,41,39,83,57
58474,2758,1371,1387,409,663,299,356,627,404
58475,201,105,96,28,41,36,20,36,40
58476,262,149,113,46,77,26,35,56,22
58477,160,84,76,16,51,17,26,35,15
58478,189,105,84,22,44,39,11,41,32
58479,314,170,144,63,67,40,50,63,31
58480,344,161,183,41,84,36,49,90,44
58481,372,171,201,53,98,20,80,109,12
58482,1036,503,533,137,227,139,139,204,190
58483,391,191,200,57,80,54,56,75,69
58484,75,35,40,8,24,3,14,24,2
58486,345,182,163,61,86,35,47,67,49
58487,499,245,254,74,128,43,82,114,58
58488,331,162,169,29,85,48,43,67,59
58489,188,101,87,33,37,31,25,44,18
58490,354,178,176,48,96,34,61,79,36
58492,513,241,272,64,133,44,89,126,57
58494,379,191,188,47,90,54,37,77,74
58495,1542,720,822,173,296,251,180,286,356
58496,292,163,129,41,71,51,23,55,51
58497,482,280,202,137,124,19,64,124,14
58501,43706,20899,22807,6593,11028,3278,6693,11432,4682
58504,22611,11327,11284,3890,6301,1136,3708,6105,1471
58505,0,0,0,0,0,0,0,0,0
58520,292,162,130,41,77,44,42,56,32
58521,547,299,248,66,195,38,55,154,39
58523,3885,1915,1970,642,985,288,603,951,416
58524,117,65,52,6,18,41,4,18,30
58528,906,438,468,245,175,18,262,177,29
58529,842,427,415,135,189,103,108,182,125
58530,1393,715,678,239,375,101,196,352,130
58531,305,170,135,48,68,54,25,68,42
58532,336,191,145,71,84,36,38,79,28
58533,993,483,510,127,207,149,96,204,210
58535,594,316,278,97,134,85,67,121,90
58538,2369,1220,1149,615,538,67,535,519,95
58540,2280,1065,1215,301,473,291,310,495,410
58541,462,234,228,74,100,60,64,107,57
58542,426,226,200,78,95,53,50,85,65
58544,571,304,267,113,123,68,70,126,71
58545,3582,1833,1749,603,935,295,567,863,319
58549,261,140,121,46,65,29,41,54,26
58552,2191,1063,1128,293,472,298,298,442,388
58553,143,76,67,18,31,27,14,31,22
58554,20229,10061,10168,3395,5255,1411,3138,5240,1790
58558,719,373,346,132,201,40,111,189,46
58559,232,123,109,28,52,43,12,56,41
58560,195,95,100,36,45,14,36,54,10
58561,1247,644,603,207,260,177,159,248,196
58562,565,297,268,77,133,87,62,114,92
58563,2156,1057,1099,331,474,252,321,445,333
58564,207,125,82,36,64,25,25,44,13
58565,282,147,135,26,74,47,42,57,36
58566,227,122,105,53,56,13,39,51,15
58568,641,336,305,136,143,57,117,147,41
58569,92,46,46,9,29,8,13,16,17
58570,347,176,171,79,80,17,72,70,29
58571,571,301,270,88,160,53,77,143,50
58572,202,130,72,39,60,31,14,43,15
58573,832,409,423,86,160,163,105,145,173
58575,1009,498,511,124,250,124,108,225,178
58576,1064,512,552,140,264,108,160,244,148
58577,1776,905,871,273,491,141,249,463,159
58579,1280,630,650,201,314,115,206,294,150
58580,287,153,134,45,92,16,39,81,14
58581,296,158,138,39,72,47,40,57,41
58601,19249,9455,9794,3289,4646,1520,3069,4590,2135
58620,198,105,93,32,43,30,32,47,14
58621,1405,632,773,187,282,163,213,299,261
58622,1537,807,730,281,359,167,209,366,155
58623,2273,1109,1164,304,548,257,316,503,345
58625,259,134,125,44,65,25,44,54,27
58626,288,144,144,38,77,29,38,66,40
58627,164,90,74,12,57,21,21,38,15
58630,549,296,253,88,164,44,69,140,44
58631,1271,615,656,148,252,215,158,246,252
58632,242,120,122,43,55,22,40,61,21
58634,351,190,161,48,93,49,38,74,49
58636,750,383,367,124,162,97,131,147,89
58638,1098,547,551,161,233,153,138,228,185
58639,1971,926,1045,273,415,238,262,453,330
58640,1225,604,621,198,253,153,186,275,160
58641,126,60,66,25,20,15,14,40,12
58642,352,178,174,69,67,42,58,68,48
58643,230,123,107,31,61,31,18,50,39
58645,334,158,176,50,89,19,47,107,22
58646,1318,647,671,174,278,195,161,249,261
58647,967,500,467,120,256,124,107,200,160
58649,366,172,194,32,82,58,43,78,73
58650,477,240,237,64,107,69,73,89,75
58651,544,283,261,98,143,42,84,129,48
58652,1121,566,555,160,251,155,138,239,178
58653,658,329,329,80,160,89,89,147,93
58654,345,199,146,95,73,31,60,59,27
58655,487,254,233,93,132,29,92,116,25
58656,429,205,224,54,106,45,79,101,44
58701,24761,12066,12695,3659,6366,2041,3453,6324,2918
58703,18479,9100,9379,3158,4677,1265,3038,4794,1547
58704,7599,4194,3405,2108,2077,9,1698,1699,8
58710,585,301,284,77,118,106,65,113,106
58711,235,117,118,33,52,32,36,56,26
58712,184,94,90,31,44,19,29,41,20
58713,40,24,16,5,13,6,5,9,2
58716,119,60,59,14,33,13,11,30,18
58718,959,510,449,163,248,99,116,227,106
58721,609,304,305,84,133,87,80,129,96
58722,1456,732,724,269,369,94,270,376,78
58723,173,91,82,17,47,27,18,36,28
58725,348,186,162,52,79,55,55,52,55
58727,342,173,169,24,82,67,22,67,80
58730,1364,641,723,176,278,187,156,264,303
58731,314,157,157,49,80,28,66,68,23
58733,493,229,264,72,143,14,102,132,30
58734,335,187,148,68,93,26,51,70,27
58735,387,187,200,59,92,36,76,93,31
58736,551,300,251,96,115,89,61,110,80
58737,151,65,86,8,31,26,26,33,27
58740,681,379,302,155,167,57,113,136,53
58741,640,324,316,110,157,57,105,150,61
58744,196,106,90,22,57,27,20,48,22
58746,1684,811,873,220,388,203,224,336,313
58747,150,82,68,35,33,14,14,38,16
58748,245,125,120,22,73,30,34,53,33
58750,597,311,286,91,164,56,79,149,58
58752,259,135,124,35,67,33,18,67,39
58755,164,91,73,24,36,31,19,29,25
58756,250,129,121,31,58,40,23,63,35
58757,780,378,402,187,157,34,209,152,41
58758,245,113,132,25,51,37,30,48,54
58759,709,363,346,102,185,76,98,172,76
58760,280,134,146,25,72,37,36,60,50
58761,1207,579,628,148,258,173,149,247,232
58762,237,137,100,39,64,34,20,47,33
58763,2860,1396,1464,584,670,142,559,665,240
58765,317,160,157,35,69,56,28,64,65
58768,249,137,112,58,52,27,26,51,35
58769,278,138,140,34,66,38,51,64,25
58770,1290,626,664,240,278,108,223,290,151
58771,482,263,219,68,133,62,47,107,65
58772,143,76,67,15,39,22,6,39,22
58773,756,386,370,104,192,90,112,153,105
58775,294,151,143,61,72,18,57,64,22
58776,216,108,108,36,47,25,38,49,21
58778,180,96,84,17,33,46,16,30,38
58779,514,282,232,75,140,67,53,124,55
58781,721,360,361,111,197,52,131,180,50
58782,464,231,233,59,112,60,60,99,74
58783,360,173,187,44,77,52,53,81,53
58784,1732,838,894,216,389,233,211,363,320
58785,1071,558,513,235,275,48,192,261,60
58787,155,82,73,13,48,21,13,39,21
58788,1322,680,642,192,313,175,134,290,218
58789,354,182,172,50,91,41,43,79,50
58790,1570,768,802,255,338,175,232,321,249
58792,255,125,130,23,68,34,35,58,37
58793,752,367,385,98,181,88,94,172,119
58794,143,77,66,25,43,9,21,28,17
58795,278,138,140,38,55,45,40,58,42
58801,16125,7893,8232,2659,3919,1315,2561,3937,1734
58830,242,136,106,33,67,36,19,46,41
58831,508,268,240,75,133,60,70,105,65
58833,90,45,45,12,16,17,6,24,15
58835,252,130,122,33,50,47,33,47,42
58838,225,122,103,38,63,21,27,57,19
58843,336,193,143,47,104,42,23,72,48
58844,165,84,81,15,46,23,20,36,25
58845,388,204,184,48,87,69,42,78,64
58847,219,130,89,37,53,40,20,48,21
58849,812,421,391,115,186,120,87,188,116
58852,1581,779,802,203,362,214,199,350,253
58853,114,63,51,29,25,9,21,23,7
58854,2430,1175,1255,396,568,211,368,573,314
58856,128,68,60,13,29,26,11,21,28
59001,1577,785,792,233,401,151,230,387,175
59002,63,37,26,16,15,6,6,17,3
59003,1055,548,507,228,275,45,199,269,39
59006,827,408,419,134,190,84,114,193,112
59007,119,66,53,22,34,10,20,26,7
59008,371,181,190,68,73,40,61,82,47
59010,144,73,71,16,52,5,27,39,5
59011,3015,1488,1527,421,744,323,408,726,393
59012,142,78,64,22,33,23,16,44,4
59013,189,107,82,36,49,22,16,52,14
59014,1441,725,716,200,358,167,211,350,155
59015,524,265,259,79,137,49,103,117,39
59016,952,513,439,244,224,45,188,213,38
59018,406,193,213,63,83,47,77,94,42
59019,3340,1699,1641,544,882,273,439,855,347
59020,100,61,39,9,41,11,4,26,9
59022,2455,1142,1313,545,486,111,630,592,91
59024,377,192,185,48,98,46,41,86,58
59025,125,65,60,17,42,6,14,41,5
59026,197,121,76,39,61,21,13,39,24
59027,309,144,165,50,75,19,40,89,36
59028,554,286,268,47,155,84,57,141,70
59029,803,388,415,133,188,67,135,192,88
59030,1774,872,902,194,561,117,245,544,113
59031,330,164,166,75,75,14,55,78,33
59032,363,190,173,51,101,38,48,88,37
59033,101,49,52,21,24,4,16,26,10
59034,4576,2208,2368,823,1076,309,763,1116,489
59035,197,114,83,40,57,17,24,50,9
59036,1631,799,832,204,402,193,250,376,206
59037,1516,760,756,251,386,123,265,402,89
59038,773,413,360,124,192,97,95,177,88
59039,91,56,35,7,30,19,2,20,13
59041,1774,900,874,275,441,184,228,454,192
59043,2865,1416,1449,766,551,99,706,620,123
59044,9701,4756,4945,1573,2466,717,1464,2521,960
59046,436,211,225,79,94,38,60,120,45
59047,12190,5978,6212,1681,3213,1084,1658,3122,1432
59050,1683,830,853,393,348,89,371,398,84
59052,203,113,90,35,54,24,24,53,13
59053,437,265,172,97,121,47,51,82,39
59054,287,127,160,31,73,23,55,78,27
59055,122,70,52,27,30,13,18,21,13
59057,399,216,183,66,112,38,51,95,37
59058,65,34,31,16,16,2,17,14,0
59059,159,92,67,41,33,18,11,40,16
59061,278,181,97,17,124,40,14,48,35
59062,82,32,50,4,23,5,13,28,9
59063,1721,855,866,264,473,118,278,440,148
59064,283,161,122,53,82,26,38,74,10
59065,85,42,43,13,21,8,8,27,8
59066,744,380,364,185,160,35,136,194,34
59067,219,106,113,32,55,19,34,50,29
59068,3517,1774,1743,481,907,386,362,912,469
59069,477,247,230,78,132,37,75,118,37
59070,748,402,346,136,189,77,84,197,65
59071,83,40,43,6,20,14,3,29,11
59072,4027,1961,2066,537,979,445,551,1027,488
59074,577,312,265,84,161,67,75,137,53
59075,344,175,169,76,69,30,61,78,30
59076,35,15,20,2,9,4,2,7,11
59077,62,34,28,7,18,9,13,9,6
59078,144,63,81,21,17,25,32,23,26
59079,3010,1538,1472,547,848,143,510,864,98
59081,29,12,17,0,8,4,2,12,3
59085,57,23,34,8,15,0,12,15,7
59086,757,384,373,122,206,56,102,209,62
59087,493,257,236,76,119,62,74,106,56
59088,1136,577,559,200,287,90,152,291,116
59089,497,248,249,106,117,25,112,108,29
59101,36312,18104,18208,5781,10203,2120,5634,9711,2863
59102,44501,20523,23978,6043,10154,4326,6305,11172,6501
59105,23063,11525,11538,4039,6175,1311,3755,6343,1440
59106,8218,4270,3948,1594,2157,519,1312,2185,451
59201,5095,2495,2600,994,1115,386,991,1171,438
59211,185,99,86,35,32,32,30,42,14
59212,299,138,161,33,63,42,43,65,53
59213,851,435,416,176,213,46,181,174,61
59214,140,78,62,14,41,23,15,24,23
59215,1243,597,646,189,283,125,187,315,144
59217,72,32,40,8,12,12,8,26,6
59218,925,459,466,146,206,107,111,211,144
59219,384,205,179,62,99,44,47,83,49
59221,1608,815,793,249,396,170,226,394,173
59222,233,119,114,17,58,44,21,56,37
59223,277,139,138,47,63,29,40,66,32
59225,708,345,363,148,163,34,159,160,44
59226,420,226,194,72,106,48,41,81,72
59230,4675,2188,2487,619,1083,486,645,1163,679
59231,177,89,88,19,34,36,16,24,48
59241,447,221,226,65,105,51,67,102,57
59242,55,20,35,3,12,5,15,12,8
59243,357,194,163,74,92,28,43,86,34
59244,108,66,42,14,33,19,3,26,13
59247,352,192,160,59,98,35,41,86,33
59248,741,414,327,103,191,120,66,182,79
59250,226,120,106,20,51,49,20,48,38
59252,222,102,120,19,41,42,40,40,40
59253,180,109,71,43,50,16,17,43,11
59254,2428,1162,1266,335,555,272,310,529,427
59255,3691,1841,1850,858,815,168,786,864,200
59257,81,45,36,8,34,3,3,22,11
59258,145,73,72,12,38,23,20,30,22
59259,413,205,208,49,112,44,57,87,64
59260,178,96,82,20,46,30,23,38,21
59261,548,286,262,95,138,53,70,115,77
59262,742,375,367,132,182,61,133,164,70
59263,1505,716,789,179,333,204,214,319,256
59270,7061,3472,3589,1141,1745,586,1054,1740,795
59274,246,134,112,35,54,45,19,55,38
59275,349,184,165,36,81,67,25,69,71
59276,45,23,22,0,14,9,4,7,11
59301,11314,5535,5779,1773,2650,1112,1649,2795,1335
59311,209,97,112,31,52,14,44,48,20
59313,2407,1219,1188,405,578,236,339,550,299
59314,145,81,64,22,46,13,21,30,13
59315,197,91,106,31,50,10,48,48,10
59317,1214,602,612,189,268,145,166,288,158
59318,147,72,75,14,33,25,19,40,16
59322,185,108,77,46,50,12,15,50,12
59323,2431,1238,1193,494,662,82,451,695,47
59324,975,471,504,133,221,117,143,234,127
59326,272,140,132,35,70,35,21,68,43
59327,3068,1541,1527,472,731,338,461,748,318
59330,8319,4079,4240,1182,2059,838,1259,1962,1019
59332,176,89,87,27,44,18,26,37,24
59333,35,24,11,12,10,2,3,8,0
59336,122,68,54,20,34,14,12,30,12
59337,820,421,399,131,202,88,102,174,123
59338,183,82,101,30,45,7,35,49,17
59339,130,71,59,16,31,24,13,25,21
59343,149,75,74,34,34,7,30,33,11
59344,387,177,210,45,81,51,43,98,69
59347,346,184,162,53,94,37,54,72,36
59348,14,8,6,0,5,3,0,4,2
59349,927,479,448,102,243,134,104,200,144
59351,77,32,45,8,19,5,20,23,2
59353,1068,515,553,149,252,114,161,244,148
59354,43,25,18,7,11,7,1,13,4
59401,14377,6946,7431,2128,3829,989,2184,3654,1593
59404,24775,12621,12154,4027,6493,2101,3568,6347,2239
59405,32022,15520,16502,5307,7684,2529,4902,8099,3501
59410,765,364,401,99,183,82,145,170,86
59411,512,270,242,117,119,34,100,106,36
59412,1623,797,826,253,388,156,245,397,184
59414,864,477,387,151,263,63,105,200,82
59416,495,257,238,55,147,55,67,117,54
59417,6606,3288,3318,1584,1446,258,1427,1586,305
59419,74,42,32,7,23,12,4,20,8
59420,174,77,97,13,41,23,33,40,24
59421,1786,884,902,246,402,236,234,432,236
59422,3052,1436,1616,466,649,321,477,681,458
59424,20,11,9,3,8,0,2,7,0
59425,3760,1823,1937,613,848,362,578,875,484
59427,5292,2616,2676,931,1271,414,936,1194,546
59430,480,265,215,87,107,71,40,102,73
59432,194,100,94,23,48,29,26,46,22
59433,688,327,361,99,163,65,109,162,90
59434,469,251,218,95,122,34,68,117,33
59436,1894,981,913,346,460,175,300,436,177
59440,202,104,98,31,57,16,33,44,21
59441,116,70,46,25,25,20,10,34,2
59442,1976,977,999,310,448,219,263,430,306
59443,729,365,364,130,176,59,127,182,55
59444,206,108,98,33,55,20,34,48,16
59446,677,347,330,98,169,80,98,159,73
59447,283,149,134,34,80,35,45,63,26
59448,1125,519,606,250,232,37,315,238,53
59450,543,279,264,92,139,48,96,127,41
59451,1031,550,481,181,277,92,159,221,101
59452,628,308,320,76,153,79,93,151,76
59453,272,134,138,43,54,37,36,62,40
59454,226,118,108,30,67,21,23,59,26
59456,107,57,50,13,19,25,9,19,22
59457,9022,4247,4775,1213,2091,943,1262,2128,1385
59460,212,113,99,27,58,28,35,40,24
59462,239,127,112,53,59,15,34,57,21
59463,181,91,90,13,54,24,15,47,28
59464,466,229,237,56,115,58,45,104,88
59465,94,53,41,4,25,24,8,17,16
59466,135,77,58,23,38,16,12,19,27
59467,83,42,41,9,21,12,10,20,11
59468,620,313,307,84,158,71,93,148,66
59469,184,98,86,36,48,14,27,42,17
59471,435,215,220,70,97,48,79,109,32
59472,483,255,228,75,139,41,56,134,38
59474,3771,1937,1834,541,1053,343,506,894,434
59477,302,164,138,62,65,37,32,65,41
59479,955,510,445,179,232,99,109,220,116
59480,581,304,277,102,156,46,95,129,53
59482,847,432,415,162,205,65,170,182,63
59483,534,258,276,76,131,51,77,142,57
59484,158,77,81,19,35,23,24,36,21
59485,590,304,286,106,149,49,108,138,40
59486,1333,670,663,238,297,135,230,285,148
59487,1328,688,640,228,346,114,212,328,100
59501,13228,6554,6674,2385,3247,922,2059,3306,1309
59520,1273,665,608,207,308,150,153,296,159
59521,2896,1458,1438,771,578,109,720,608,110
59522,1576,741,835,224,344,173,225,375,235
59523,2579,1279,1300,406,607,266,359,601,340
59524,733,370,363,151,165,54,140,168,55
59525,325,160,165,55,78,27,40,83,42
59526,2582,1252,1330,518,555,179,558,594,178
59527,1086,556,530,285,221,50,238,233,59
59528,310,169,141,59,85,25,42,66,33
59529,69,43,26,9,26,8,6,14,6
59530,183,86,97,22,39,25,32,38,27
59531,388,220,168,75,107,38,42,90,36
59532,223,121,102,38,64,19,34,47,21
59535,110,62,48,18,37,7,4,37,7
59537,141,68,73,16,43,9,24,44,5
59538,3161,1560,1601,470,731,359,449,739,413
59540,386,185,201,58,77,50,52,96,53
59542,281,161,120,76,65,20,29,68,23
59544,194,95,99,34,40,21,42,41,16
59545,44,23,21,5,14,4,8,9,4
59546,117,62,55,30,20,12,12,30,13
59547,46,21,25,3,9,9,8,10,7
59601,28671,13902,14769,4327,7501,2074,4100,7674,2995
59602,18272,9160,9112,3015,4853,1292,2800,5076,1236
59631,247,115,132,30,62,23,37,75,20
59632,1829,928,901,312,497,119,295,472,134
59633,241,111,130,32,57,22,51,54,25
59634,4225,2113,2112,673,1199,241,700,1212,200
59635,5915,2961,2954,1179,1525,257,1036,1664,254
59636,37,24,13,8,16,0,5,8,0
59638,364,182,182,46,99,37,29,126,27
59639,1324,657,667,166,320,171,194,342,131
59640,80,38,42,4,32,2,7,33,2
59642,52,29,23,7,13,9,3,14,6
59643,523,300,223,47,192,61,38,144,41
59644,3434,1717,1717,484,864,369,484,815,418
59645,1623,793,830,230,391,172,251,371,208
59648,751,421,330,89,219,113,66,182,82
59701,33619,16684,16935,5212,8525,2947,4620,8359,3956
59710,349,194,155,59,101,34,31,92,32
59711,9163,4543,4620,1362,2208,973,1189,2148,1283
59713,214,97,117,27,49,21,46,51,20
59714,10593,5439,5154,1875,3126,438,1681,2984,489
59715,29888,15499,14389,5242,8751,1506,4763,7598,2028
59716,559,308,251,57,207,44,30,185,36
59718,16701,8814,7887,2875,5172,767,2617,4429,841
59720,220,122,98,28,68,26,22,54,22
59721,392,207,185,70,102,35,47,95,43
59722,5753,3495,2258,866,2168,461,604,1066,588
59725,8011,4107,3904,1456,2003,648,1288,1824,792
59727,159,85,74,21,41,23,17,38,19
59728,378,178,200,49,97,32,53,101,46
59729,1983,976,1007,197,548,231,251,514,242
59730,1654,855,799,208,542,105,201,501,97
59731,213,116,97,26,54,36,20,55,22
59733,117,63,54,17,29,17,14,29,11
59735,315,177,138,68,73,36,42,68,28
59736,117,61,56,18,32,11,13,41,2
59739,405,211,194,75,99,37,55,87,52
59740,401,212,189,45,121,46,31,116,42
59741,3904,1985,1919,690,998,297,583,1001,335
59743,181,98,83,28,45,25,15,52,16
59745,102,55,47,15,33,7,14,23,10
59746,111,59,52,19,29,11,12,31,9
59747,200,91,109,22,43,26,37,45,27
59748,334,180,154,79,75,26,55,77,22
59749,1482,727,755,197,329,201,171,325,259
59750,401,197,204,56,105,36,72,107,25
59751,143,78,65,14,29,35,11,29,25
59752,3103,1584,1519,533,789,262,503,749,267
59754,935,453,482,128,226,99,165,238,79
59755,158,86,72,11,66,9,16,46,10
59756,296,185,111,19,132,34,12,82,17
59758,1666,918,748,215,607,96,178,508,62
59759,3252,1670,1582,533,814,323,438,832,312
59761,328,171,157,25,105,41,46,79,32
59762,322,158,164,25,90,43,28,107,29
59801,28839,14173,14666,4709,7954,1510,5164,7356,2146
59802,17930,9227,8703,2677,5534,1016,2390,4928,1385
59803,14003,6817,7186,2202,3789,826,2314,3940,932
59804,7371,3562,3809,1041,1940,581,1055,1959,795
59808,11256,5587,5669,1921,3041,625,1807,2970,892
59820,1242,664,578,214,358,92,183,325,70
59821,2441,1186,1255,407,638,141,441,659,155
59823,1029,517,512,173,294,50,149,291,72
59824,1816,938,878,403,389,146,356,386,136
59825,2386,1176,1210,379,653,144,386,690,134
59826,587,300,287,73,153,74,68,146,73
59827,222,91,131,17,31,43,25,49,57
59828,4215,2183,2032,755,1030,398,577,1043,412
59829,2844,1553,1291,567,722,264,387,681,223
59831,481,243,238,66,130,47,82,122,34
59832,775,390,385,108,199,83,131,185,69
59833,4812,2432,2380,816,1272,344,752,1347,281
59834,1644,855,789,294,465,96,240,470,79
59836,275,126,149,25,74,27,56,78,15
59837,169,91,78,19,50,22,9,48,21
59840,12359,5911,6448,1692,2745,1474,1569,3040,1839
59841,463,262,201,188,58,16,116,65,20
59842,45,25,20,2,9,14,0,12,8
59843,255,136,119,35,68,33,28,68,23
59844,587,304,283,92,146,66,83,163,37
59845,1134,554,580,144,259,151,159,245,176
59846,1432,791,641,226,430,135,153,405,83
59847,4914,2490,2424,888,1372,230,767,1448,209
59848,117,63,54,16,22,25,12,29,13
59851,106,51,55,0,28,23,0,37,18
59853,590,307,283,74,157,76,77,136,70
59854,250,134,116,40,60,34,26,60,30
59855,664,300,364,153,110,37,134,204,26
59858,1512,791,721,255,387,149,189,342,190
59859,3456,1708,1748,490,831,387,469,851,428
59860,9175,4536,4639,1446,2108,982,1324,2257,1058
59864,6182,2995,3187,1154,1451,390,1142,1525,520
59865,2886,1453,1433,554,652,247,446,733,254
59866,810,420,390,133,211,76,100,218,72
59867,230,118,112,26,63,29,36,56,20
59868,1886,992,894,265,518,209,246,466,182
59870,8583,4261,4322,1378,2156,727,1206,2337,779
59871,214,101,113,5,68,28,36,68,9
59872,2165,1126,1039,309,562,255,260,533,246
59873,2687,1374,1313,437,658,279,319,689,305
59874,1278,675,603,173,337,165,148,326,129
59875,3480,1714,1766,475,881,358,501,878,387
59901,39333,19310,20023,6283,10062,2965,5952,10155,3916
59910,404,190,214,43,75,72,65,82,67
59911,6908,3449,3459,938,1735,776,851,1808,800
59912,12003,6075,5928,2020,3128,927,1876,3204,848
59913,679,377,302,115,200,62,89,175,38
59914,295,138,157,20,57,61,12,98,47
59915,183,65,118,17,44,4,48,56,14
59916,115,51,64,4,28,19,11,33,20
59917,3722,1833,1889,544,931,358,565,949,375
59918,392,208,184,63,91,54,56,92,36
59919,911,488,423,202,241,45,180,189,54
59920,733,387,346,131,224,32,116,197,33
59921,1,1,0,0,1,0,0,0,0
59922,1937,931,1006,270,431,230,226,534,246
59923,10284,5116,5168,1481,2555,1080,1506,2580,1082
59925,825,460,365,151,248,61,105,214,46
59926,441,210,231,45,143,22,50,155,26
59927,143,76,67,27,43,6,15,33,19
59928,70,50,20,9,32,9,0,15,5
59929,169,92,77,20,36,36,9,36,32
59930,811,426,385,133,216,77,120,189,76
59931,224,124,100,21,57,46,16,44,40
59932,976,481,495,96,231,154,113,204,178
59933,14,8,6,1,5,2,2,3,1
59934,442,248,194,88,116,44,46,112,36
59935,3172,1655,1517,487,764,404,408,738,371
59936,422,207,215,42,131,34,82,101,32
59937,11619,5785,5834,1640,3305,840,1604,3226,1004
60002,19350,9650,9700,3048,5376,1226,2849,5190,1661
60004,53118,25478,27640,7409,13918,4151,7334,14600,5706
60005,28884,14031,14853,3698,7780,2553,3206,7794,3853
60007,35281,17213,18068,5267,9543,2403,4819,9996,3253
60008,23406,11894,11512,3600,6779,1515,3185,6263,2064
60010,40110,19757,20353,6450,10399,2908,6019,11126,3208
60012,10087,5017,5070,1746,2701,570,1644,2626,800
60013,24079,11924,12155,4519,6538,867,4510,6452,1193
60014,44525,22247,22278,8535,11649,2063,7530,12042,2706
60015,27291,13243,14048,4300,7122,1821,4135,7598,2315
60016,58500,28204,30296,7675,16063,4466,7178,16433,6685
60018,30046,14832,15214,4534,8013,2285,4204,7702,3308
60020,6237,2991,3246,713,1786,492,837,1635,774
60021,5764,2857,2907,996,1542,319,878,1669,360
60022,8602,4199,4403,1529,1879,791,1412,2131,860
60025,49556,23894,25662,7256,12120,4518,6700,12931,6031
60029,341,185,156,62,80,43,43,71,42
60030,32426,15840,16586,5702,8605,1533,5385,9267,1934
60031,37377,18002,19375,6199,10316,1487,6220,11014,2141
60033,13231,6971,6260,2481,3688,802,1960,3298,1002
60034,1931,980,951,374,501,105,297,502,152
60035,29757,14493,15264,4387,7168,2938,4126,7735,3403
60037,878,479,399,227,252,0,197,202,0
60040,5601,2885,2716,1044,1548,293,893,1368,455
60041,9285,4802,4483,1570,2707,525,1315,2564,604
60042,8800,4428,4372,1656,2533,239,1459,2563,350
60043,2550,1204,1346,457,551,196,471,667,208
60044,15517,9472,6045,4660,4004,808,2071,3104,870
60045,22232,10398,11834,3554,4991,1853,3991,5497,2346
60046,30267,15239,15028,5364,8529,1346,4779,8668,1581
60047,38288,18766,19522,6986,10193,1587,7068,10616,1838
60048,28418,13605,14813,4614,7331,1660,4458,7947,2408
60050,48092,23929,24163,8162,13133,2634,7682,12948,3533
60053,21681,10322,11359,2767,5079,2476,2624,5476,3259
60056,57158,28251,28907,7978,15566,4707,7588,15120,6199
60060,36687,18672,18015,6822,10488,1362,6115,10126,1774
60061,20805,10122,10683,3589,5912,621,3348,6383,952
60062,40175,19283,20892,5655,9132,4496,5203,9982,5707
60064,16044,8295,7749,3207,4061,1027,2962,3782,1005
60067,50881,24931,25950,7342,14070,3519,6810,14773,4367
60068,37690,17827,19863,5357,8600,3870,4935,9545,5383
60069,7126,3706,3420,1114,1849,743,954,1744,722
60070,16347,8062,8285,2232,4773,1057,2391,4419,1475
60071,2870,1444,1426,482,749,213,420,764,242
60072,358,218,140,68,109,41,24,74,42
60073,38829,19783,19046,7883,10626,1274,7173,10251,1622
60074,23584,12351,11233,3718,7925,708,3462,6794,977
60076,34367,16602,17765,5156,8126,3320,4504,8698,4563
60077,25088,11691,13397,3216,5750,2725,2941,6284,4172
60081,8486,4297,4189,1426,2475,396,1499,2260,430
60083,5521,2827,2694,926,1582,319,791,1596,307
60084,12994,6624,6370,1931,3836,857,1822,3504,1044
60085,73069,37563,35506,14158,20405,3000,13302,18236,3968
60087,23701,11681,12020,4144,6079,1458,3815,6327,1878
60088,13546,8639,4907,5168,3471,0,2662,2225,20
60089,41734,20157,21577,6825,11172,2160,6342,12257,2978
60090,36526,18096,18430,5461,10668,1967,4842,10309,3279
60091,27427,13153,14274,4707,5849,2597,4231,6901,3142
60093,19580,9429,10151,3341,4270,1818,3168,4735,2248
60096,6901,3492,3409,1230,1843,419,1027,1963,419
60097,10453,5320,5133,1806,2942,572,1603,2910,620
60098,27613,13890,13723,4506,7597,1787,4252,7299,2172
60099,29657,14188,15469,5489,7287,1412,5678,7876,1915
60101,37800,18935,18865,6129,10538,2268,5916,10398,2551
60102,48410,24287,24123,8935,13973,1379,8469,13865,1789
60103,75805,37954,37851,14185,21276,2493,13135,21633,3083
60104,20593,9676,10917,3785,4912,979,3730,5919,1268
60106,22248,11217,11031,3429,6442,1346,3235,5795,2001
60107,35648,17766,17882,6013,10310,1443,5609,10516,1757
60108,22058,10623,11435,2917,6201,1505,2825,6591,2019
60109,166,88,78,31,55,2,17,56,5
60110,31834,16371,15463,6639,8676,1056,5961,8148,1354
60111,269,154,115,59,83,12,28,61,26
60112,1312,610,702,221,354,35,269,385,48
60113,292,158,134,61,73,24,39,72,23
60115,42389,20916,21473,8816,10316,1784,9393,9546,2534
60118,14637,7194,7443,2300,4062,832,2132,4263,1048
60119,7563,3793,3770,1339,1991,463,1207,2050,513
60120,48358,24549,23809,8844,13772,1933,8541,12765,2503
60123,54989,27040,27949,9215,14665,3160,8885,14744,4320
60126,45548,22047,23501,7223,11218,3606,6536,11644,5321
60129,297,159,138,48,101,10,50,73,15
60130,15688,7215,8473,1636,4725,854,1863,5164,1446
60131,19318,9588,9730,3269,4961,1358,2969,4843,1918
60134,21459,10741,10718,4028,5637,1076,3584,5725,1409
60135,5957,2960,2997,1004,1606,350,976,1523,498
60136,1481,746,735,255,460,31,231,456,48
60137,38072,18519,19553,6079,9974,2466,5790,10628,3135
60139,32221,16390,15831,5589,9637,1164,5044,9448,1339
60140,7332,3652,3680,1207,1967,478,1218,1891,571
60141,230,189,41,0,101,88,0,32,9
60142,7798,3809,3989,978,1975,856,1040,2091,858
60143,10004,4907,5097,1453,2794,660,1322,2939,836
60145,2585,1323,1262,449,733,141,455,653,154
60146,2253,1157,1096,412,592,153,397,518,181
60148,50290,24664,25626,6959,14159,3546,6685,13727,5214
60150,1675,840,835,269,438,133,258,419,158
60151,3562,1801,1761,586,1011,204,594,935,232
60152,10934,5475,5459,1818,2912,745,1721,2809,929
60153,26860,12552,14308,5195,5858,1499,5064,7002,2242
60154,16573,7689,8884,1781,3901,2007,1782,4189,2913
60155,8271,3794,4477,1144,2135,515,1247,2523,707
60157,2089,1051,1038,290,529,232,179,564,295
60160,23298,11667,11631,4165,6155,1347,3967,5778,1886
60162,8500,4121,4379,1238,2192,691,1138,2242,999
60163,5256,2608,2648,838,1369,401,711,1388,549
60164,21553,10872,10681,3691,5773,1408,3179,5399,2103
60165,5096,2631,2465,1051,1386,194,1044,1220,201
60171,10579,5072,5507,1538,2735,799,1351,2838,1318
60172,25479,12543,12936,4115,7106,1322,3712,7561,1663
60173,12087,6368,5719,1325,4673,370,1315,4010,394
60174,31611,15989,15622,5744,8374,1871,4669,8360,2593
60175,18122,9225,8897,3499,5020,706,3241,4939,717
60176,11580,5825,5755,1745,3299,781,1674,3107,974
60177,16722,8352,8370,2784,5035,533,2631,4924,815
60178,16542,8041,8501,2733,4257,1051,2712,4377,1412
60180,1724,830,894,281,435,114,294,476,124
60181,30352,14884,15468,4591,8295,1998,4569,8144,2755
60184,750,365,385,96,228,41,100,249,36
60185,33102,17046,16056,6116,9720,1210,6051,8513,1492
60187,61677,30004,31673,10763,15671,3570,9913,16486,5274
60188,43143,21346,21797,7894,12202,1250,7388,12494,1915
60190,12178,6233,5945,2132,3434,667,1841,3358,746
60191,14861,7464,7397,2327,3725,1412,1781,3988,1628
60192,2033,1057,976,403,623,31,373,563,40
60193,40621,19458,21163,5511,11388,2559,5216,12212,3735
60194,41361,20140,21221,6625,11645,1870,5845,12219,3157
60195,30038,15186,14852,5126,9050,1010,4466,9005,1381
60201,42005,19753,22252,7117,10065,2571,7908,10443,3901
60202,32208,15242,16966,4440,9250,1552,3998,10611,2357
60203,4539,2147,2392,655,1056,436,638,1171,583
60301,2259,975,1284,125,749,101,186,821,277
60302,32440,14981,17459,4205,9024,1752,4050,10655,2754
60304,17825,8412,9413,2916,4791,705,2710,5628,1075
60305,11635,5345,6290,1941,2521,883,2042,2977,1271
60401,5593,2658,2935,692,1315,651,767,1362,806
60402,60418,29171,31247,9579,15450,4142,8914,15917,6416
60406,25344,12558,12786,4520,6481,1557,4382,6582,1822
60407,1648,838,810,314,436,88,317,399,94
60408,5243,2600,2643,958,1346,296,923,1406,314
60409,38933,17864,21069,6469,8926,2469,6564,10717,3788
60410,7715,3978,3737,1548,2115,315,1315,2130,292
60411,60732,29261,31471,11376,14119,3766,11006,15409,5056
60415,13764,6567,7197,1979,3799,789,1970,3829,1398
60416,7280,3589,3691,1200,1931,458,1156,1888,647
60417,15773,7734,8039,2233,4132,1369,2064,4265,1710
60419,25676,11840,13836,5018,5557,1265,4605,7331,1900
60420,6092,2382,3710,778,1264,340,947,2171,592
60421,3493,1740,1753,525,972,243,477,966,310
60422,9332,4479,4853,1574,2150,755,1456,2490,907
60423,22917,11365,11552,4216,5964,1185,3963,6292,1297
60424,2331,1144,1187,420,573,151,335,656,196
60425,8959,4171,4788,1380,2198,593,1211,2637,940
60426,48080,22761,25319,10069,9895,2797,9356,12163,3800
60429,15958,7218,8740,2731,3609,878,2906,4545,1289
60430,20963,9755,11208,3242,4842,1671,3120,5547,2541
60431,23435,11968,11467,4708,6107,1153,3941,6305,1221
60432,21555,11632,9923,4378,6400,854,4098,4759,1066
60433,17650,8627,9023,3562,4023,1042,2956,4205,1862
60435,52381,25130,27251,7948,13424,3758,7670,13783,5798
60436,16236,7994,8242,2720,4142,1132,2274,3974,1994
60437,221,103,118,34,52,17,21,58,39
60438,28880,13659,15221,4167,7081,2411,4195,7660,3366
60439,20088,9605,10483,3221,5091,1293,3178,5218,2087
60440,46412,23044,23368,8923,12709,1412,8142,13104,2122
60441,49295,26035,23260,8514,15013,2508,7691,12607,2962
60442,6250,3121,3129,1180,1641,300,1121,1631,377
60443,15094,7002,8092,2407,3512,1083,2266,4251,1575
60444,1532,812,720,288,396,128,209,385,126
60445,25890,12366,13524,3858,6857,1651,3598,6941,2985
60446,20094,10260,9834,3646,5841,773,3209,5717,908
60447,7127,3631,3496,1324,1942,365,1238,1890,368
60448,19674,10027,9647,3815,5366,846,3252,5427,968
60449,5713,2905,2808,833,1608,464,757,1555,496
60450,19092,9484,9608,3027,5040,1417,2877,4762,1969
60451,27328,13393,13935,4960,7288,1145,4903,7543,1489
60452,27717,13707,14010,4396,7654,1657,4168,7926,1916
60453,54619,25669,28950,7342,12581,5746,6692,13351,8907
60455,15984,7814,8170,2467,4168,1179,2238,4094,1838
60456,4506,2083,2423,704,1033,346,617,1135,671
60457,14289,6872,7417,2060,3841,971,2071,3933,1413
60458,14097,6931,7166,2438,3917,576,2243,4069,854
60459,28096,13847,14249,4375,7382,2090,4284,7040,2925
60460,1549,755,794,239,375,141,250,374,170
60461,4621,2244,2377,662,1004,578,562,1190,625
60462,38438,18422,20016,5613,9343,3466,5206,10040,4770
60463,13403,6386,7017,1968,2711,1707,1786,2921,2310
60464,9305,4432,4873,1300,2091,1041,1164,2281,1428
60465,17323,8101,9222,2129,4316,1656,1956,4997,2269
60466,30294,14044,16250,5222,7156,1666,4941,8795,2514
60467,20788,10126,10662,3450,5230,1446,3247,5581,1834
60468,5321,2625,2696,940,1370,315,896,1361,439
60469,4537,2385,2152,869,1193,323,602,1153,397
60470,653,322,331,102,177,43,110,161,60
60471,12806,5835,6971,2278,3017,540,2087,4039,845
60472,6587,3177,3410,1346,1391,440,1174,1557,679
60473,22396,10741,11655,3517,5049,2175,3063,5656,2936
60474,744,362,382,97,197,68,114,170,98
60475,9057,4465,4592,1373,2468,624,1408,2446,738
60476,2615,1220,1395,328,657,235,374,695,326
60477,56931,27577,29354,9416,15116,3045,8626,16286,4442
60478,16282,7358,8924,2784,3739,835,2785,5025,1114
60479,782,408,374,160,193,55,130,169,75
60480,4666,2429,2237,592,1500,337,593,1309,335
60481,11131,5613,5518,1756,3075,782,1608,2955,955
60482,11294,5533,5761,1638,3095,800,1608,3039,1114
60490,9489,4737,4752,1856,2683,198,1786,2741,225
60501,11160,5692,5468,2046,2951,695,1849,2716,903
60504,45024,22431,22593,8204,13458,769,7495,14215,883
60505,57114,29433,27681,11968,15320,2145,10836,13930,2915
60506,51129,25213,25916,8846,13435,2932,8711,13212,3993
60510,26437,12907,13530,4748,6886,1273,4465,7169,1896
60511,1886,930,956,261,539,130,261,548,147
60512,794,443,351,108,245,90,70,195,86
60513,19075,8941,10134,2547,4972,1422,2679,5309,2146
60514,17351,8078,9273,2322,4472,1284,2257,5067,1949
60515,27692,13117,14575,3944,7009,2164,3622,7455,3498
60516,30562,15110,15452,4728,8482,1900,4372,8800,2280
60517,31629,15643,15986,5221,9232,1190,4888,9511,1587
60518,3556,1787,1769,621,881,285,549,881,339
60519,21,6,15,0,6,0,9,6,0
60520,2811,1370,1441,414,779,177,470,783,188
60521,37489,18347,19142,6501,9077,2769,5804,9783,3555
60523,9896,4327,5569,872,2026,1429,1032,2361,2176
60525,32667,15882,16785,4930,8185,2767,4280,8556,3949
60526,13251,6077,7174,1811,3079,1187,1749,3269,2156
60530,604,303,301,109,139,55,115,138,48
60531,2040,1002,1038,361,506,135,406,495,137
60532,27161,13696,13465,3989,8584,1123,3688,8233,1544
60534,10081,5089,4992,1436,2932,721,1434,2561,997
60536,77,43,34,18,17,8,3,27,4
60537,388,187,201,87,76,24,82,100,19
60538,13585,6527,7058,2249,3462,816,2328,3571,1159
60539,0,0,0,0,0,0,0,0,0
60540,42100,20681,21419,7127,11478,2076,6948,11812,2659
60541,2565,1279,1286,470,655,154,409,672,205
60542,10982,5466,5516,1734,3144,588,1633,3036,847
60543,18571,9139,9432,3160,5110,869,3146,5139,1147
60544,43958,21665,22293,7761,11748,2156,7294,12338,2661
60545,7669,3808,3861,1445,1927,436,1390,1899,572
60546,15962,7652,8310,1971,3967,1714,1707,4134,2469
60548,10870,5377,5493,1797,2705,875,1621,2788,1084
60549,557,311,246,93,147,71,57,168,21
60550,1482,684,798,249,319,116,236,353,209
60551,5196,3380,1816,826,2368,186,662,889,265
60552,3865,1886,1979,680,931,275,671,972,336
60553,685,382,303,150,183,49,90,170,43
60554,4892,2411,2481,868,1305,238,891,1347,243
60555,13725,6824,6901,2323,3939,562,2204,4026,671
60556,1776,881,895,295,447,139,332,412,151
60557,137,70,67,30,31,9,16,45,6
60558,12572,6031,6541,2056,2821,1154,2067,3136,1338
60559,25797,12635,13162,3697,7322,1616,3132,7363,2667
60560,11711,5972,5739,2077,3226,669,1806,3100,833
60561,23676,11452,12224,3284,6157,2011,3189,6732,2303
60563,31582,15104,16478,4264,9355,1485,4248,9750,2480
60564,31685,15758,15927,6572,8679,507,6362,8948,617
60565,40503,20002,20501,8139,10613,1250,7473,11502,1526
60601,5565,2570,2995,192,1782,596,263,1966,766
60602,70,70,0,23,34,13,0,0,0
60603,544,241,303,159,82,0,247,56,0
60604,77,42,35,0,42,0,0,35,0
60605,12688,6760,5928,1103,5140,517,726,4112,1090
60606,1422,765,657,43,704,18,29,609,19
60607,15725,7818,7907,1759,5400,659,1834,4978,1095
60608,92147,51368,40779,19014,28975,3379,16200,20087,4492
60609,79592,38774,40818,17926,17950,2898,17705,18901,4212
60610,47619,22213,25406,4093,15217,2903,4485,17438,3483
60611,26525,12243,14282,845,8708,2690,898,10106,3278
60612,38185,18047,20138,7749,8524,1774,7667,9686,2785
60613,50608,26064,24544,3219,20426,2419,2991,18030,3523
60614,65438,31718,33720,4593,24442,2683,5308,24967,3445
60615,44636,20389,24247,5652,12124,2613,6074,14102,4071
60616,47259,22337,24922,7093,11840,3404,6625,13421,4876
60617,96287,44959,51328,17298,21410,6251,17194,25145,8989
60618,98059,48870,49189,15649,28813,4408,14924,27547,6718
60619,74904,32947,41957,11127,15908,5912,11361,20853,9743
60620,85884,38487,47397,14227,17895,6365,14500,23471,9426
60621,47575,21773,25802,10071,8698,3004,9643,11677,4482
60622,75859,39931,35928,11541,25035,3355,9822,21800,4306
60623,108189,54375,53814,24043,26496,3836,23351,25295,5168
60624,45472,20702,24770,9560,8838,2304,9979,11128,3663
60625,91604,46294,45310,14722,27215,4357,13832,25540,5938
60626,59764,30468,29296,9506,18665,2297,8974,16705,3617
60628,87891,40056,47835,15802,18418,5836,15991,23282,8562
60629,114301,55892,58409,23218,27292,5382,22442,28563,7404
60630,54812,26439,28373,7129,15154,4156,6392,15295,6686
60631,28886,13283,15603,3139,7273,2871,3289,7322,4992
60632,87700,44356,43344,17542,22653,4161,16804,20719,5821
60633,13280,6552,6728,2100,3317,1135,1846,3308,1574
60634,74104,36021,38083,9862,20259,5900,9304,19679,9100
60636,51304,23780,27524,10796,10240,2744,10250,13111,4163
60637,57162,25584,31578,10874,11316,3394,10970,15141,5467
60638,55716,27047,28669,8164,14246,4637,7423,14038,7208
60639,93087,46396,46691,19286,23663,3447,17989,23806,4896
60640,73786,37915,35871,8775,24929,4211,7169,21960,6742
60641,73626,36867,36759,11261,21317,4289,10732,20233,5794
60643,52428,24456,27972,8651,11804,4001,7837,14284,5851
60644,59043,27235,31808,11855,12354,3026,11571,15711,4526
60645,43633,21253,22380,6834,11256,3163,6181,11269,4930
60646,27057,12826,14231,3372,6770,2684,3172,7030,4029
60647,98989,50526,48463,17685,29239,3602,17361,26702,4400
60649,54757,23951,30806,8740,12030,3181,9119,16496,5191
60651,77378,35808,41570,16032,17237,2539,16720,20863,3987
60652,38992,18754,20238,6936,9135,2683,6645,10143,3450
60653,34683,14956,19727,6888,6110,1958,7194,8841,3692
60654,0,0,0,0,0,0,0,0,0
60655,29061,14265,14796,4720,7608,1937,4249,7674,2873
60656,26756,12798,13958,2607,7594,2597,2697,7449,3812
60657,66828,33391,33437,3161,27726,2504,2915,26459,4063
60659,39193,19345,19848,6153,10809,2383,5765,10597,3486
60660,47775,23962,23813,5672,15563,2727,6041,13753,4019
60661,4190,2153,2037,102,1976,75,164,1818,55
60706,23045,10797,12248,2563,5318,2916,2441,5575,4232
60707,42735,20231,22504,6139,10855,3237,5884,11561,5059
60712,12359,5865,6494,1764,2554,1547,1531,2877,2086
60714,31161,14488,16673,3506,6968,4014,2947,7285,6441
60803,22864,11005,11859,3637,5935,1433,3401,6339,2119
60804,86066,44276,41790,18549,22418,3309,17412,19858,4520
60805,20821,9888,10933,3255,5003,1630,3301,5070,2562
60827,33132,14895,18237,7371,6258,1266,7169,9273,1795
60901,37209,17954,19255,6273,9020,2661,5982,9436,3837
60910,540,265,275,91,136,38,68,148,59
60911,1404,731,673,248,366,117,227,303,143
60912,623,313,310,109,123,81,82,157,71
60913,1616,858,758,295,463,100,244,400,114
60914,22593,10956,11637,3885,5716,1355,3815,5999,1823
60915,10319,4946,5373,1768,2531,647,1676,2594,1103
60917,568,302,266,96,149,57,87,126,53
60918,1023,498,525,150,253,95,182,227,116
60919,452,234,218,70,127,37,60,104,54
60920,135,66,69,17,32,17,25,34,10
60921,1593,791,802,290,349,152,228,352,222
60922,2680,1337,1343,463,701,173,414,685,244
60924,1741,809,932,264,365,180,252,414,266
60926,78,43,35,10,26,7,7,17,11
60927,2229,1026,1203,306,549,171,336,594,273
60928,741,369,372,120,178,71,100,160,112
60929,771,367,404,111,169,87,123,152,129
60930,916,420,496,147,200,73,122,222,152
60931,739,362,377,126,182,54,141,171,65
60932,183,105,78,29,71,5,11,53,14
60933,354,179,175,57,96,26,50,96,29
60934,354,184,170,85,75,24,61,82,27
60935,935,475,460,153,248,74,154,243,63
60936,4235,1968,2267,584,959,425,556,1042,669
60938,2132,1028,1104,304,472,252,270,516,318
60940,3191,1593,1598,514,820,259,481,819,298
60941,1877,921,956,344,420,157,347,422,187
60942,6843,3414,3429,1080,1479,855,977,1564,888
60945,188,83,105,19,43,21,28,55,22
60946,514,270,244,112,119,39,79,116,49
60948,1352,667,685,147,341,179,153,336,196
60949,650,306,344,71,196,39,116,159,69
60950,8849,4376,4473,1442,2222,712,1197,2442,834
60951,1233,591,642,202,284,105,240,300,102
60952,730,370,360,132,175,63,117,157,86
60953,2588,1290,1298,355,624,311,298,630,370
60954,7065,3587,3478,1227,1784,576,1113,1657,708
60955,2092,1092,1000,478,467,147,347,459,194
60957,5670,2734,2936,880,1315,539,798,1376,762
60959,1054,496,558,154,221,121,150,228,180
60960,1093,536,557,148,276,112,158,257,142
60961,756,371,385,123,177,71,103,191,91
60962,616,328,288,86,178,64,65,124,99
60963,1613,759,854,218,385,156,221,404,229
60964,7157,3751,3406,1171,1702,878,1035,1642,729
60966,1695,837,858,275,389,173,244,410,204
60967,64,47,17,16,28,3,0,12,5
60968,434,231,203,70,121,40,62,100,41
60969,45,23,22,2,18,3,8,10,4
60970,7586,3642,3944,1153,1653,836,1014,1783,1147
60973,457,236,221,72,121,43,56,111,54
60974,346,162,184,53,75,34,51,100,33
61001,1044,535,509,150,200,185,109,221,179
61006,1883,913,970,352,436,125,324,462,184
61007,572,281,291,64,159,58,86,142,63
61008,28437,14076,14361,4870,7420,1786,4688,7130,2543
61010,7120,3462,3658,1288,1760,414,1270,1862,526
61011,2194,1089,1105,388,579,122,318,705,82
61012,1898,991,907,374,480,137,324,468,115
61013,469,222,247,60,133,29,86,126,35
61014,1141,565,576,133,295,137,156,259,161
61015,894,482,412,167,253,62,85,270,57
61016,3731,1837,1894,558,1048,231,579,1065,250
61018,1076,555,521,212,251,92,135,289,97
61019,3575,1787,1788,457,866,464,510,848,430
61020,1539,754,785,243,395,116,277,378,130
61021,23310,12151,11159,3223,7014,1914,2952,5756,2451
61024,2573,1250,1323,459,587,204,405,653,265
61025,4896,2478,2418,766,1286,426,727,1302,389
61028,1857,938,919,260,412,266,202,430,287
61030,2179,1044,1135,307,531,206,335,515,285
61031,1668,793,875,265,369,159,223,366,286
61032,32763,15501,17262,4704,7976,2821,4792,8154,4316
61036,6238,3075,3163,782,1539,754,718,1582,863
61037,72,37,35,4,25,8,6,29,0
61038,1455,768,687,254,432,82,269,326,92
61039,922,448,474,146,230,72,140,241,93
61041,1256,589,667,133,265,191,159,279,229
61042,708,362,346,124,177,61,125,168,53
61044,151,73,78,19,46,8,22,49,7
61046,3058,1561,1497,494,728,339,374,714,409
61047,2025,997,1028,303,484,210,321,519,188
61048,4392,2151,2241,718,1031,402,616,1034,591
61049,534,270,264,72,150,48,80,141,43
61050,466,238,228,44,137,57,57,119,52
61051,1705,828,877,254,433,141,255,410,212
61052,1319,676,643,272,357,47,199,372,72
61053,3147,1548,1599,447,755,346,425,714,460
61054,3883,1951,1932,651,894,406,488,920,524
61057,79,37,42,10,22,5,16,26,0
61059,116,51,65,10,30,11,17,31,17
61060,1460,735,725,236,371,128,242,350,133
61061,7419,3671,3748,1105,1863,703,1037,1825,886
61062,1976,961,1015,331,508,122,365,487,163
61063,3909,1921,1988,605,988,328,555,1023,410
61064,3999,1921,2078,626,959,336,617,988,473
61065,7040,3571,3469,1384,1818,369,1319,1742,408
61067,920,495,425,148,273,74,112,269,44
61068,14641,7332,7309,2472,3847,1013,2349,3621,1339
61070,1028,492,536,188,225,79,176,232,128
61071,14886,7157,7729,2155,3733,1269,2257,3750,1722
61072,8621,4329,4292,1487,2354,488,1411,2257,624
61073,16294,8376,7918,3111,4472,793,2600,4552,766
61074,5092,2453,2639,746,1163,544,720,1201,718
61075,1082,558,524,215,273,70,180,236,108
61077,55,21,34,8,13,0,0,19,15
61078,1354,714,640,245,319,150,152,315,173
61080,8749,4322,4427,1296,2402,624,1256,2260,911
61081,22995,11248,11747,3653,5623,1972,3298,5654,2795
61084,2823,1375,1448,467,710,198,526,739,183
61085,3683,1833,1850,511,866,456,451,889,510
61087,1761,869,892,275,404,190,253,403,236
61088,4834,2413,2421,824,1205,384,773,1255,393
61089,952,494,458,213,222,59,164,212,82
61091,7,4,3,0,4,0,3,0,0
61101,22900,10831,12069,4339,5153,1339,4226,5724,2119
61102,21053,10570,10483,3867,5334,1369,3822,5182,1479
61103,24232,11523,12709,3793,6012,1718,3553,6303,2853
61104,20422,10004,10418,3513,5583,908,3638,5241,1539
61107,30126,14308,15818,4049,7619,2640,4023,7952,3843
61108,27494,13159,14335,3707,6731,2721,3655,6994,3686
61109,26515,13417,13098,4131,7571,1715,3994,7212,1892
61111,20442,9955,10487,3061,5593,1301,2934,5685,1868
61112,18,8,10,8,0,0,7,3,0
61114,15400,7356,8044,2237,3706,1413,1923,4010,2111
61115,20367,9953,10414,3214,5444,1295,3250,5706,1458
61201,39285,18641,20644,6264,9194,3183,6540,9372,4732
61230,1160,562,598,203,281,78,185,293,120
61231,6164,2969,3195,935,1431,603,809,1536,850
61232,336,166,170,42,90,34,43,90,37
61233,534,285,249,98,142,45,85,124,40
61234,1269,627,642,237,293,97,200,284,158
61235,1478,730,748,241,348,141,200,353,195
61236,65,41,24,15,20,6,0,24,0
61238,3495,1819,1676,565,953,301,483,845,348
61239,321,154,167,52,88,14,53,94,20
61240,5924,2999,2925,899,1564,536,817,1529,579
61241,6937,3490,3447,1170,1855,465,1033,1891,523
61242,1196,619,577,166,355,98,165,300,112
61243,238,114,124,40,61,13,54,57,13
61244,22300,10545,11755,3309,5457,1779,3508,5566,2681
61250,2866,1430,1436,405,763,262,447,686,303
61251,342,168,174,71,80,17,53,96,25
61252,5811,2916,2895,828,1479,609,745,1455,695
61254,11317,5518,5799,1745,2737,1036,1544,2811,1444
61256,1474,736,738,201,389,146,174,401,163
61257,1350,662,688,221,336,105,193,386,109
61259,1208,563,645,123,324,116,161,373,111
61260,816,369,447,112,184,73,147,227,73
61261,941,476,465,129,264,83,127,241,97
61262,803,415,388,112,227,76,99,206,83
61263,342,160,182,70,75,15,71,85,26
61264,12463,6744,5719,1793,3955,996,1483,3051,1185
61265,46502,22089,24413,6717,11683,3689,6918,12173,5322
61270,7880,3848,4032,1285,1892,671,1185,1894,953
61272,1409,727,682,200,375,152,190,322,170
61273,3271,1657,1614,570,829,258,469,808,337
61274,451,210,241,60,100,50,78,122,41
61275,4615,2381,2234,764,1261,356,605,1225,404
61276,55,31,24,0,24,7,0,17,7
61277,3437,1718,1719,507,818,393,453,769,497
61279,989,502,487,168,215,119,97,261,129
61281,2590,1306,1284,437,731,138,392,748,144
61282,8971,4348,4623,1411,2127,810,1286,2273,1064
61283,1609,784,825,274,397,113,304,363,158
61284,3447,1764,1683,589,923,252,496,932,255
61285,1667,845,822,263,417,165,258,411,153
61301,10405,5354,5051,1639,2636,1079,1262,2583,1206
61310,4216,2162,2054,816,997,349,620,973,461
61311,342,193,149,70,79,44,36,90,23
61312,756,385,371,114,223,48,121,181,69
61313,359,192,167,76,90,26,48,89,30
61314,1038,510,528,173,218,119,166,222,140
61315,249,120,129,41,61,18,40,63,26
61316,262,117,145,25,60,32,43,69,33
61317,328,168,160,49,90,29,35,99,26
61318,698,340,358,88,194,58,87,193,78
61319,1185,614,571,180,351,83,172,297,102
61320,724,346,378,104,180,62,109,184,85
61321,339,175,164,51,96,28,40,93,31
61322,1698,855,843,346,383,126,260,356,227
61323,98,57,41,25,21,11,15,19,7
61324,95,53,42,0,18,35,0,14,28
61325,1001,496,505,157,260,79,182,221,102
61326,2450,1152,1298,364,585,203,396,619,283
61327,1125,554,571,165,276,113,151,272,148
61328,108,40,68,15,22,3,42,22,4
61329,1338,649,689,192,330,127,168,327,194
61330,1495,758,737,252,395,111,212,380,145
61331,40,21,19,0,12,9,0,13,6
61332,33,13,20,0,8,5,5,9,6
61333,430,204,226,55,110,39,82,103,41
61334,770,379,391,124,188,67,128,169,94
61335,566,287,279,80,142,65,83,126,70
61336,694,329,365,103,172,54,150,149,66
61337,496,274,222,109,133,32,75,114,33
61338,355,169,186,60,73,36,55,93,38
61340,337,157,180,51,81,25,48,91,41
61341,7466,3635,3831,1072,1926,637,1076,1932,823
61342,9334,4517,4817,1461,2241,815,1453,2196,1168
61344,405,200,205,53,99,48,53,102,50
61345,868,431,437,90,250,91,116,236,85
61346,94,41,53,11,22,8,14,25,14
61348,4357,2102,2255,578,1074,450,609,1058,588
61349,1080,527,553,164,250,113,151,260,142
61350,24276,11702,12574,3748,5861,2093,3632,5902,3040
61353,1291,658,633,207,343,108,182,327,124
61354,10623,5036,5587,1369,2505,1162,1360,2576,1651
61356,11284,5335,5949,1600,2682,1053,1538,2807,1604
61358,526,257,269,65,132,60,65,139,65
61359,269,134,135,40,60,34,25,64,46
61360,3017,1516,1501,522,753,241,521,717,263
61361,1378,697,681,174,346,177,177,319,185
61362,5758,2767,2991,822,1403,542,809,1395,787
61363,270,130,140,32,69,29,42,55,43
61364,20534,9993,10541,3207,4734,2052,2907,4786,2848
61367,846,404,442,101,200,103,99,197,146
61368,1489,731,758,218,355,158,214,364,180
61369,1631,756,875,205,382,169,217,372,286
61370,1322,663,659,171,353,139,153,332,174
61372,113,51,62,23,22,6,32,26,4
61373,2019,952,1067,307,504,141,332,540,195
61374,137,68,69,16,38,14,20,35,14
61375,1195,605,590,168,268,169,139,310,141
61376,2256,1106,1150,385,472,249,310,480,360
61377,1366,681,685,242,300,139,197,293,195
61378,586,276,310,80,152,44,117,147,46
61379,1391,687,704,211,364,112,204,352,148
61401,36541,18281,18260,5467,9603,3211,4930,8387,4943
61410,4134,2001,2133,609,1025,367,631,1015,487
61411,396,177,219,35,105,37,50,96,73
61412,1388,666,722,164,357,145,230,315,177
61413,1182,598,584,199,278,121,174,273,137
61414,1006,504,502,147,256,101,160,246,96
61415,1945,927,1018,253,466,208,272,479,267
61416,147,78,69,32,38,8,23,36,10
61417,329,179,150,34,113,32,33,88,29
61418,666,336,330,106,142,88,93,159,78
61419,53,24,29,4,12,8,6,13,10
61420,1253,628,625,207,315,106,175,313,137
61421,1455,730,725,230,350,150,193,347,185
61422,3626,1756,1870,525,894,337,538,888,444
61423,827,405,422,129,198,78,112,232,78
61424,149,72,77,20,35,17,21,39,17
61425,707,346,361,74,216,56,97,206,58
61426,111,71,40,55,14,2,10,14,16
61427,2316,1120,1196,325,564,231,306,585,305
61428,954,501,453,110,244,147,80,231,142
61430,721,354,367,99,194,61,95,210,62
61431,369,194,175,33,109,52,33,96,46
61432,712,359,353,105,162,92,112,138,103
61434,3542,1693,1849,473,912,308,503,858,488
61435,57,33,24,10,19,4,11,9,4
61436,992,512,480,138,287,87,110,275,95
61437,915,475,440,126,269,80,115,238,87
61438,774,387,387,123,194,70,126,176,85
61439,285,148,137,30,80,38,21,77,39
61440,857,442,415,154,209,79,125,196,94
61441,999,502,497,112,246,144,98,268,131
61442,931,495,436,163,246,86,134,211,91
61443,14404,6783,7621,2185,3215,1383,2155,3295,2171
61447,1117,558,559,155,292,111,149,291,119
61448,4201,2005,2196,630,961,414,521,1036,639
61449,522,243,279,43,123,77,89,117,73
61450,1846,877,969,282,426,169,288,412,269
61451,376,195,181,52,119,24,48,106,27
61452,346,188,158,66,100,22,45,87,26
61453,676,336,340,110,166,60,95,176,69
61454,765,373,392,88,214,71,130,182,80
61455,21632,10418,11214,4179,4835,1404,4698,4461,2055
61458,934,460,474,112,230,118,130,231,113
61459,402,203,199,48,114,41,64,97,38
61460,387,201,186,75,75,51,67,80,39
61462,12224,5831,6393,2046,2795,990,2045,2920,1428
61465,1092,550,542,172,263,115,127,245,170
61466,360,192,168,71,92,29,39,89,40
61467,1176,592,584,168,304,120,150,284,150
61468,134,78,56,40,31,7,29,21,6
61469,2531,1250,1281,359,613,278,353,633,295
61470,640,312,328,113,137,62,116,136,76
61471,152,77,75,26,34,17,19,37,19
61472,779,386,393,130,182,74,154,174,65
61473,1819,850,969,255,392,203,249,408,312
61474,397,198,199,59,98,41,54,86,59
61475,239,116,123,51,55,10,49,53,21
61476,396,199,197,55,107,37,41,116,40
61477,854,443,411,152,200,91,93,230,88
61478,302,130,172,23,77,30,48,75,49
61479,158,63,95,16,35,12,16,48,31
61480,1403,675,728,234,325,116,214,300,214
61482,594,287,307,82,148,57,94,153,60
61483,2120,958,1162,283,468,207,352,472,338
61484,975,523,452,186,236,101,109,236,107
61485,714,360,354,129,172,59,102,190,62
61486,1535,737,798,213,373,151,211,418,169
61488,1210,581,629,182,327,72,167,361,101
61489,995,503,492,150,257,96,105,235,152
61490,987,462,525,121,244,97,124,246,155
61491,2091,1038,1053,291,522,225,259,536,258
61501,2020,993,1027,296,489,208,313,450,264
61516,693,350,343,114,166,70,107,150,86
61517,3166,1589,1577,528,854,207,441,874,262
61519,242,123,119,50,58,15,34,58,27
61520,18717,9957,8760,2540,5757,1660,2261,3999,2500
61523,10776,5272,5504,1638,2821,813,1559,2796,1149
61524,140,66,74,26,28,12,20,38,16
61525,5357,2601,2756,888,1437,276,912,1519,325
61526,1210,600,610,183,317,100,214,315,81
61528,1653,813,840,234,434,145,273,426,141
61529,2665,1286,1379,381,660,245,393,671,315
61530,6126,2857,3269,1069,1288,500,1073,1312,884
61531,3375,1629,1746,473,834,322,478,809,459
61532,818,361,457,96,192,73,154,241,62
61533,2172,1036,1136,295,591,150,343,591,202
61534,1942,941,1001,310,506,125,323,532,146
61535,1496,766,730,273,435,58,226,416,88
61536,2925,1590,1335,450,913,227,387,713,235
61537,3019,1428,1591,410,722,296,453,660,478
61539,214,105,109,30,56,19,32,55,22
61540,2993,1462,1531,440,695,327,350,721,460
61541,170,77,93,14,56,7,22,57,14
61542,4021,1941,2080,536,970,435,528,924,628
61543,42,15,27,6,9,0,9,13,5
61544,669,338,331,114,135,89,88,155,88
61545,722,357,365,123,182,52,116,185,64
61546,4430,2322,2108,766,1189,367,544,1193,371
61547,3549,1836,1713,610,1019,207,470,1033,210
61548,10168,4955,5213,1645,2541,769,1628,2619,966
61550,17036,8203,8833,2547,4067,1589,2283,4366,2184
61552,166,93,73,36,57,0,16,49,8
61554,43422,21631,21791,6492,11582,3557,5910,11077,4804
61559,3092,1519,1573,504,724,291,489,748,336
61560,736,402,334,83,215,104,67,165,102
61561,2911,1440,1471,468,682,290,464,641,366
61563,533,282,251,91,126,65,62,131,58
61564,1002,466,536,162,238,66,205,268,63
61565,1814,948,866,307,516,125,266,498,102
61567,859,471,388,162,244,65,136,183,69
61568,4029,1972,2057,644,989,339,653,1005,399
61569,1198,604,594,143,304,157,119,302,173
61570,1786,946,840,364,449,133,262,393,185
61571,20436,9916,10520,3148,5258,1510,3010,5453,2057
61572,1070,533,537,151,270,112,128,270,139
61602,758,545,213,73,393,79,15,134,64
61603,19252,9198,10054,3624,4632,942,3315,5185,1554
61604,33582,15567,18015,4872,7933,2762,4722,8738,4555
61605,18461,8419,10042,3744,3546,1129,3815,4444,1783
61606,9737,4823,4914,2467,2072,284,2661,1842,411
61607,10414,4983,5431,1283,2693,1007,1481,2764,1186
61610,4970,2385,2585,693,1308,384,795,1317,473
61611,23695,11685,12010,3337,6054,2294,2974,6066,2970
61614,34495,16410,18085,4296,8722,3392,4146,8800,5139
61615,18547,8932,9615,2741,4966,1225,2577,5446,1592
61701,37270,17620,19650,5490,9717,2413,5941,9963,3746
61704,35552,17604,17948,6028,10091,1485,5700,10504,1744
61720,383,167,216,53,85,29,79,105,32
61721,645,322,323,112,160,50,96,172,55
61722,636,287,349,114,131,42,168,147,34
61723,2340,1116,1224,372,498,246,305,601,318
61724,636,326,310,118,157,51,102,150,58
61725,1308,697,611,248,366,83,165,369,77
61726,2804,1375,1429,437,682,256,366,660,403
61727,10275,4974,5301,1534,2600,840,1451,2571,1279
61728,1413,642,771,191,311,140,233,326,212
61729,1118,586,532,187,315,84,179,282,71
61730,369,182,187,48,98,36,38,106,43
61731,224,86,138,12,54,20,71,58,9
61732,2095,1030,1065,357,566,107,378,568,119
61733,1074,572,502,200,273,99,153,246,103
61734,3024,1523,1501,497,724,302,462,699,340
61735,386,193,193,46,108,39,50,102,41
61736,1379,698,681,252,381,65,211,393,77
61737,543,296,247,120,151,25,73,129,45
61738,4455,2159,2296,683,1150,326,664,1131,501
61739,4948,2393,2555,841,1140,412,809,1104,642
61740,1733,826,907,273,372,181,225,386,296
61741,1938,947,991,346,452,149,340,467,184
61742,911,476,435,191,229,56,147,229,59
61743,255,133,122,47,72,14,53,51,18
61744,2002,990,1012,362,480,148,334,474,204
61745,4227,2083,2144,688,1150,245,686,1142,316
61747,1560,789,771,268,362,159,193,329,249
61748,2538,1297,1241,422,677,198,354,677,210
61749,692,351,341,92,175,84,89,155,97
61750,116,58,58,20,24,14,8,42,8
61752,4095,1969,2126,543,1091,335,622,1015,489
61753,2903,1452,1451,474,802,176,451,736,264
61754,1283,628,655,204,333,91,186,352,117
61755,4045,2017,2028,714,1052,251,660,1073,295
61756,2069,1032,1037,335,534,163,279,540,218
61758,66,40,26,0,34,6,0,13,13
61759,1525,758,767,228,382,148,183,414,170
61760,2691,1324,1367,473,588,263,364,621,382
61761,45384,21433,23951,9281,10364,1788,11020,10266,2665
61764,14605,7837,6768,2187,4661,989,1832,3386,1550
61769,684,383,301,156,181,46,99,155,47
61770,1095,560,535,164,285,111,141,270,124
61771,591,284,307,87,144,53,106,151,50
61772,352,189,163,41,120,28,15,102,46
61773,561,277,284,73,137,67,72,148,64
61774,1099,515,584,167,276,72,209,284,91
61775,264,125,139,22,73,30,59,46,34
61776,1417,688,729,238,400,50,227,440,62
61777,1046,515,531,190,268,57,158,296,77
61778,677,348,329,94,186,68,109,153,67
61801,29293,15858,13435,7458,7223,1177,5162,6523,1750
61802,16500,7761,8739,2203,4427,1131,2384,4816,1539
61810,353,172,181,64,93,15,57,93,31
61811,852,425,427,138,238,49,157,229,41
61812,403,218,185,79,95,44,40,99,46
61813,2137,1061,1076,336,543,182,269,543,264
61814,1275,615,660,187,342,86,192,345,123
61815,167,72,95,14,46,12,37,46,12
61816,489,238,251,78,113,47,63,123,65
61817,2865,1287,1578,361,681,245,424,725,429
61818,1726,845,881,286,408,151,290,425,166
61820,33628,17694,15934,8833,7996,865,8327,6201,1406
61821,28901,13945,14956,4346,7558,2041,4157,8165,2634
61822,15152,7427,7725,2302,4189,936,2315,4392,1018
61830,567,284,283,84,151,49,82,153,48
61831,147,65,82,19,40,6,24,48,10
61832,39096,18544,20552,6239,8874,3431,5834,9729,4989
61833,2091,993,1098,294,514,185,274,536,288
61834,7795,4833,2962,1068,3200,565,868,1529,565
61839,611,322,289,105,160,57,88,138,63
61840,713,337,376,81,183,73,110,199,67
61841,1380,697,683,239,343,115,210,324,149
61842,2955,1471,1484,464,748,259,422,710,352
61843,2106,1053,1053,364,536,153,336,506,211
61844,1010,502,508,141,292,69,124,279,105
61845,1822,701,1121,377,232,92,845,147,129
61846,5319,2567,2752,880,1269,418,805,1365,582
61847,1200,571,629,170,291,110,161,287,181
61848,220,106,114,32,53,21,34,59,21
61849,1774,875,899,261,462,152,251,453,195
61850,442,211,231,53,102,56,67,99,65
61851,542,261,281,90,127,44,81,141,59
61852,277,147,130,63,67,17,49,66,15
61853,10655,5328,5327,2050,2735,543,1839,2903,585
61854,1524,748,776,205,425,118,213,425,138
61855,56,33,23,8,19,6,3,11,9
61856,6718,3160,3558,958,1633,569,943,1658,957
61857,179,87,92,21,57,9,32,45,15
61858,2895,1400,1495,441,720,239,442,775,278
61859,1276,600,676,218,308,74,252,303,121
61862,548,284,264,115,129,40,94,131,39
61863,886,425,461,129,220,76,129,237,95
61864,1580,796,784,290,401,105,277,380,127
61865,1408,729,679,293,350,86,220,358,101
61866,14239,6833,7406,2420,3516,897,2384,3780,1242
61870,1274,648,626,188,310,150,172,310,144
61871,210,98,112,24,56,18,32,57,23
61872,696,373,323,106,227,40,68,200,55
61873,5041,2478,2563,815,1335,328,745,1386,432
61874,4249,1916,2333,468,1204,244,541,1349,443
61875,743,343,400,101,219,23,145,220,35
61876,868,440,428,129,224,87,129,231,68
61877,1560,775,785,253,397,125,213,402,170
61878,1550,756,794,237,387,132,218,395,181
61880,3355,1707,1648,532,977,198,490,882,276
61882,665,347,318,108,163,76,81,164,73
61883,4595,2194,2401,597,1158,439,667,1105,629
61884,1202,623,579,251,268,104,216,273,90
61910,4383,2236,2147,832,1065,339,678,1023,446
61911,4149,1993,2156,748,920,325,753,911,492
61912,1458,721,737,198,406,117,192,439,106
61913,1888,876,1012,294,421,161,330,460,222
61914,1854,907,947,282,460,165,214,491,242
61917,670,356,314,119,181,56,91,139,84
61919,824,417,407,122,232,63,112,207,88
61920,24346,11435,12911,4684,5469,1282,5823,5220,1868
61924,2648,1257,1391,417,614,226,358,598,435
61925,966,483,483,150,274,59,148,274,61
61928,766,400,366,104,205,91,91,199,76
61929,741,408,333,123,225,60,87,174,72
61930,552,267,285,78,108,81,90,109,86
61931,1243,658,585,263,283,112,144,295,146
61932,500,243,257,69,101,73,51,121,85
61933,1345,662,683,225,330,107,200,326,157
61936,332,149,183,49,72,28,73,65,45
61937,2784,1377,1407,502,660,215,483,667,257
61938,22312,10724,11588,3349,5402,1973,3105,5521,2962
61940,272,124,148,33,68,23,49,72,27
61941,81,30,51,0,22,8,5,20,26
61942,1388,640,748,193,315,132,234,311,203
61943,1908,958,950,321,441,196,274,467,209
61944,13835,6734,7101,1974,3510,1250,1997,3215,1889
61949,110,50,60,13,28,9,18,30,12
61951,7199,3424,3775,1021,1669,734,947,1763,1065
61953,6249,3028,3221,1047,1402,579,852,1561,808
61956,2890,1412,1478,476,683,253,437,661,380
61957,1929,922,1007,284,479,159,300,500,207
62001,1568,760,808,195,381,184,158,380,270
62002,34082,16168,17914,5267,8126,2775,4884,8864,4166
62006,481,223,258,52,126,45,49,159,50
62009,2186,1017,1169,327,477,213,306,507,356
62010,10464,5061,5403,1802,2624,635,1575,2767,1061
62011,402,207,195,89,83,35,54,95,46
62012,6616,3207,3409,1076,1648,483,1087,1718,604
62013,736,358,378,95,188,75,124,178,76
62014,4188,2038,2150,655,986,397,688,1041,421
62015,560,265,295,54,155,56,77,127,91
62016,4002,1932,2070,584,930,418,547,961,562
62017,1339,671,668,215,319,137,190,310,168
62018,4264,2126,2138,681,1177,268,745,1002,391
62019,697,327,370,82,179,66,151,154,65
62021,911,421,490,93,265,63,152,252,86
62022,846,420,426,86,249,85,82,256,88
62023,104,55,49,14,30,11,18,22,9
62024,12587,6068,6519,1769,3099,1200,1816,3116,1587
62025,29933,14161,15772,4658,7511,1992,5489,7695,2588
62027,589,316,273,115,149,52,84,148,41
62028,1265,597,668,239,312,46,359,279,30
62030,128,64,64,22,26,16,21,25,18
62031,1174,584,590,173,313,98,203,316,71
62032,714,364,350,144,161,59,113,165,72
62033,5110,2516,2594,795,1242,479,652,1295,647
62034,12083,5798,6285,1835,3194,769,1783,3481,1021
62035,15694,7705,7989,2218,3978,1509,1959,4093,1937
62036,558,297,261,74,151,72,54,132,75
62037,1865,1010,855,384,454,172,209,472,174
62040,46056,22393,23663,7250,11363,3780,6791,11745,5127
62044,2089,998,1091,342,470,186,340,497,254
62045,561,323,238,87,168,68,43,122,73
62046,400,175,225,56,87,32,67,107,51
62047,1561,769,792,243,379,147,220,335,237
62048,1539,771,768,218,399,154,211,379,178
62049,6879,3284,3595,1048,1580,656,927,1681,987
62050,562,272,290,92,130,50,91,120,79
62051,2958,2472,486,381,1973,118,140,235,111
62052,12256,5793,6463,1889,2976,928,1939,2982,1542
62053,815,402,413,101,205,96,132,191,90
62054,891,479,412,171,223,85,127,192,93
62056,8877,4223,4654,1349,2070,804,1279,2181,1194
62058,792,406,386,139,199,68,117,169,100
62059,576,248,328,55,141,52,74,112,142
62060,5890,2852,3038,1028,1317,507,946,1408,684
62061,1346,657,689,184,341,132,219,338,132
62062,4428,2115,2313,653,1157,305,645,1200,468
62063,1229,634,595,231,306,97,209,279,107
62065,131,78,53,25,29,24,16,24,13
62067,2212,1088,1124,318,544,226,325,559,240
62069,3354,1637,1717,516,816,305,452,800,465
62070,64,22,42,1,8,13,13,9,20
62074,1215,650,565,230,284,136,161,269,135
62075,3693,1780,1913,542,814,424,521,836,556
62077,125,58,67,17,31,10,7,38,22
62078,113,62,51,23,30,9,15,28,8
62079,160,91,69,35,43,13,9,48,12
62080,2546,1264,1282,382,611,271,439,608,235
62081,304,146,158,28,75,43,21,86,51
62082,3298,1685,1613,584,846,255,501,770,342
62083,239,152,87,70,58,24,18,42,27
62084,1448,717,731,199,383,135,192,341,198
62085,32,17,15,5,5,7,0,7,8
62086,1604,793,811,235,372,186,234,389,188
62087,1876,918,958,313,478,127,307,508,143
62088,6790,3303,3487,1070,1618,615,934,1680,873
62089,298,160,138,62,75,23,38,66,34
62090,1598,702,896,341,306,55,327,464,105
62091,329,162,167,43,78,41,52,82,33
62092,3115,1423,1692,409,710,304,485,713,494
62093,362,156,206,46,72,38,83,71,52
62094,1300,616,684,180,328,108,202,327,155
62095,10386,4743,5643,1486,2373,884,1615,2501,1527
62097,2507,1227,1280,352,643,232,338,684,258
62201,8609,3967,4642,1834,1632,501,1758,2057,827
62203,10100,5107,4993,1793,2630,684,1684,2402,907
62204,10629,4901,5728,2290,2171,440,2316,2783,629
62205,10384,4718,5666,1744,2238,736,1807,2521,1338
62206,18315,8598,9717,3659,3844,1095,3650,4556,1511
62207,9800,4388,5412,2049,1807,532,1941,2439,1032
62208,14863,7163,7700,2034,3854,1275,2061,3848,1791
62214,1286,664,622,218,323,123,180,327,115
62215,1197,626,571,261,281,84,180,291,100
62216,956,474,482,164,232,78,120,261,101
62217,4156,3672,484,486,3059,127,140,221,123
62218,1461,759,702,260,410,89,270,344,88
62219,996,494,502,174,244,76,169,215,118
62220,19820,9507,10313,3101,4949,1457,2826,5378,2109
62221,22232,10711,11521,3653,5810,1248,3580,6227,1714
62223,17290,8210,9080,2456,4051,1703,2167,4558,2355
62225,5352,2691,2661,1324,1367,0,1306,1342,13
62226,26999,12549,14450,3730,6563,2256,3785,7034,3631
62230,5688,2815,2873,978,1384,453,833,1483,557
62231,6939,3436,3503,1114,1664,658,962,1601,940
62232,7115,3546,3569,1078,1845,623,826,1904,839
62233,6456,3328,3128,954,1775,599,741,1482,905
62234,31980,15559,16421,4786,8339,2434,4483,8441,3497
62236,10464,5236,5228,1673,2739,824,1396,2726,1106
62237,3168,1552,1616,491,810,251,515,805,296
62238,779,360,419,134,194,32,165,200,54
62239,4740,2235,2505,644,1305,286,727,1308,470
62240,2136,1072,1064,447,513,112,409,552,103
62241,1169,548,621,158,258,132,227,270,124
62242,1402,717,685,213,369,135,173,317,195
62243,5601,2670,2931,866,1381,423,911,1456,564
62244,1393,676,717,252,354,70,289,370,58
62245,2452,1250,1202,426,632,192,359,580,263
62246,9898,5577,4321,1401,3397,779,1340,1875,1106
62249,13601,6522,7079,2235,3232,1055,2136,3472,1471
62250,443,208,235,65,110,33,54,123,58
62253,793,386,407,93,174,119,72,200,135
62254,5353,2611,2742,929,1297,385,841,1283,618
62255,1135,572,563,232,259,81,199,261,103
62257,3932,1881,2051,572,925,384,639,946,466
62258,7351,3593,3758,1157,1899,537,1124,1841,793
62260,5875,2964,2911,987,1483,494,760,1590,561
62261,250,131,119,43,60,28,60,47,12
62262,1909,975,934,317,465,193,276,441,217
62263,5436,2689,2747,863,1362,464,684,1384,679
62264,3293,1603,1690,522,793,288,513,784,393
62265,4116,1999,2117,659,1030,310,712,1050,355
62266,128,73,55,25,38,10,8,25,22
62268,732,350,382,109,166,75,142,168,72
62269,26223,12652,13571,4451,6921,1280,4300,7474,1797
62271,2005,1013,992,286,524,203,285,458,249
62272,1581,752,829,221,389,142,233,385,211
62273,41,26,15,10,16,0,4,6,5
62274,8571,5182,3389,1149,3403,630,906,1573,910
62275,3720,1908,1812,650,991,267,575,912,325
62277,1476,726,750,224,382,120,244,366,140
62278,6694,3290,3404,1043,1649,598,880,1685,839
62279,0,0,0,0,0,0,0,0,0
62280,492,255,237,94,117,44,53,131,53
62281,1718,856,862,279,423,154,285,437,140
62283,712,362,350,118,148,96,89,174,87
62284,647,317,330,118,143,56,126,154,50
62285,2913,1470,1443,491,765,214,408,797,238
62286,6454,3087,3367,1033,1539,515,1001,1603,763
62288,2975,1449,1526,419,744,286,370,732,424
62289,316,163,153,57,89,17,56,68,29
62292,613,289,324,100,140,49,88,169,67
62293,4598,2266,2332,721,1198,347,684,1157,491
62294,12383,6194,6189,2263,3391,540,2030,3425,734
62295,929,463,466,154,259,50,121,261,84
62297,400,191,209,49,78,64,63,78,68
62298,13985,6770,7215,2182,3528,1060,2173,3554,1488
62301,52578,25094,27484,7989,12068,5037,8087,12473,6924
62311,951,463,488,127,233,103,142,199,147
62312,2183,1002,1181,261,509,232,321,509,351
62313,360,185,175,45,108,32,47,81,47
62314,691,357,334,135,171,51,116,149,69
62316,739,356,383,107,176,73,120,193,70
62318,368,198,170,65,98,35,42,93,35
62319,255,131,124,31,68,32,21,73,30
62320,2286,1078,1208,394,495,189,401,559,248
62321,4385,2020,2365,600,981,439,674,1019,672
62323,344,177,167,41,96,40,50,91,26
62324,1463,809,654,236,422,151,206,280,168
62325,495,233,262,82,109,42,90,130,42
62326,2584,1269,1315,416,603,250,343,655,317
62330,1673,785,888,204,392,189,222,438,228
62334,158,76,82,23,43,10,22,38,22
62336,75,47,28,17,19,11,3,15,10
62338,1321,621,700,192,338,91,220,367,113
62339,1105,505,600,152,239,114,186,229,185
62340,1783,887,896,287,421,179,270,430,196
62341,3679,1794,1885,577,884,333,443,951,491
62343,807,404,403,109,210,85,123,192,88
62344,208,100,108,23,75,2,47,56,5
62345,434,214,220,74,104,36,66,110,44
62346,157,78,79,9,40,29,22,33,24
62347,2185,1096,1089,334,585,177,302,587,200
62348,266,121,145,37,70,14,56,66,23
62349,639,308,331,96,170,42,121,168,42
62351,1812,876,936,273,438,165,255,435,246
62352,353,156,197,49,67,40,51,81,65
62353,5582,3731,1851,760,2611,360,484,868,499
62354,1567,779,788,272,332,175,180,373,235
62355,887,447,440,122,237,88,118,216,106
62356,706,333,373,111,140,82,121,156,96
62357,297,157,140,62,67,28,34,74,32
62358,672,354,318,104,187,63,92,149,77
62359,141,70,71,16,39,15,13,45,13
62360,1732,870,862,318,420,132,274,437,151
62361,558,292,266,98,126,68,87,124,55
62362,413,196,217,54,85,57,47,87,83
62363,6334,3193,3141,928,1572,693,758,1388,995
62365,674,348,326,127,163,58,109,151,66
62366,1459,738,721,257,313,168,178,343,200
62367,1409,718,691,283,337,98,221,346,124
62370,664,318,346,117,168,33,102,197,47
62373,459,232,227,93,100,39,88,101,38
62374,285,143,142,32,74,37,26,62,54
62375,335,157,178,52,92,13,71,90,17
62376,1124,555,569,171,265,119,163,269,137
62378,934,489,445,170,206,113,136,204,105
62379,2237,1097,1140,333,561,203,332,562,246
62380,493,292,201,118,124,50,63,105,33
62401,18811,9159,9652,3012,4690,1457,2850,4651,2151
62410,1089,560,529,226,252,82,174,252,103
62411,4075,1991,2084,646,996,349,631,980,473
62413,456,224,232,56,118,50,103,101,28
62414,1658,838,820,258,447,133,252,420,148
62417,3289,1579,1710,489,767,323,491,799,420
62418,2025,966,1059,309,470,187,315,458,286
62419,400,212,188,75,107,30,51,95,42
62420,5015,2351,2664,678,1182,491,688,1217,759
62421,786,416,370,144,197,75,126,166,78
62422,1190,582,608,189,300,93,193,287,128
62423,684,344,340,105,187,52,114,158,68
62424,1988,1024,964,423,475,126,360,455,149
62425,758,353,405,106,140,107,150,146,109
62426,1231,577,654,196,305,76,237,273,144
62427,1868,929,939,296,457,176,281,433,225
62428,3210,1593,1617,519,748,326,410,734,473
62431,1200,638,562,216,294,128,153,266,143
62432,552,261,291,58,141,62,64,151,76
62433,1065,572,493,150,290,132,107,232,154
62434,469,202,267,38,88,76,18,78,171
62436,547,274,273,97,126,51,79,141,53
62438,446,236,210,83,119,34,68,113,29
62439,8034,3770,4264,1030,1830,910,940,1864,1460
62440,1470,705,765,223,383,99,237,404,124
62441,7330,3572,3758,1042,1777,753,966,1797,995
62442,2535,1284,1251,411,644,229,342,597,312
62443,1645,888,757,345,410,133,236,381,140
62444,341,176,165,39,96,41,30,98,37
62445,1135,587,548,233,285,69,218,269,61
62446,427,206,221,69,88,49,59,91,71
62447,3715,1793,1922,596,917,280,608,914,400
62448,6252,3024,3228,1053,1456,515,1015,1485,728
62449,3208,1531,1677,457,739,335,424,808,445
62450,12009,5736,6273,1835,2736,1165,1672,2979,1622
62451,2233,1043,1190,308,526,209,304,582,304
62452,363,169,194,29,114,26,55,102,37
62454,11831,6385,5446,1819,3548,1018,1475,2552,1419
62458,2266,1098,1168,357,519,222,362,531,275
62459,251,98,153,17,39,42,44,61,48
62460,1152,572,580,176,272,124,157,296,127
62461,807,432,375,156,195,81,118,180,77
62462,1291,637,654,257,309,71,264,293,97
62463,1390,692,698,245,329,118,181,344,173
62465,948,455,493,126,219,110,130,197,166
62466,2617,1316,1301,441,630,245,365,628,308
62467,3691,1926,1765,791,892,243,662,794,309
62468,2452,1221,1231,386,626,209,340,555,336
62469,371,201,170,81,74,46,48,77,45
62471,10109,5539,4570,1479,3257,803,1302,2061,1207
62473,1579,772,807,317,410,45,310,432,65
62474,993,485,508,171,223,91,143,246,119
62475,436,207,229,61,113,33,89,106,34
62476,1896,965,931,299,473,193,222,465,244
62477,1170,583,587,202,321,60,197,287,103
62478,393,214,179,74,113,27,43,88,48
62479,745,396,349,131,181,84,88,157,104
62480,945,467,478,158,207,102,181,215,82
62481,427,212,215,69,129,14,86,96,33
62501,1629,813,816,257,445,111,257,417,142
62510,1786,821,965,241,405,175,277,452,236
62511,177,79,98,12,45,22,25,51,22
62512,537,282,255,84,166,32,91,100,64
62513,1792,865,927,241,472,152,309,437,181
62514,298,156,142,48,97,11,22,97,23
62515,957,484,473,144,273,67,136,256,81
62517,240,113,127,34,52,27,22,59,46
62518,537,281,256,98,123,60,64,129,63
62519,119,46,73,21,25,0,44,23,6
62520,1490,735,755,253,374,108,204,421,130
62521,37431,17706,19725,5347,9046,3313,5712,9587,4426
62522,18497,8803,9694,3416,4161,1226,3548,4503,1643
62523,853,482,371,152,282,48,83,115,173
62526,36271,16869,19402,5248,8540,3081,4980,9438,4984
62530,1569,767,802,258,412,97,264,421,117
62531,1959,975,984,269,530,176,283,496,205
62532,51,24,27,9,15,0,20,7,0
62533,1031,491,540,134,281,76,178,262,100
62534,1228,625,603,214,288,123,158,315,130
62535,2547,1228,1319,379,636,213,402,679,238
62536,898,438,460,119,271,48,141,250,69
62537,125,58,67,18,28,12,19,30,18
62538,432,213,219,76,106,31,64,111,44
62539,1381,672,709,204,383,85,228,366,115
62540,1434,694,740,237,323,134,210,357,173
62541,57,39,18,12,20,7,0,11,7
62543,536,285,251,86,146,53,72,134,45
62544,1654,801,853,258,385,158,232,378,243
62545,1053,553,500,165,315,73,135,267,98
62546,1712,847,865,299,367,181,258,412,195
62547,812,406,406,121,222,63,111,205,90
62548,2370,1111,1259,319,502,290,325,525,409
62549,5749,2927,2822,967,1605,355,859,1541,422
62550,3046,1443,1603,468,723,252,459,771,373
62551,858,447,411,168,208,71,129,210,72
62552,1007,499,508,104,281,114,114,289,105
62553,499,237,262,54,128,55,86,127,49
62554,1768,881,887,265,460,156,234,525,128
62555,606,315,291,100,166,49,72,187,32
62556,480,227,253,74,107,46,86,109,58
62557,7716,3626,4090,1092,1768,766,1112,1798,1180
62558,3483,1675,1808,538,893,244,546,967,295
62560,1392,653,739,186,319,148,185,370,184
62561,4691,2307,2384,760,1282,265,700,1309,375
62563,4912,2402,2510,830,1261,311,724,1385,401
62565,7684,3723,3961,1100,1784,839,1106,1784,1071
62567,1178,579,599,183,272,124,180,277,142
62568,16213,8431,7782,2392,4656,1383,2000,3739,2043
62570,527,259,268,83,118,58,86,136,46
62571,1401,689,712,182,365,142,194,358,160
62572,552,292,260,132,132,28,79,132,49
62573,1655,821,834,295,442,84,256,464,114
62601,533,275,258,90,148,37,64,154,40
62610,241,122,119,44,65,13,31,71,17
62611,1187,577,610,171,306,100,178,325,107
62612,1989,1008,981,328,518,162,260,536,185
62613,3436,1728,1708,619,859,250,507,913,288
62615,5442,2628,2814,982,1343,303,911,1434,469
62617,764,366,398,109,176,81,108,188,102
62618,7518,3814,3704,1293,1890,631,1001,1823,880
62621,1197,574,623,192,288,94,197,308,118
62624,630,332,298,79,158,95,50,129,119
62625,812,433,379,164,219,50,98,231,50
62626,8520,4167,4353,1395,1953,819,1191,1959,1203
62627,1113,575,538,157,314,104,126,304,108
62628,1027,542,485,182,261,99,140,254,91
62629,9488,4668,4820,1725,2427,516,1516,2637,667
62630,619,286,333,90,137,59,106,163,64
62631,240,130,110,35,59,36,26,55,29
62633,739,375,364,130,162,83,125,156,83
62634,961,447,514,153,229,65,162,256,96
62635,755,394,361,161,150,83,103,146,112
62638,1453,745,708,261,388,96,229,358,121
62639,349,168,181,23,111,34,64,84,33
62640,3787,1870,1917,550,904,416,542,888,487
62642,1556,782,774,265,393,124,222,395,157
62643,397,200,197,79,91,30,70,91,36
62644,5798,2771,3027,755,1371,645,824,1361,842
62649,586,283,303,89,156,38,96,140,67
62650,27552,13616,13936,4219,7078,2319,4102,6469,3365
62655,709,349,360,137,169,43,88,190,82
62656,20752,10475,10277,3133,5855,1487,2815,5226,2236
62661,1387,689,698,237,367,85,230,357,111
62663,344,156,188,54,77,25,68,84,36
62664,3320,1580,1740,465,782,333,475,757,508
62665,1695,837,858,258,403,176,250,423,185
62666,695,331,364,117,178,36,136,170,58
62667,601,309,292,97,155,57,83,144,65
62668,1560,805,755,267,391,147,251,378,126
62670,2585,1249,1336,342,716,191,429,670,237
62671,737,366,371,109,169,88,104,183,84
62672,295,166,129,62,72,32,34,67,28
62673,621,306,315,103,124,79,103,119,93
62674,1509,768,741,211,373,184,184,380,177
62675,5960,2848,3112,889,1476,483,835,1565,712
62677,2512,1252,1260,410,637,205,369,687,204
62681,5083,2467,2616,743,1209,515,626,1256,734
62682,994,487,507,129,263,95,152,240,115
62684,3902,1886,2016,653,976,257,595,1053,368
62685,2167,1105,1062,359,539,207,294,519,249
62686,160,86,74,34,50,2,22,40,12
62688,920,458,462,121,261,76,149,228,85
62689,545,296,249,120,120,56,46,129,74
62690,4113,1914,2199,592,1021,301,606,1040,553
62691,2620,1252,1368,388,620,244,361,641,366
62692,2073,963,1110,300,464,199,329,538,243
62693,1665,824,841,256,419,149,259,403,179
62694,3348,1598,1750,478,818,302,500,785,465
62695,443,190,253,60,117,13,80,124,49
62701,1168,699,469,80,548,71,9,265,195
62702,39513,18429,21084,5532,9790,3107,5719,10533,4832
62703,31215,14451,16764,4949,7279,2223,5002,8452,3310
62704,41095,19095,22000,5213,10624,3258,5078,11575,5347
62707,27292,13409,13883,4278,7319,1812,3786,8078,2019
62801,24056,12191,11865,3547,6751,1893,3214,5722,2929
62803,919,443,476,151,210,82,161,203,112
62806,3438,1634,1804,461,804,369,455,816,533
62807,877,433,444,133,220,80,140,215,89
62808,1460,731,729,186,402,143,227,329,173
62809,219,116,103,30,64,22,27,63,13
62810,975,494,481,163,243,88,152,234,95
62811,394,216,178,75,103,38,41,97,40
62812,11159,5260,5899,1535,2616,1109,1543,2691,1665
62814,2095,1019,1076,315,530,174,356,531,189
62815,469,232,237,84,128,20,73,137,27
62816,1269,639,630,159,378,102,169,328,133
62817,698,335,363,106,174,55,112,161,90
62818,344,170,174,59,70,41,55,87,32
62819,475,249,226,69,128,52,56,123,47
62820,190,90,100,22,41,27,25,45,30
62821,7924,3717,4207,899,1898,920,1038,1894,1275
62822,2898,1380,1518,418,639,323,341,702,475
62823,1696,821,875,255,408,158,232,384,259
62824,1925,943,982,301,464,178,267,456,259
62825,223,114,109,38,60,16,29,57,23
62827,1243,617,626,160,308,149,137,321,168
62828,1523,754,769,214,398,142,238,387,144
62829,170,76,94,19,48,9,27,67,0
62830,1455,712,743,219,381,112,201,357,185
62831,642,292,350,97,136,59,105,155,90
62832,9717,4683,5034,1428,2344,911,1382,2327,1325
62833,375,190,185,52,93,45,50,87,48
62835,1291,594,697,190,280,124,186,287,224
62836,776,379,397,120,184,75,129,189,79
62837,9098,4343,4755,1301,2111,931,1198,2139,1418
62838,1487,752,735,264,366,122,230,353,152
62839,6744,3134,3610,945,1514,675,925,1591,1094
62842,824,437,387,165,194,78,102,188,97
62843,135,72,63,24,35,13,19,32,12
62844,2266,1067,1199,343,544,180,344,517,338
62846,2738,2332,406,314,1864,154,133,189,84
62848,752,374,378,141,184,49,127,193,58
62849,2212,1088,1124,361,577,150,391,537,196
62850,665,357,308,117,178,62,97,154,57
62851,367,188,179,70,88,30,50,88,41
62852,232,128,104,39,65,24,33,54,17
62853,911,470,441,118,253,99,124,241,76
62854,1891,948,943,315,452,181,261,462,220
62857,113,66,47,8,42,16,17,16,14
62858,3123,1536,1587,406,785,345,452,727,408
62859,5575,2698,2877,858,1215,625,712,1235,930
62860,654,329,325,112,165,52,101,166,58
62861,185,93,92,25,52,16,13,59,20
62862,423,227,196,71,114,42,45,103,48
62863,10901,5315,5586,1611,2748,956,1556,2577,1453
62864,24927,11921,13006,3862,5840,2219,3569,6090,3347
62865,1931,982,949,305,505,172,262,494,193
62867,654,327,327,92,175,60,78,179,70
62868,1897,914,983,299,453,162,316,484,183
62869,2619,1240,1379,348,671,221,373,704,302
62870,2182,1035,1147,334,533,168,364,512,271
62871,822,414,408,137,184,93,128,182,98
62872,1414,684,730,256,337,91,262,383,85
62874,73,34,39,15,16,3,9,27,3
62875,1248,625,623,216,304,105,175,308,140
62876,353,162,191,36,47,79,19,48,124
62877,598,296,302,102,151,43,100,143,59
62878,419,211,208,50,114,47,51,102,55
62879,108,55,53,21,14,20,11,29,13
62880,718,369,349,130,142,97,91,147,111
62881,11804,5685,6119,1766,2813,1106,1639,2932,1548
62882,2676,1341,1335,490,667,184,406,668,261
62883,584,302,282,59,157,86,77,130,75
62884,3130,1452,1678,364,758,330,499,749,430
62885,850,466,384,158,195,113,120,167,97
62886,393,198,195,51,98,49,63,84,48
62887,343,170,173,47,80,43,59,66,48
62888,2136,1068,1068,323,542,203,287,538,243
62889,964,501,463,173,231,97,128,236,99
62890,2659,1356,1303,449,713,194,401,692,210
62891,558,272,286,99,128,45,62,147,77
62892,439,238,201,106,102,30,51,97,53
62893,992,527,465,146,291,90,119,231,115
62894,960,491,469,151,236,104,135,227,107
62895,2204,1034,1170,345,451,238,369,527,274
62896,12949,6204,6745,1822,3149,1233,1763,3214,1768
62897,327,157,170,46,83,28,56,82,32
62898,1933,952,981,316,512,124,320,498,163
62899,1480,737,743,224,393,120,241,355,147
62901,30067,15426,14641,4901,9102,1423,4986,7617,2038
62905,614,299,315,71,168,60,96,158,61
62906,7814,3671,4143,908,1972,791,1091,1864,1188
62907,2234,1108,1126,370,569,169,335,603,188
62908,505,260,245,71,140,49,68,128,49
62910,2793,1348,1445,449,711,188,436,748,261
62912,1179,606,573,185,314,107,172,318,83
62914,4033,1755,2278,637,755,363,732,978,568
62915,178,75,103,28,43,4,37,54,12
62916,731,347,384,99,175,73,116,166,102
62917,2563,1215,1348,363,593,259,357,604,387
62918,8596,4217,4379,1371,2280,566,1259,2334,786
62919,1159,627,532,163,361,103,140,251,141
62920,3193,1602,1591,544,743,315,415,816,360
62921,353,174,179,61,99,14,53,77,49
62922,2912,1504,1408,422,711,371,356,667,385
62923,437,234,203,52,135,47,53,95,55
62924,2759,1342,1417,405,725,212,405,792,220
62926,2383,1221,1162,402,553,266,301,604,257
62927,355,152,203,44,84,24,73,77,53
62928,237,101,136,34,48,19,38,68,30
62930,6695,3140,3555,972,1422,746,992,1478,1085
62931,1582,801,781,197,404,200,169,409,203
62932,1677,830,847,266,427,137,237,418,192
62933,1012,463,549,96,239,128,127,243,179
62934,1118,529,589,157,238,134,151,297,141
62935,2067,979,1088,273,527,179,313,481,294
62938,3176,1618,1558,546,747,325,382,767,409
62939,2900,1437,1463,345,783,309,392,725,346
62940,413,184,229,57,97,30,66,117,46
62941,829,398,431,119,196,83,116,216,99
62942,777,367,410,107,190,70,161,176,73
62943,642,306,336,82,139,85,105,149,82
62946,14357,7001,7356,2462,3294,1245,1737,3548,2071
62947,608,334,274,115,194,25,71,175,28
62948,11853,5402,6451,1531,2720,1151,1665,2980,1806
62949,624,307,317,86,171,50,91,158,68
62950,192,82,110,11,53,18,16,50,44
62951,5437,2597,2840,848,1310,439,729,1423,688
62952,3452,1656,1796,525,829,302,494,888,414
62953,402,206,196,77,85,44,64,82,50
62954,688,307,381,115,167,25,150,189,42
62956,1001,471,530,165,193,113,155,232,143
62957,1139,540,599,161,277,102,182,268,149
62958,1779,953,826,294,560,99,191,532,103
62959,24935,12289,12646,3475,6405,2409,3235,6110,3301
62960,11338,5436,5902,1611,2712,1113,1387,2787,1728
62962,55,33,22,9,14,10,0,14,8
62963,710,282,428,135,116,31,169,181,78
62964,1641,783,858,318,297,168,257,378,223
62966,20227,10307,9920,4657,4289,1361,3834,4187,1899
62967,339,171,168,55,91,25,62,77,29
62969,872,411,461,128,229,54,121,209,131
62970,747,340,407,87,173,80,144,161,102
62972,472,250,222,127,103,20,85,108,29
62974,1202,610,592,166,331,113,166,317,109
62975,230,119,111,53,66,0,62,37,12
62976,677,343,334,123,161,59,90,164,80
62977,551,295,256,111,116,68,57,160,39
62979,1373,664,709,178,325,161,141,347,221
62982,1472,657,815,162,343,152,204,370,241
62983,1441,675,766,190,333,152,195,372,199
62984,2090,1003,1087,286,510,207,280,513,294
62985,928,477,451,113,247,117,113,216,122
62987,878,406,472,91,241,74,154,214,104
62988,2230,1302,928,313,839,150,254,452,222
62990,1058,557,501,171,235,151,129,271,101
62991,806,399,407,110,212,77,83,251,73
62992,1104,579,525,228,289,62,150,226,149
62993,183,77,106,41,27,9,38,35,33
62994,801,493,308,259,187,47,90,159,59
62995,5841,4154,1687,937,2859,358,445,781,461
62996,742,424,318,138,229,57,96,163,59
62997,668,330,338,127,149,54,91,169,78
62998,433,238,195,70,161,7,67,85,43
62999,1718,830,888,227,432,171,206,410,272
63005,16591,8283,8308,2993,4532,758,2896,4761,651
63010,36636,18101,18535,6144,9896,2061,5563,10091,2881
63011,38402,18519,19883,6044,9608,2867,5767,10309,3807
63012,9239,4743,4496,1760,2600,383,1514,2651,331
63013,1605,823,782,293,429,101,270,386,126
63014,776,387,389,111,214,62,123,201,65
63015,2225,1195,1030,382,664,149,372,532,126
63016,7838,3900,3938,1387,2014,499,1430,1967,541
63017,42705,20233,22472,5611,10441,4181,5406,11402,5664
63019,4114,1976,2138,611,977,388,592,996,550
63020,20397,9990,10407,3283,5206,1501,3211,5376,1820
63021,54387,26266,28121,9120,14552,2594,8897,15944,3280
63023,5050,2595,2455,941,1335,319,766,1395,294
63025,10583,5237,5346,1855,2914,468,1713,2924,709
63026,41559,20687,20872,7168,11660,1859,6685,11864,2323
63028,22902,11111,11791,3701,5784,1626,3635,5897,2259
63030,366,177,189,64,93,20,59,105,25
63031,49957,23748,26209,7998,12399,3351,7359,13567,5283
63033,45471,21048,24423,7011,10463,3574,6767,12289,5367
63034,16981,8232,8749,2683,4325,1224,2547,4754,1448
63036,934,521,413,151,264,106,86,223,104
63037,3211,1661,1550,524,855,282,493,748,309
63038,4884,2358,2526,813,1288,257,944,1329,253
63039,871,462,409,130,251,81,98,237,74
63040,8339,4080,4259,1585,2214,281,1422,2481,356
63041,268,133,135,45,67,21,27,97,11
63042,19060,9167,9893,2823,5114,1230,2681,5488,1724
63043,22623,11044,11579,3036,6539,1469,2791,6816,1972
63044,14269,6857,7412,1990,3606,1261,1758,3768,1886
63048,2464,1181,1283,405,521,255,290,517,476
63049,13886,6973,6913,2390,3968,615,2168,4043,702
63050,13211,6637,6574,2291,3549,797,2069,3644,861
63051,13555,6714,6841,2410,3707,597,2340,3712,789
63052,19420,9718,9702,3581,5260,877,3274,5455,973
63055,1754,935,819,320,464,151,206,481,132
63056,2019,1015,1004,305,486,224,294,508,202
63060,2511,1282,1229,447,634,201,396,666,167
63061,218,107,111,27,53,27,35,59,17
63068,4559,2215,2344,760,1105,350,741,1107,496
63069,15419,8083,7336,2459,4725,899,2286,3886,1164
63070,5892,2952,2940,1064,1559,329,952,1576,412
63071,1064,539,525,186,270,83,195,239,91
63072,2871,1428,1443,449,797,182,421,898,124
63074,15182,7253,7929,2171,3917,1165,1821,4148,1960
63077,11302,5630,5672,1973,2939,718,1725,2854,1093
63080,12594,6033,6561,1987,3011,1035,1967,3189,1405
63084,13839,6804,7035,2371,3559,874,2266,3508,1261
63087,853,397,456,128,237,32,156,230,70
63088,8492,4040,4452,1301,2359,380,1166,2611,675
63089,5839,2911,2928,954,1549,408,994,1537,397
63090,21002,10287,10715,3485,5330,1472,3342,5194,2179
63091,1247,614,633,167,305,142,178,282,173
63101,1387,653,734,129,301,223,121,371,242
63102,1284,914,370,17,857,40,22,253,95
63103,4558,2174,2384,475,1333,366,686,959,739
63104,19192,9405,9787,3187,5447,771,3113,5274,1400
63105,14335,7181,7154,1888,4265,1028,1664,4061,1429
63106,10530,4278,6252,2138,1442,698,2350,2748,1154
63107,16329,7652,8677,3519,3126,1007,3157,3918,1602
63108,21100,10145,10955,2399,6228,1518,2674,5787,2494
63109,29079,13380,15699,3362,7776,2242,3417,8433,3849
63110,20351,9680,10671,3819,4955,906,3704,5522,1445
63111,21624,10256,11368,3419,5536,1301,3373,5547,2448
63112,23062,10496,12566,3646,5440,1410,3804,6224,2538
63113,15781,7272,8509,2689,3330,1253,2564,3725,2220
63114,38509,18313,20196,5922,9671,2720,6007,10300,3889
63115,25168,11294,13874,4335,4940,2019,4264,6130,3480
63116,46811,22770,24041,7125,13037,2608,6323,12935,4783
63117,9627,4349,5278,1038,2639,672,1015,2991,1272
63118,30311,14312,15999,5888,7148,1276,6102,7836,2061
63119,34232,15619,18613,4752,8196,2671,4646,9019,4948
63120,12997,5956,7041,2786,2342,828,2662,3062,1317
63121,29294,13323,15971,4815,6756,1752,4669,8402,2900
63122,38779,17835,20944,5433,9148,3254,5082,10453,5409
63123,49742,23305,26437,6291,11922,5092,5953,12613,7871
63124,9788,4464,5324,1217,2021,1226,1131,2226,1967
63125,33249,15699,17550,4628,7979,3092,4084,8616,4850
63126,15323,7288,8035,1925,3455,1908,1770,3831,2434
63127,4817,2265,2552,632,979,654,509,1036,1007
63128,29096,13869,15227,3716,6768,3385,3570,7361,4296
63129,51243,24997,26246,8290,13384,3323,7655,14171,4420
63130,34643,16199,18444,6231,8046,1922,6169,9519,2756
63131,16511,8055,8456,2476,3846,1733,2366,4228,1862
63132,13920,6542,7378,1959,3455,1128,1799,3971,1608
63133,8618,3854,4764,1679,1709,466,1675,2364,725
63134,15051,6892,8159,2725,3282,885,2709,4174,1276
63135,21788,10027,11761,3952,4662,1413,3771,5850,2140
63136,53465,23458,30007,10063,10712,2683,10460,15149,4398
63137,21186,9890,11296,3554,4680,1656,3372,5557,2367
63138,21872,10332,11540,4080,4969,1283,3722,6083,1735
63139,24329,11667,12662,2935,7143,1589,2602,7085,2975
63140,775,372,403,208,132,32,171,199,33
63141,19824,9535,10289,2627,4789,2119,2665,5013,2611
63143,11014,5433,5581,1267,3632,534,1296,3446,839
63144,9101,4235,4866,1179,2487,569,949,2940,977
63146,29828,14105,15723,3247,8178,2680,3435,8688,3600
63147,13268,6458,6810,2357,3364,737,2035,3466,1309
63301,46059,22424,23635,6961,11946,3517,6649,12066,4920
63303,41575,20659,20916,6685,11598,2376,6185,11791,2940
63304,38586,18955,19631,7154,10078,1723,6838,10594,2199
63330,103,65,38,6,31,28,9,16,13
63332,1207,574,633,174,302,98,217,301,115
63333,879,445,434,156,196,93,163,196,75
63334,8029,4923,3106,1267,3091,565,1011,1382,713
63336,1115,528,587,157,254,117,169,291,127
63339,956,486,470,191,217,78,181,224,65
63341,3143,1607,1536,476,924,207,451,914,171
63343,4580,2213,2367,724,1113,376,836,1082,449
63344,1445,731,714,247,375,109,213,368,133
63345,477,259,218,99,121,39,44,124,50
63347,2671,1373,1298,608,661,104,525,671,102
63348,4526,2266,2260,775,1209,282,738,1263,259
63349,1308,672,636,257,302,113,225,282,129
63350,521,260,261,69,136,55,57,145,59
63351,1620,826,794,291,407,128,218,377,199
63352,1210,634,576,189,306,139,134,285,157
63353,5251,2550,2701,760,1245,545,786,1136,779
63357,4879,2536,2343,815,1305,416,729,1200,414
63359,1398,693,705,215,299,179,168,354,183
63361,4241,2079,2162,659,1001,419,628,1024,510
63362,4474,2279,2195,855,1219,205,797,1178,220
63363,1624,797,827,239,406,152,254,353,220
63366,57473,28338,29135,10370,15437,2531,10375,15580,3180
63367,8350,4218,4132,1269,2209,740,1208,2168,756
63369,1899,943,956,310,521,112,306,497,153
63370,40,17,23,0,17,0,18,5,0
63373,680,346,334,89,188,69,100,170,64
63376,68741,33766,34975,12554,18363,2849,11750,19576,3649
63377,2158,1115,1043,327,576,212,314,488,241
63379,15130,7331,7799,2564,3876,891,2583,4008,1208
63381,520,247,273,68,139,40,101,121,51
63382,4966,1727,3239,495,865,367,597,2054,588
63383,12388,5926,6462,1920,2988,1018,2073,3072,1317
63384,2158,1094,1064,383,486,225,305,483,276
63385,13825,6780,7045,2435,3464,881,2369,3597,1079
63386,557,309,248,85,167,57,76,112,60
63387,103,51,52,18,25,8,14,29,9
63388,586,270,316,65,139,66,71,180,65
63389,4596,2344,2252,777,1251,316,792,1135,325
63390,6749,3493,3256,1213,1759,521,899,1802,555
63401,22105,10398,11707,3495,5181,1722,3654,5520,2533
63430,674,306,368,90,161,55,116,182,70
63431,427,212,215,47,124,41,72,113,30
63432,654,326,328,135,139,52,112,156,60
63433,61,37,24,10,20,7,0,24,0
63434,462,242,220,80,121,41,67,107,46
63435,4384,2146,2238,911,913,322,878,911,449
63436,1268,630,638,198,270,162,151,306,181
63437,1596,749,847,230,339,180,238,369,240
63438,537,276,261,72,141,63,53,141,67
63439,253,120,133,37,63,20,63,53,17
63440,1337,686,651,221,375,90,193,334,124
63441,1115,560,555,148,286,126,150,290,115
63443,389,210,179,61,101,48,46,73,60
63445,3952,1951,2001,640,942,369,510,918,573
63446,634,293,341,88,144,61,108,153,80
63447,1043,536,507,188,230,118,117,214,176
63448,1770,827,943,246,419,162,257,489,197
63450,148,71,77,16,42,13,12,48,17
63451,343,171,172,56,89,26,55,86,31
63452,1188,561,627,182,224,155,188,256,183
63453,575,323,252,131,159,33,88,137,27
63454,797,406,391,131,206,69,113,193,85
63456,4098,1978,2120,645,957,376,611,972,537
63457,336,180,156,65,90,25,47,86,23
63458,240,125,115,49,48,28,32,53,30
63459,3768,1955,1813,615,941,399,503,979,331
63460,329,151,178,47,61,43,49,93,36
63461,5550,2708,2842,846,1341,521,810,1319,713
63462,1438,677,761,183,340,154,181,349,231
63463,647,331,316,129,158,44,127,156,33
63464,48,27,21,5,11,11,4,4,13
63465,457,230,227,63,123,44,74,116,37
63468,3020,1384,1636,435,661,288,450,676,510
63469,1237,627,610,186,328,113,162,288,160
63471,649,345,304,101,186,58,80,163,61
63472,521,244,277,85,107,52,73,127,77
63473,304,169,135,40,84,45,16,69,50
63474,621,314,307,86,143,85,70,143,94
63501,21073,9662,11411,3925,4557,1180,4659,4881,1871
63530,980,481,499,151,262,68,134,268,97
63531,563,272,291,91,109,72,70,126,95
63532,1350,665,685,227,299,139,209,316,160
63533,800,398,402,122,198,78,124,188,90
63534,807,415,392,103,242,70,107,200,85
63535,108,62,46,15,26,21,6,34,6
63536,808,406,402,142,177,87,110,174,118
63537,1809,866,943,250,415,201,237,397,309
63538,321,157,164,42,90,25,53,79,32
63539,287,144,143,28,61,55,24,61,58
63540,181,95,86,33,41,21,38,36,12
63541,446,220,226,53,92,75,52,109,65
63543,421,214,207,87,95,32,68,94,45
63544,793,411,382,120,209,82,95,185,102
63545,1220,561,659,158,257,146,198,276,185
63546,1448,739,709,211,380,148,160,387,162
63547,583,300,283,91,142,67,86,136,61
63548,1305,606,699,202,269,135,232,297,170
63549,2554,1211,1343,413,534,264,413,537,393
63551,428,211,217,57,100,54,67,88,62
63552,7761,3756,4005,1205,1749,802,998,1844,1163
63555,3349,1579,1770,558,684,337,507,737,526
63556,3904,1947,1957,604,1006,337,538,939,480
63557,281,141,140,35,69,37,37,66,37
63558,800,405,395,113,195,97,104,191,100
63559,1496,744,752,228,370,146,220,361,171
63560,311,155,156,30,73,52,56,60,40
63561,1070,491,579,130,256,105,166,229,184
63563,653,324,329,96,147,81,140,112,77
63565,3949,1944,2005,606,877,461,497,924,584
63566,73,33,40,11,16,6,10,14,16
63567,174,79,95,16,51,12,30,52,13
63601,15742,7501,8241,2594,3733,1174,2493,4081,1667
63620,1438,683,755,182,363,138,236,353,166
63621,1220,584,636,168,292,124,171,310,155
63622,891,461,430,171,218,72,111,209,110
63623,819,399,420,116,180,103,114,183,123
63624,3668,1792,1876,570,916,306,574,925,377
63625,508,309,199,127,115,67,34,121,44
63626,206,111,95,37,57,17,35,41,19
63627,3004,1582,1422,573,739,270,489,722,211
63628,11563,5765,5798,1847,2857,1061,1653,2845,1300
63629,1474,740,734,242,401,97,249,369,116
63630,4127,2130,1997,769,1115,246,688,1038,271
63631,976,501,475,174,249,78,143,257,75
63633,807,428,379,152,208,68,112,182,85
63636,659,350,309,100,158,92,100,147,62
63637,897,458,439,157,244,57,189,198,52
63638,2868,1419,1449,410,678,331,395,679,375
63640,22548,12166,10382,3260,6964,1942,2636,5087,2659
63645,10721,5085,5636,1521,2592,972,1540,2668,1428
63648,1307,666,641,225,343,98,216,335,90
63650,4534,2212,2322,739,1070,403,589,1141,592
63653,1028,495,533,194,239,62,162,269,102
63654,526,263,263,74,128,61,50,134,79
63655,1641,783,858,291,373,119,332,376,150
63656,469,242,227,62,144,36,63,120,44
63660,4132,2472,1660,741,1515,216,576,843,241
63662,1161,540,621,150,291,99,228,288,105
63663,584,264,320,82,135,47,88,152,80
63664,8701,4143,4558,1308,2040,795,1432,2182,944
63665,272,144,128,29,94,21,33,70,25
63670,11680,5842,5838,1856,2908,1078,1788,2689,1361
63673,1922,1033,889,280,523,230,242,444,203
63674,151,99,52,60,39,0,7,45,0
63675,159,82,77,21,41,20,23,27,27
63701,32232,15701,16531,4770,8430,2501,4855,8423,3253
63703,9750,4359,5391,1865,1882,612,2157,1969,1265
63730,3376,1641,1735,492,801,348,421,777,537
63732,623,326,297,94,162,70,69,140,88
63735,894,426,468,151,211,64,145,232,91
63736,3204,1580,1624,544,854,182,553,806,265
63738,52,22,30,0,15,7,6,6,18
63739,654,346,308,113,198,35,96,190,22
63740,5488,2601,2887,878,1274,449,843,1356,688
63742,93,49,44,14,28,7,9,31,4
63743,37,20,17,8,10,2,5,10,2
63747,387,188,199,65,99,24,75,91,33
63748,1139,594,545,164,286,144,126,241,178
63750,117,56,61,13,20,23,17,27,17
63751,970,485,485,130,234,121,155,231,99
63753,288,142,146,54,59,29,57,63,26
63755,20600,9967,10633,3339,5245,1383,3197,5589,1847
63758,184,93,91,24,49,20,17,44,30
63760,656,294,362,91,161,42,123,164,75
63763,109,62,47,21,35,6,13,12,22
63764,5808,2896,2912,956,1430,510,804,1455,653
63766,894,418,476,122,232,64,154,219,103
63767,824,392,432,119,209,64,131,212,89
63769,1348,675,673,163,377,135,175,349,149
63770,112,54,58,18,27,9,19,25,14
63771,2837,1408,1429,500,714,194,405,736,288
63774,147,83,64,29,39,15,22,28,14
63775,16053,7924,8129,2547,4079,1298,2466,3899,1764
63780,6562,3275,3287,1131,1638,506,945,1749,593
63781,1056,533,523,176,284,73,160,262,101
63782,358,197,161,81,94,22,41,104,16
63783,172,82,90,31,36,15,19,52,19
63784,265,136,129,33,69,34,36,58,35
63785,882,449,433,145,226,78,120,239,74
63787,728,361,367,117,198,46,108,200,59
63801,23768,11160,12608,3895,5530,1735,3850,6102,2656
63820,294,153,141,38,86,29,46,66,29
63821,973,477,496,133,253,91,142,233,121
63822,2777,1286,1491,407,633,246,378,748,365
63823,1097,518,579,103,286,129,121,291,167
63824,136,77,59,30,33,14,5,38,16
63825,4349,2153,2196,636,1093,424,603,1114,479
63826,144,57,87,19,32,6,24,43,20
63827,1213,603,610,210,297,96,197,305,108
63828,319,158,161,46,83,29,67,76,18
63829,1308,633,675,186,352,95,187,316,172
63830,7653,3535,4118,1395,1621,519,1442,1809,867
63833,284,124,160,25,76,23,47,72,41
63834,5967,2673,3294,1021,1258,394,1057,1507,730
63837,1683,807,876,313,368,126,277,429,170
63839,540,288,252,92,144,52,86,119,47
63841,13004,6114,6890,1849,3057,1208,1817,3306,1767
63845,5955,2849,3106,949,1389,511,821,1572,713
63846,1522,734,788,228,343,163,235,355,198
63847,146,74,72,30,39,5,39,30,3
63848,1555,743,812,240,396,107,243,342,227
63849,308,198,110,91,74,33,28,70,12
63850,56,26,30,10,15,1,2,21,7
63851,4585,2040,2545,815,831,394,826,1104,615
63852,1504,749,755,250,347,152,214,375,166
63853,274,134,140,43,77,14,55,67,18
63855,1189,573,616,204,287,82,195,287,134
63857,13072,6118,6954,2111,2997,1010,1909,3384,1661
63860,192,129,63,54,55,20,6,51,6
63862,1864,846,1018,328,396,122,352,462,204
63863,6934,3261,3673,1122,1572,567,1074,1687,912
63866,665,318,347,99,156,63,112,168,67
63867,1061,517,544,169,239,109,144,256,144
63868,1049,486,563,130,267,89,149,262,152
63869,4205,2006,2199,717,986,303,621,1100,478
63870,1303,630,673,225,302,103,213,311,149
63873,5145,2456,2689,835,1183,438,795,1285,609
63874,411,200,211,62,106,32,67,107,37
63876,2370,1137,1233,350,553,234,277,557,399
63877,4032,1891,2141,639,921,331,621,953,567
63878,207,115,92,60,32,23,23,45,24
63879,920,431,489,137,218,76,162,244,83
63880,33,19,14,8,7,4,5,7,2
63882,547,256,291,89,110,57,67,135,89
63901,32620,15548,17072,4986,7607,2955,4543,8380,4149
63932,1377,711,666,201,387,123,210,319,137
63933,3807,1811,1996,551,888,372,522,909,565
63934,94,47,47,22,19,6,20,27,0
63935,9537,4600,4937,1411,2145,1044,1424,2251,1262
63936,953,502,451,162,260,80,127,250,74
63937,2687,1265,1422,417,599,249,459,651,312
63938,43,21,22,4,12,5,4,14,4
63939,1464,794,670,233,346,215,161,339,170
63940,1389,672,717,208,354,110,193,374,150
63941,472,243,229,63,124,56,70,90,69
63942,670,346,324,96,192,58,85,171,68
63943,884,438,446,138,226,74,140,222,84
63944,1315,651,664,220,281,150,185,312,167
63945,1215,586,629,199,306,81,204,332,93
63947,187,90,97,27,31,32,37,31,29
63951,390,187,203,40,84,63,64,89,50
63952,583,276,307,86,130,60,94,128,85
63953,1671,756,915,208,401,147,273,431,211
63954,1356,691,665,226,350,115,228,361,76
63955,248,121,127,40,67,14,35,70,22
63956,901,458,443,149,224,85,105,219,119
63957,5535,2678,2857,829,1143,706,706,1268,883
63960,3167,1626,1541,635,669,322,438,685,418
63961,1554,770,784,234,376,160,189,352,243
63963,147,64,83,5,31,28,20,19,44
63964,1039,504,535,128,177,199,110,244,181
63965,2662,1285,1377,348,665,272,378,706,293
63966,2469,1219,1250,331,528,360,314,612,324
63967,1517,797,720,150,449,198,154,384,182
64001,594,256,338,59,144,53,71,179,88
64011,3582,1823,1759,593,965,265,542,955,262
64012,25461,12473,12988,4421,6503,1549,4039,6890,2059
64014,22771,11068,11703,4000,6019,1049,3846,6450,1407
64015,29073,14278,14795,4996,7739,1543,4754,8195,1846
64016,4107,2060,2047,755,983,322,622,1087,338
64017,451,233,218,77,104,52,61,102,55
64018,905,452,453,123,260,69,133,247,73
64019,2221,1128,1093,381,612,135,321,606,166
64020,3567,1696,1871,518,813,365,515,814,542
64021,836,442,394,133,214,95,117,188,89
64022,196,94,102,36,40,18,41,43,18
64024,16281,7954,8327,2807,4051,1096,2729,4078,1520
64029,8309,4177,4132,1493,2382,302,1396,2366,370
64030,24967,11968,12999,4033,6372,1563,4131,6870,1998
64034,5954,3026,2928,1062,1634,330,950,1668,310
64035,1070,554,516,203,244,107,171,244,101
64036,474,280,194,64,186,30,70,94,30
64037,6007,2868,3139,849,1465,554,881,1454,804
64040,5969,3069,2900,1068,1509,492,832,1455,613
64048,3992,2111,1881,731,1120,260,541,1081,259
64050,23433,10928,12505,3367,5736,1825,3615,5871,3019
64052,20957,10153,10804,2585,5586,1982,2528,5529,2747
64053,5870,3036,2834,917,1809,310,793,1511,530
64054,4134,2086,2048,537,1196,353,538,1096,414
64055,33691,15806,17885,4222,8230,3354,4146,9293,4446
64056,15296,7369,7927,2921,3597,851,2910,4020,997
64057,11143,5242,5901,1698,2806,738,1754,2977,1170
64058,5981,2885,3096,939,1597,349,1060,1649,387
64060,9772,4879,4893,1801,2619,459,1678,2643,572
64061,2645,1327,1318,390,710,227,345,780,193
64062,5852,2934,2918,1067,1500,367,1009,1467,442
64063,20291,9561,10730,3399,5217,945,3607,5766,1357
64064,11273,5587,5686,1810,3087,690,1566,3420,700
64066,86,53,33,24,18,11,2,22,9
64067,5779,2694,3085,873,1287,534,845,1470,770
64068,32884,15732,17152,5297,8435,2000,5363,9066,2723
64070,2294,1181,1113,386,626,169,308,646,159
64071,850,433,417,175,207,51,121,225,71
64072,117,63,54,20,32,11,9,38,7
64074,600,313,287,101,168,44,76,164,47
64075,9161,4497,4664,1575,2384,538,1480,2480,704
64076,8855,4367,4488,1524,2235,608,1440,2191,857
64077,2005,995,1010,316,511,168,333,495,182
64078,7106,3518,3588,1220,1869,429,1185,1902,501
64079,8377,4231,4146,1466,2320,445,1272,2319,555
64080,9947,4920,5027,1701,2533,686,1641,2555,831
64081,17990,8232,9758,2794,4034,1404,2576,4356,2826
64082,5787,2817,2970,896,1577,344,1048,1567,355
64083,12721,6135,6586,2119,3159,857,1934,3399,1253
64084,1392,716,676,208,370,138,170,392,114
64085,8921,4313,4608,1474,2138,701,1356,2212,1040
64086,19895,9900,9995,3620,5511,769,3276,5784,935
64088,1428,725,703,249,375,101,208,369,126
64089,7835,3832,4003,1261,2110,461,1273,2155,575
64090,107,44,63,16,20,8,32,20,11
64093,24286,12012,12274,4896,5831,1285,4944,5612,1718
64096,1127,597,530,215,267,115,128,268,134
64097,1485,762,723,215,410,137,182,386,155
64098,2942,1406,1536,423,777,206,438,834,264
64101,336,289,47,16,273,0,5,42,0
64102,0,0,0,0,0,0,0,0,0
64105,2771,1567,1204,128,1306,133,124,885,195
64106,6201,3459,2742,1053,2140,266,1037,1218,487
64108,6715,3456,3259,1013,2079,364,1033,1682,544
64109,12525,6318,6207,1946,3573,799,1984,3163,1060
64110,17891,8405,9486,2860,4814,731,3181,5222,1083
64111,17561,9490,8071,1568,6972,950,1502,5207,1362
64112,8697,4312,4385,593,3171,548,604,2834,947
64113,11350,5495,5855,1500,3199,796,1400,3495,960
64114,23611,10804,12807,2186,6352,2266,2114,6497,4196
64116,15888,7667,8221,1925,4609,1133,2013,4536,1672
64117,13263,6191,7072,1917,3424,850,1991,3881,1200
64118,38827,18911,19916,5553,10522,2836,5139,11271,3506
64119,25836,12456,13380,3620,6947,1889,3811,7184,2385
64120,433,236,197,32,161,43,64,79,54
64123,10595,5190,5405,1769,2764,657,1688,2620,1097
64124,13424,6867,6557,2490,3714,663,2276,3411,870
64125,2393,1209,1184,440,672,97,516,547,121
64126,6810,3155,3655,1317,1453,385,1435,1728,492
64127,20747,9845,10902,3986,4666,1193,3807,5264,1831
64128,14777,6557,8220,2703,2839,1015,2812,3667,1741
64129,10327,4984,5343,1690,2775,519,1801,2795,747
64130,25648,11617,14031,4702,4942,1973,4247,6665,3119
64131,23342,10777,12565,3266,5975,1536,3385,6896,2284
64132,16131,7160,8971,3192,3167,801,3237,4470,1264
64133,34367,16167,18200,4513,8480,3174,4522,8951,4727
64134,23529,11367,12162,4379,5710,1278,3881,6629,1652
64136,1197,586,611,220,288,78,158,293,160
64137,9889,4804,5085,1428,2587,789,1254,2709,1122
64138,24659,11528,13131,3732,5845,1951,3508,6855,2768
64139,1000,567,433,135,370,62,132,209,92
64145,4374,1987,2387,570,882,535,606,956,825
64146,1371,585,786,123,312,150,144,368,274
64147,614,279,335,212,61,6,184,145,6
64149,275,142,133,40,56,46,23,64,46
64150,2839,1448,1391,377,850,221,408,690,293
64151,22692,11054,11638,3252,6597,1205,3125,6840,1673
64152,23276,11511,11765,3837,6528,1146,3739,6830,1196
64153,3547,1752,1795,509,1116,127,557,1119,119
64154,4636,2242,2394,594,1340,308,578,1334,482
64155,16926,8394,8532,2794,4970,630,2734,4994,804
64156,1040,536,504,159,318,59,134,293,77
64157,3012,1435,1577,574,812,49,575,937,65
64158,2462,1287,1175,510,757,20,434,699,42
64161,427,229,198,85,112,32,45,118,35
64163,785,439,346,132,271,36,120,195,31
64164,226,120,106,31,39,50,25,57,24
64165,45,25,20,0,12,13,0,7,13
64166,257,130,127,44,72,14,34,80,13
64167,456,228,228,103,93,32,83,118,27
64192,24,24,0,7,17,0,0,0,0
64401,1404,707,697,240,357,110,213,384,100
64402,2579,1226,1353,350,565,311,350,558,445
64421,862,439,423,128,248,63,141,221,61
64422,418,216,202,80,97,39,60,94,48
64423,736,395,341,125,183,87,81,178,82
64424,4187,1949,2238,581,855,513,542,915,781
64426,434,217,217,66,106,45,74,88,55
64427,593,281,312,76,160,45,106,162,44
64428,1058,519,539,180,251,88,160,258,121
64429,11099,6674,4425,1472,4364,838,1269,2049,1107
64430,847,445,402,155,219,71,123,200,79
64431,399,188,211,45,83,60,50,82,79
64432,128,40,88,14,18,8,15,40,33
64433,183,165,18,50,87,28,5,7,6
64434,469,224,245,82,110,32,102,110,33
64436,838,436,402,114,235,87,113,205,84
64437,1010,494,516,140,238,116,150,227,139
64438,288,153,135,51,52,50,33,49,53
64439,1461,721,740,234,370,117,210,374,156
64440,724,353,371,90,185,78,101,194,76
64441,182,90,92,26,44,20,26,48,18
64442,806,407,399,115,192,100,98,197,104
64443,1095,559,536,150,272,137,122,269,145
64444,1483,739,744,215,406,118,231,384,129
64445,357,180,177,59,79,42,54,63,60
64446,1155,575,580,158,314,103,152,268,160
64448,1191,564,627,184,303,77,230,312,85
64449,472,252,220,90,124,38,65,115,40
64451,516,263,253,84,140,39,63,131,59
64453,241,127,114,55,67,5,37,68,9
64454,2408,1148,1260,357,590,201,417,587,256
64455,490,248,242,79,124,45,58,129,55
64456,1645,807,838,265,330,212,188,349,301
64457,360,180,180,63,93,24,72,74,34
64458,209,113,96,43,46,24,24,44,28
64459,458,239,219,59,141,39,53,128,38
64461,1015,527,488,181,246,100,146,237,105
64463,1615,798,817,264,347,187,244,368,205
64465,4172,2021,2151,736,1005,280,686,1088,377
64466,530,300,230,107,153,40,54,125,51
64467,193,112,81,31,56,25,22,37,22
64468,14129,6964,7165,2692,3400,872,3144,2738,1283
64469,2169,1036,1133,341,505,190,370,494,269
64470,1654,767,887,208,342,217,193,352,342
64471,533,264,269,78,122,64,84,111,74
64473,1568,779,789,236,371,172,204,368,217
64474,935,461,474,143,237,81,149,229,96
64475,484,262,222,84,124,54,67,93,62
64476,404,197,207,59,90,48,52,109,46
64477,3204,1554,1650,477,855,222,465,828,357
64479,940,477,463,169,235,73,151,215,97
64480,437,217,220,67,108,42,56,124,40
64481,1141,583,558,203,240,140,155,254,149
64482,2182,1070,1112,279,513,278,225,501,386
64483,671,336,335,116,164,56,110,172,53
64484,1229,632,597,216,314,102,178,307,112
64485,7687,3664,4023,1210,1870,584,1134,1849,1040
64486,407,194,213,60,95,39,63,86,64
64487,829,412,417,119,220,73,139,192,86
64489,1992,980,1012,361,407,212,284,388,340
64490,2034,1028,1006,335,500,193,289,487,230
64491,2373,1190,1183,443,523,224,295,542,346
64492,1116,590,526,176,337,77,118,297,111
64493,554,274,280,74,128,72,83,146,51
64494,974,483,491,140,269,74,153,230,108
64496,202,115,87,39,56,20,21,44,22
64497,542,290,252,131,133,26,93,118,41
64498,419,212,207,55,110,47,72,94,41
64499,168,103,65,36,52,15,20,35,10
64501,12039,5906,6133,2077,3131,698,1792,3064,1277
64503,12260,5874,6386,2027,2963,884,2024,3147,1215
64504,10964,5317,5647,1793,2663,861,1760,2760,1127
64505,12432,5817,6615,1887,3049,881,2152,3197,1266
64506,21921,11410,10511,3154,6377,1879,2655,5026,2830
64507,14052,6533,7519,2298,3189,1046,2433,3272,1814
64601,11755,5216,6539,1620,2531,1065,1682,3142,1715
64620,439,207,232,58,117,32,93,103,36
64622,798,426,372,170,174,82,108,170,94
64623,824,433,391,145,189,99,108,203,80
64624,1727,841,886,275,401,165,256,376,254
64625,741,374,367,124,184,66,126,166,75
64628,6337,2948,3389,980,1284,684,930,1385,1074
64630,738,380,358,110,166,104,98,166,94
64631,1019,483,536,112,249,122,133,228,175
64632,837,417,420,118,207,92,109,204,107
64633,5516,2505,3011,724,1257,524,860,1257,894
64635,531,267,264,87,135,45,76,126,62
64636,258,114,144,27,57,30,47,65,32
64637,604,335,269,104,156,75,54,128,87
64638,606,324,282,113,149,62,83,149,50
64639,221,113,108,32,50,31,26,55,27
64640,3196,1547,1649,441,729,377,424,757,468
64641,724,371,353,130,158,83,101,159,93
64642,832,401,431,120,185,96,140,184,107
64643,1089,547,542,170,229,148,156,232,154
64644,2979,1426,1553,448,688,290,514,661,378
64645,284,157,127,53,74,30,42,61,24
64646,404,210,194,74,101,35,56,99,39
64647,294,132,162,32,65,35,41,71,50
64648,2090,1008,1082,446,410,152,441,442,199
64649,712,347,365,119,164,64,110,177,78
64650,630,315,315,96,179,40,84,168,63
64651,740,384,356,103,193,88,105,163,88
64652,447,218,229,54,100,64,51,114,64
64653,757,380,377,123,194,63,123,184,70
64655,345,192,153,85,87,20,36,84,33
64656,413,212,201,75,109,28,61,100,40
64657,422,223,199,78,103,42,62,83,54
64658,3618,1713,1905,574,786,353,552,853,500
64659,936,436,500,118,228,90,157,217,126
64660,573,275,298,87,114,74,85,145,68
64661,1053,512,541,136,252,124,133,240,168
64664,266,127,139,34,73,20,38,64,37
64667,449,233,216,86,103,44,64,93,59
64668,1571,767,804,216,394,157,212,388,204
64670,1029,512,517,170,250,92,161,238,118
64671,1704,878,826,290,431,157,216,431,179
64672,236,111,125,26,56,29,30,54,41
64673,2229,1066,1163,301,504,261,312,488,363
64674,497,222,275,63,106,53,78,121,76
64676,267,133,134,44,66,23,45,60,29
64679,781,380,401,96,179,105,123,164,114
64681,223,102,121,29,43,30,25,57,39
64682,370,171,199,49,87,35,64,83,52
64683,8317,3924,4393,1175,1882,867,1165,1890,1338
64686,315,172,143,54,86,32,33,71,39
64688,501,259,242,91,111,57,72,99,71
64689,523,261,262,87,124,50,81,141,40
64701,13290,6394,6896,2092,3337,965,2086,3418,1392
64720,3650,1818,1832,620,851,347,549,868,415
64722,525,254,271,95,114,45,84,119,68
64723,757,386,371,133,176,77,115,179,77
64724,2265,1079,1186,381,458,240,320,483,383
64725,1761,880,881,297,432,151,244,458,179
64726,557,315,242,96,175,44,63,134,45
64728,604,305,299,108,147,50,80,153,66
64730,7179,3407,3772,1055,1642,710,1014,1757,1001
64733,1098,534,564,193,247,94,165,287,112
64734,1823,942,881,311,507,124,256,495,130
64735,12864,6217,6647,1858,3068,1291,1757,3092,1798
64738,1288,658,630,204,296,158,194,290,146
64739,917,450,467,140,234,76,164,226,77
64740,1964,1061,903,269,489,303,175,467,261
64741,395,185,210,37,83,65,65,101,44
64742,2190,1096,1094,376,530,190,361,561,172
64743,302,163,139,66,72,25,52,73,14
64744,7914,3718,4196,1120,1726,872,1156,1819,1221
64745,63,30,33,10,15,5,18,11,4
64746,1550,783,767,267,390,126,273,392,102
64747,3728,1894,1834,651,968,275,564,944,326
64748,1600,823,777,280,389,154,230,360,187
64750,407,201,206,80,78,43,48,90,68
64751,216,84,132,18,37,29,45,31,56
64752,834,399,435,128,177,94,132,212,91
64755,2726,1362,1364,445,707,210,449,634,281
64756,730,383,347,93,179,111,86,170,91
64759,8203,3979,4224,1335,1867,777,1255,1906,1063
64761,1513,769,744,292,365,112,223,382,139
64762,1622,767,855,253,385,129,299,418,138
64763,1372,654,718,184,307,163,177,336,205
64767,731,377,354,136,167,74,121,163,70
64769,703,335,368,117,152,66,151,157,60
64770,1006,544,462,158,268,118,99,229,134
64771,492,270,222,68,119,83,46,120,56
64772,13192,6271,6921,2194,3049,1028,2180,3192,1549
64776,3561,1822,1739,491,846,485,364,871,504
64778,367,196,171,57,87,52,64,87,20
64779,2798,1383,1415,499,650,234,445,652,318
64780,614,323,291,84,147,92,80,123,88
64781,97,41,56,11,13,17,10,19,27
64783,810,416,394,114,186,116,105,194,95
64784,1326,656,670,158,335,163,195,344,131
64788,1262,608,654,197,297,114,200,303,151
64790,836,422,414,153,215,54,140,184,90
64801,32760,15866,16894,5400,8225,2241,5480,8459,2955
64804,34156,16265,17891,4774,8551,2940,4839,8905,4147
64830,674,328,346,136,159,33,155,167,24
64831,6033,3034,2999,1128,1488,418,972,1507,520
64832,829,448,381,126,261,61,95,215,71
64833,99,54,45,18,27,9,12,30,3
64834,7066,3490,3576,1307,1757,426,1156,1937,483
64835,1823,890,933,284,493,113,328,461,144
64836,21999,10876,11123,3660,5563,1653,3195,5379,2549
64840,2685,1439,1246,560,718,161,349,700,197
64841,427,201,226,69,107,25,58,141,27
64842,973,481,492,150,257,74,185,221,86
64843,3181,1591,1590,552,752,287,501,761,328
64844,4455,2209,2246,787,1121,301,679,1130,437
64847,422,210,212,69,100,41,69,95,48
64848,684,347,337,134,171,42,139,147,51
64849,75,40,35,14,22,4,8,17,10
64850,21143,10303,10840,3572,5156,1575,3463,5171,2206
64854,3909,2016,1893,637,1074,305,640,956,297
64855,1678,839,839,278,433,128,240,440,159
64856,3620,1724,1896,567,948,209,637,983,276
64857,324,155,169,49,75,31,62,71,36
64858,150,71,79,19,38,14,50,21,8
64859,1187,598,589,212,326,60,208,323,58
64861,1164,591,573,163,284,144,151,255,167
64862,3117,1444,1673,445,719,280,526,765,382
64863,1774,901,873,365,446,90,317,447,109
64865,5546,2669,2877,931,1264,474,920,1368,589
64866,1212,626,586,204,298,124,179,270,137
64867,1137,625,512,225,294,106,162,252,98
64870,11550,5402,6148,2017,2647,738,2059,2983,1106
64873,829,411,418,116,205,90,134,204,80
64874,911,431,480,166,184,81,170,212,98
65001,462,247,215,73,106,68,56,85,74
65010,3903,1838,2065,603,971,264,639,1095,331
65011,2308,1183,1125,466,520,197,356,544,225
65013,3232,1596,1636,509,744,343,415,830,391
65014,2374,1230,1144,376,614,240,341,557,246
65016,1362,701,661,211,386,104,197,323,141
65017,1268,689,579,197,380,112,161,294,124
65018,7454,3640,3814,1241,1802,597,1189,1776,849
65020,12023,5935,6088,1742,2809,1384,1529,3067,1492
65023,1515,794,721,224,452,118,203,408,110
65024,1098,537,561,174,262,101,175,262,124
65025,777,376,401,136,186,54,117,205,79
65026,12044,5790,6254,1809,2852,1129,1729,3020,1505
65032,1520,765,755,297,360,108,250,388,117
65034,585,295,290,124,135,36,91,157,42
65035,1597,841,756,320,422,99,281,357,118
65036,236,100,136,24,57,19,44,55,37
65037,4515,2187,2328,449,939,799,445,1020,863
65039,2200,1114,1086,338,632,144,299,598,189
65040,1248,584,664,160,385,39,256,327,81
65041,5808,2914,2894,748,1434,732,662,1322,910
65043,8893,4436,4457,1635,2349,452,1468,2451,538
65046,1162,613,549,205,325,83,146,289,114
65047,1364,644,720,233,315,96,255,334,131
65048,133,62,71,21,35,6,36,31,4
65049,4845,2360,2485,559,1263,538,582,1353,550
65050,588,305,283,152,132,21,144,113,26
65051,4714,2426,2288,889,1161,376,705,1072,511
65052,3164,1591,1573,519,756,316,467,793,313
65053,1267,666,601,230,335,101,201,288,112
65054,508,262,246,100,141,21,96,118,32
65058,1090,572,518,180,291,101,156,260,102
65059,842,402,440,116,200,86,153,197,90
65061,624,327,297,91,132,104,60,129,108
65062,12,5,7,0,0,5,0,0,7
65063,2784,1389,1395,409,816,164,414,743,238
65064,624,283,341,107,158,18,111,172,58
65065,4969,2444,2525,522,1281,641,480,1337,708
65066,6394,3055,3339,1001,1444,610,959,1533,847
65067,391,199,192,45,145,9,68,113,11
65068,639,332,307,127,159,46,88,151,68
65069,805,400,405,155,182,63,134,223,48
65072,1615,843,772,144,386,313,129,359,284
65074,2676,1329,1347,430,675,224,418,713,216
65075,785,396,389,129,169,98,127,137,125
65076,916,451,465,164,221,66,196,202,67
65077,511,296,215,94,155,47,43,150,22
65078,3462,1790,1672,498,750,542,401,744,527
65079,4669,2309,2360,342,1051,916,353,1137,870
65080,732,360,372,87,202,71,126,180,66
65081,4321,2673,1648,588,1802,283,464,755,429
65082,1193,635,558,206,326,103,179,250,129
65083,362,128,234,44,61,23,101,98,35
65084,6293,2963,3330,983,1395,585,1008,1512,810
65085,1090,526,564,168,268,90,217,229,118
65101,28230,15417,12813,4114,9737,1566,4060,6632,2121
65109,36486,17886,18600,5489,9973,2424,5294,9856,3450
65201,34588,16655,17933,7193,8366,1096,8581,7761,1591
65202,35865,17506,18359,5857,9908,1741,5630,10391,2338
65203,45469,21855,23614,7508,11930,2417,7231,13163,3220
65230,794,414,380,157,171,86,106,164,110
65231,3189,1597,1592,552,832,213,499,830,263
65232,208,104,104,18,62,24,28,53,23
65233,11102,6225,4877,2088,3296,841,1335,2312,1230
65236,1474,688,786,198,312,178,199,336,251
65237,926,447,479,143,224,80,131,235,113
65239,1194,584,610,186,294,104,199,279,132
65240,6988,3385,3603,1129,1637,619,1027,1820,756
65243,2658,1360,1298,592,677,91,505,651,142
65244,433,222,211,56,120,46,53,90,68
65246,110,54,56,15,20,19,4,29,23
65247,684,368,316,150,165,53,96,169,51
65248,4588,2211,2377,806,1029,376,826,998,553
65250,659,353,306,116,176,61,96,161,49
65251,21164,11357,9807,3695,6294,1368,3242,4704,1861
65254,1998,944,1054,285,487,172,342,481,231
65255,2783,1356,1427,439,736,181,389,812,226
65256,1525,718,807,197,430,91,240,460,107
65257,1590,789,801,231,417,141,244,404,153
65258,546,277,269,88,116,73,77,123,69
65259,2712,1400,1312,494,719,187,384,670,258
65260,533,307,226,123,138,46,61,123,42
65261,1116,514,602,137,242,135,162,249,191
65262,501,255,246,84,107,64,65,119,62
65263,1924,956,968,330,477,149,291,474,203
65264,865,436,429,105,206,125,137,183,109
65265,15595,7308,8287,2204,3545,1559,2356,3890,2041
65270,17324,9146,8178,2491,5250,1405,2465,3786,1927
65274,1783,826,957,253,420,153,295,429,233
65275,2700,1319,1381,391,590,338,351,585,445
65276,1524,767,757,260,364,143,222,341,194
65278,204,98,106,40,50,8,37,56,13
65279,1395,684,711,205,367,112,205,375,131
65280,205,107,98,36,54,17,26,54,18
65281,3150,1516,1634,430,725,361,436,700,498
65282,167,69,98,7,33,29,47,34,17
65283,537,287,250,74,131,82,48,123,79
65284,2289,1108,1181,388,553,167,398,576,207
65285,745,402,343,115,217,70,119,158,66
65286,176,88,88,32,39,17,14,42,32
65287,369,180,189,59,91,30,58,98,33
65301,31691,15175,16516,4954,7579,2642,4983,7764,3769
65305,3836,2168,1668,1148,1020,0,849,819,0
65320,107,46,61,11,17,18,10,21,30
65321,429,195,234,76,94,25,66,118,50
65322,639,314,325,88,165,61,90,150,85
65323,929,478,451,138,245,95,130,232,89
65324,1651,860,791,218,318,324,131,393,267
65325,2842,1384,1458,404,664,316,414,689,355
65326,1845,971,874,148,380,443,123,369,382
65327,273,141,132,45,63,33,40,58,34
65329,378,191,187,67,92,32,59,101,27
65330,537,265,272,75,140,50,79,132,61
65332,1487,732,755,220,367,145,263,362,130
65333,871,431,440,144,191,96,162,182,96
65334,778,381,397,127,196,58,137,189,71
65335,259,133,126,35,77,21,25,67,34
65336,5444,2741,2703,952,1545,244,996,1424,283
65337,1976,995,981,357,498,140,314,460,207
65338,2906,1457,1449,434,662,361,390,693,366
65339,886,454,432,154,220,80,141,187,104
65340,15604,7561,8043,2674,3749,1138,2602,3682,1759
65344,315,143,172,35,76,32,62,75,35
65345,393,205,188,50,111,44,69,98,21
65347,694,344,350,100,181,63,86,208,56
65348,1407,697,710,239,330,128,246,326,138
65349,2776,1381,1395,446,634,301,361,599,435
65350,1670,880,790,328,423,129,270,397,123
65351,2619,1276,1343,388,634,254,404,607,332
65354,222,107,115,19,71,17,26,68,21
65355,9057,4443,4614,969,2097,1377,977,2123,1514
65360,4791,2335,2456,733,1151,451,731,1114,611
65401,27574,14262,13312,5326,6959,1977,4032,6628,2652
65436,112,51,61,15,30,6,18,26,17
65438,2988,1457,1531,488,677,292,409,799,323
65439,300,140,160,27,89,24,45,86,29
65440,614,276,338,57,156,63,122,132,84
65441,4513,2298,2215,787,1150,361,706,1074,435
65443,96,47,49,12,21,14,10,20,19
65444,1024,493,531,143,226,124,180,233,118
65446,353,198,155,73,94,31,26,90,39
65449,512,261,251,50,133,78,90,109,52
65452,2951,1509,1442,490,737,282,395,695,352
65453,8072,4026,4046,1305,1857,864,1135,1882,1029
65456,578,290,288,76,132,82,80,142,66
65457,97,48,49,20,20,8,18,22,9
65459,7950,3863,4087,1318,1933,612,1321,2067,699
65461,90,58,32,19,20,19,14,8,10
65462,1372,680,692,218,316,146,202,362,128
65463,859,394,465,122,201,71,157,199,109
65464,458,212,246,75,82,55,97,105,44
65466,1606,763,843,194,355,214,184,395,264
65468,40,21,19,4,13,4,2,13,4
65470,966,506,460,130,265,111,120,232,108
65473,13666,8345,5321,4602,3723,20,2701,2620,0
65479,342,168,174,63,77,28,40,83,51
65483,4586,2119,2467,610,997,512,598,1105,764
65484,156,78,78,20,36,22,12,31,35
65486,3066,1590,1476,560,739,291,397,768,311
65501,198,108,90,41,36,31,14,47,29
65529,232,133,99,46,57,30,21,49,29
65532,54,30,24,5,13,12,0,13,11
65534,798,407,391,132,195,80,123,207,61
65535,1540,808,732,249,423,136,234,370,128
65536,26386,12918,13468,4301,6433,2184,3957,6559,2952
65540,378,188,190,55,94,39,61,98,31
65541,219,104,115,43,43,18,38,56,21
65542,4654,2239,2415,659,1114,466,659,1203,553
65543,230,123,107,58,37,28,25,58,24
65548,5450,2619,2831,926,1190,503,786,1235,810
65550,3113,1584,1529,429,852,303,383,854,292
65552,1548,786,762,263,392,131,224,378,160
65555,1071,512,559,182,240,90,173,284,102
65556,5209,2544,2665,810,1268,466,785,1314,566
65557,168,81,87,17,24,40,19,42,26
65559,8583,4156,4427,1345,1892,919,1327,2059,1041
65560,13419,6527,6892,2059,3081,1387,1881,3285,1726
65564,168,92,76,21,49,22,22,37,17
65565,5180,2421,2759,779,1211,431,841,1266,652
65566,934,456,478,178,191,87,163,213,102
65567,1295,667,628,234,325,108,171,355,102
65570,571,285,286,83,149,53,76,150,60
65571,2257,1100,1157,342,505,253,342,532,283
65580,867,445,422,118,205,122,99,191,132
65582,2092,977,1115,297,507,173,321,521,273
65583,13762,6721,7041,2241,3754,726,2279,3740,1022
65588,2529,1234,1295,435,586,213,447,629,219
65589,276,133,143,40,70,23,52,75,16
65590,1548,787,761,245,394,148,282,390,89
65591,823,439,384,131,238,70,101,219,64
65601,726,366,360,88,157,121,87,170,103
65603,226,118,108,47,42,29,38,41,29
65604,3711,1788,1923,575,916,297,581,958,384
65605,11570,5688,5882,1894,2753,1041,1673,2749,1460
65606,3130,1548,1582,445,748,355,442,753,387
65608,9119,4356,4763,1415,2020,921,1407,2178,1178
65609,774,401,373,133,207,61,112,195,66
65610,4273,2115,2158,635,1121,359,587,1167,404
65611,1923,866,1057,198,409,259,288,447,322
65612,1376,693,683,226,379,88,224,360,99
65613,14866,6992,7874,2519,3280,1193,2585,3502,1787
65614,527,271,256,81,129,61,67,122,67
65616,17198,8127,9071,2296,4278,1553,2417,4573,2081
65617,1646,846,800,350,401,95,275,456,69
65618,176,105,71,21,62,22,11,51,9
65619,4309,2119,2190,692,1200,227,652,1267,271
65620,406,221,185,78,132,11,65,112,8
65622,7865,3785,4080,1331,1816,638,1301,1819,960
65623,33,8,25,1,7,0,12,13,0
65624,434,210,224,90,81,39,41,129,54
65625,7600,3771,3829,1257,1822,692,1170,1800,859
65626,1558,814,744,281,401,132,193,389,162
65627,552,268,284,59,156,53,93,166,25
65629,763,365,398,114,193,58,120,207,71
65630,152,66,86,33,23,10,13,61,12
65631,2526,1207,1319,445,626,136,479,661,179
65632,2687,1401,1286,521,664,216,375,682,229
65633,3504,1764,1740,658,849,257,524,849,367
65634,692,362,330,90,179,93,49,180,101
65635,565,280,285,92,105,83,67,130,88
65637,1234,583,651,177,310,96,204,305,142
65638,411,221,190,52,108,61,34,106,50
65640,656,315,341,68,142,105,73,177,91
65641,1490,736,754,148,337,251,150,385,219
65644,2530,1265,1265,354,655,256,379,623,263
65646,1946,997,949,333,483,181,302,472,175
65647,2242,1113,1129,367,533,213,337,546,246
65648,4467,2219,2248,752,1166,301,695,1250,303
65649,1416,701,715,191,318,192,205,325,185
65650,1141,592,549,130,259,203,111,248,190
65652,3672,2223,1449,583,1424,216,421,818,210
65653,4714,2309,2405,622,912,775,441,1104,860
65655,3123,1496,1627,415,705,376,430,776,421
65656,5599,2792,2807,838,1333,621,699,1400,708
65657,110,53,57,15,32,6,23,23,11
65658,1020,510,510,111,241,158,115,213,182
65659,412,228,184,89,113,26,43,115,26
65660,227,114,113,33,58,23,39,59,15
65661,2687,1220,1467,344,564,312,359,607,501
65662,1316,651,665,218,306,127,198,336,131
65663,1897,966,931,383,437,146,333,464,134
65664,60,27,33,14,9,4,18,11,4
65667,3144,1592,1552,528,734,330,452,724,376
65668,1707,852,855,187,314,351,140,336,379
65669,1800,869,931,266,453,150,296,483,152
65672,7766,3690,4076,1143,1924,623,1302,1946,828
65674,2460,1206,1254,402,524,280,343,557,354
65675,120,60,60,28,29,3,20,32,8
65676,500,250,250,40,128,82,52,114,84
65679,2402,1242,1160,400,675,167,374,598,188
65680,971,487,484,136,244,107,103,282,99
65681,2282,1158,1124,275,580,303,292,548,284
65682,2083,1035,1048,380,451,204,301,487,260
65685,981,500,481,163,215,122,134,227,120
65686,4280,1982,2298,346,775,861,349,891,1058
65689,4840,2365,2475,769,1114,482,667,1130,678
65690,513,260,253,66,118,76,59,120,74
65692,1238,629,609,167,327,135,144,356,109
65701,22,13,9,0,8,5,0,5,4
65702,425,207,218,59,111,37,68,116,34
65704,3704,1776,1928,561,862,353,604,886,438
65705,3725,1799,1926,554,892,353,484,894,548
65706,12747,6235,6512,2136,3076,1023,1939,3266,1307
65707,2115,1079,1036,349,519,211,268,526,242
65708,11433,5567,5866,1898,2773,896,1853,2722,1291
65710,1085,567,518,208,301,58,169,279,70
65711,9300,4376,4924,1444,1946,986,1459,2219,1246
65712,7166,3585,3581,1119,1677,789,891,1780,910
65713,2428,1192,1236,356,657,179,430,608,198
65714,21034,10210,10824,3424,5494,1292,3347,5770,1707
65715,138,71,67,17,23,31,26,35,6
65717,2556,1307,1249,506,587,214,437,599,213
65720,485,245,240,86,120,39,80,104,56
65721,19013,9266,9747,3185,4928,1153,3048,5237,1462
65722,1580,809,771,293,403,113,218,431,122
65723,3657,1806,1851,670,876,260,580,874,397
65724,1219,603,616,92,265,246,81,322,213
65725,2395,1198,1197,416,622,160,395,638,164
65727,94,47,47,7,26,14,8,25,14
65728,88,29,59,0,8,21,27,18,14
65729,211,114,97,23,40,51,5,37,55
65730,74,50,24,8,26,16,0,9,15
65731,352,179,173,50,89,40,37,100,36
65732,790,363,427,115,149,99,116,191,120
65733,497,274,223,45,119,110,41,76,106
65734,3243,1622,1621,600,765,257,525,782,314
65735,185,83,102,17,43,23,31,40,31
65737,6385,3167,3218,878,1621,668,778,1739,701
65738,11282,5370,5912,1797,2851,722,1798,3034,1080
65739,1120,614,506,178,320,116,105,289,112
65740,2704,1262,1442,353,586,323,484,647,311
65742,8778,4379,4399,1393,2212,774,1307,2425,667
65744,189,101,88,30,53,18,14,46,28
65745,2446,1252,1194,451,640,161,448,593,153
65746,7123,3425,3698,1411,1599,415,1452,1659,587
65747,3672,1795,1877,293,743,759,296,779,802
65752,464,247,217,97,101,49,72,109,36
65753,3846,1879,1967,632,970,277,561,1044,362
65754,675,337,338,153,157,27,142,179,17
65755,367,172,195,22,86,64,49,88,58
65756,776,417,359,156,193,68,105,199,55
65757,5932,2979,2953,966,1602,411,853,1614,486
65759,1124,550,574,192,273,85,186,284,104
65760,581,280,301,65,155,60,74,157,70
65761,1231,618,613,113,280,225,113,280,220
65762,462,248,214,74,111,63,58,111,45
65764,1244,659,585,217,312,130,174,297,114
65766,125,63,62,12,28,23,10,34,18
65767,1932,972,960,268,445,259,252,499,209
65768,410,200,210,50,101,49,45,119,46
65769,3024,1561,1463,603,782,176,515,719,229
65770,2798,1410,1388,433,783,194,440,688,260
65771,934,465,469,167,238,60,121,289,59
65772,2291,1137,1154,399,553,185,366,627,161
65773,712,333,379,79,143,111,110,165,104
65774,1184,578,606,201,264,113,191,271,144
65775,22914,11045,11869,3702,5233,2110,3441,5595,2833
65777,352,198,154,52,99,47,44,79,31
65778,559,290,269,84,135,71,84,133,52
65779,1871,938,933,255,349,334,183,414,336
65781,6230,2990,3240,923,1562,505,935,1605,700
65783,222,98,124,32,52,14,41,64,19
65784,24,13,11,8,5,0,4,5,2
65785,5294,2674,2620,874,1115,685,635,1160,825
65786,2013,1027,986,331,542,154,297,489,200
65787,1090,548,542,72,227,249,91,256,195
65788,420,205,215,72,110,23,70,102,43
65789,2006,1043,963,376,499,168,291,526,146
65790,589,302,287,67,167,68,72,137,78
65791,4206,1976,2230,641,891,444,611,992,627
65793,5985,2844,3141,876,1325,643,887,1505,749
65802,39061,18818,20243,6483,9889,2446,6314,10276,3653
65803,38631,18872,19759,6230,10170,2472,6020,9975,3764
65804,35575,16492,19083,4519,8575,3398,4536,9419,5128
65806,11169,5848,5321,1907,3500,441,2009,2477,835
65807,48930,23703,25227,7390,12934,3379,7790,12137,5300
65809,9602,4698,4904,1524,2304,870,1280,2559,1065
65810,15762,7791,7971,2585,4209,997,2267,4503,1201
66002,13368,6406,6962,2394,2889,1123,2162,3097,1703
66006,6153,3083,3070,1234,1411,438,1119,1400,551
66007,3950,2007,1943,705,1027,275,565,1054,324
66008,338,176,162,50,95,31,64,77,21
66010,547,269,278,79,122,68,80,140,58
66012,9598,4771,4827,1796,2385,590,1425,2519,883
66013,1644,830,814,285,422,123,214,472,128
66014,406,189,217,43,61,85,61,75,81
66015,841,393,448,127,197,69,161,190,97
66016,592,277,315,87,156,34,125,139,51
66017,419,217,202,82,92,43,64,88,50
66018,4438,2285,2153,842,1217,226,710,1206,237
66019,234,125,109,45,68,12,40,43,26
66020,1574,831,743,305,400,126,166,392,185
66021,2291,1185,1106,447,634,104,391,613,102
66023,1158,568,590,198,253,117,204,249,137
66024,883,429,454,178,194,57,159,203,92
66025,5791,2779,3012,1017,1437,325,918,1631,463
66026,738,354,384,100,185,69,132,174,78
66027,6714,3585,3129,1530,2055,0,1606,1517,6
66030,11192,5433,5759,1930,3118,385,2086,3048,625
66032,5116,2432,2684,788,1110,534,791,1134,759
66033,735,385,350,115,164,106,97,157,96
66035,1254,632,622,289,229,114,256,200,166
66039,708,387,321,134,180,73,101,157,63
66040,3021,1499,1522,397,890,212,462,786,274
66041,724,380,344,128,184,68,114,169,61
66042,454,231,223,61,128,42,56,134,33
66043,9349,5854,3495,1360,3970,524,1151,1887,457
66044,30944,15363,15581,6853,7714,796,7479,6921,1181
66046,19888,10139,9749,3448,5831,860,3142,5438,1169
66047,15055,7335,7720,2293,4165,877,2436,4186,1098
66048,33913,17540,16373,5065,10106,2369,4874,8415,3084
66049,20634,10277,10357,3484,5676,1117,3220,5745,1392
66050,1550,722,828,238,350,134,315,404,109
66052,1867,930,937,282,499,149,292,503,142
66053,5791,2869,2922,956,1551,362,927,1523,472
66054,2833,1420,1413,461,725,234,489,710,214
66056,1742,857,885,237,360,260,217,391,277
66058,454,262,192,90,128,44,55,104,33
66060,1119,539,580,164,267,108,167,253,160
66061,42439,21121,21318,7478,11824,1819,6944,11939,2435
66062,55036,27450,27586,10615,15520,1315,9978,15913,1695
66064,6423,3090,3333,981,1646,463,1072,1561,700
66066,2657,1365,1292,469,713,183,386,650,256
66067,15488,7697,7791,2758,3749,1190,2389,3717,1685
66070,2179,1157,1022,334,578,245,264,590,168
66071,11610,5742,5868,1951,2965,826,1840,2951,1077
66072,1013,512,501,155,238,119,130,252,119
66073,2341,1133,1208,345,602,186,403,586,219
66075,2251,1147,1104,379,556,212,318,507,279
66076,2052,1040,1012,350,486,204,305,499,208
66077,51,23,28,0,16,7,0,13,15
66078,1070,561,509,254,213,94,172,254,83
66079,749,374,375,118,209,47,119,209,47
66080,1024,485,539,142,224,119,150,228,161
66083,6191,3069,3122,1095,1624,350,1090,1624,408
66085,5435,2735,2700,960,1450,325,931,1508,261
66086,6885,3429,3456,1149,1844,436,1129,1766,561
66087,2055,1041,1014,354,500,187,307,475,232
66088,2543,1259,1284,442,579,238,394,584,306
66090,2587,1249,1338,414,630,205,399,635,304
66091,363,196,167,69,97,30,22,93,52
66092,3650,1815,1835,628,997,190,577,991,267
66093,596,298,298,95,125,78,88,128,82
66094,542,272,270,102,129,41,111,125,34
66095,872,446,426,138,234,74,113,208,105
66097,1202,611,591,233,279,99,180,279,132
66101,14613,7361,7252,2910,3648,803,2498,3371,1383
66102,28670,14106,14564,5154,7330,1622,5184,7110,2270
66103,14402,7208,7194,2091,4470,647,2262,4138,794
66104,27606,12993,14613,4965,6003,2025,4560,7096,2957
66105,3213,1615,1598,603,857,155,702,714,182
66106,24374,11830,12544,4464,5953,1413,4362,6162,2020
66109,15888,7803,8085,2587,4108,1108,2454,4338,1293
66111,10899,5318,5581,1740,2757,821,1656,2861,1064
66112,11857,5541,6316,1913,2863,765,1846,3161,1309
66115,0,0,0,0,0,0,0,0,0
66118,0,0,0,0,0,0,0,0,0
66202,16694,7913,8781,1882,4980,1051,2034,5176,1571
66203,20033,9601,10432,2773,5367,1461,2737,5588,2107
66204,18774,8907,9867,2420,5134,1353,2083,5816,1968
66205,14103,6635,7468,1793,3679,1163,1563,4291,1614
66206,9638,4528,5110,1251,2131,1146,1223,2331,1556
66207,13301,6316,6985,1856,2800,1660,1607,3171,2207
66208,21776,10146,11630,3001,5139,2006,2677,6121,2832
66209,18778,8952,9826,3050,4500,1402,3148,4915,1763
66210,17953,8804,9149,2418,5544,842,2288,5781,1080
66211,3477,1750,1727,575,861,314,337,1019,371
66212,33395,15729,17666,4104,8819,2806,4274,9149,4243
66213,26434,12940,13494,4428,7678,834,4412,8058,1024
66214,12217,6132,6085,1691,3675,766,1542,3665,878
66215,25163,11897,13266,3762,6802,1333,3513,7381,2372
66216,23310,11486,11824,3992,6361,1133,3818,6660,1346
66217,3937,1935,2002,513,1131,291,528,1151,323
66218,3275,1642,1633,535,981,126,511,1004,118
66219,8084,4143,3941,1384,2555,204,1360,2426,155
66220,1487,765,722,245,427,93,187,487,48
66221,6092,3063,3029,1337,1567,159,1237,1649,143
66223,12752,6242,6510,2429,3523,290,2448,3815,247
66224,6462,3263,3199,1370,1698,195,1173,1764,262
66226,6705,3332,3373,1234,1957,141,1174,2015,184
66227,1623,847,776,251,473,123,212,439,125
66401,1807,928,879,254,425,249,231,440,208
66402,2602,1316,1286,483,655,178,416,678,192
66403,860,436,424,164,188,84,159,176,89
66404,645,348,297,145,155,48,122,127,48
66406,561,271,290,94,140,37,80,142,68
66407,479,253,226,71,136,46,79,110,37
66408,534,270,264,99,129,42,90,120,54
66409,2659,1417,1242,493,718,206,316,763,163
66411,1439,696,743,218,313,165,224,295,224
66412,308,171,137,34,61,76,26,78,33
66413,1876,923,953,291,446,186,239,473,241
66414,3077,1512,1565,554,741,217,546,749,270
66415,849,400,449,115,159,126,113,161,175
66416,462,222,240,61,108,53,69,119,52
66417,421,207,214,92,83,32,96,88,30
66418,551,277,274,84,137,56,94,136,44
66419,454,220,234,78,93,49,72,121,41
66422,584,280,304,99,127,54,120,126,58
66423,960,448,512,131,225,92,141,229,142
66424,562,276,286,89,140,47,84,118,84
66425,572,288,284,76,127,85,74,128,82
66427,1400,697,703,196,290,211,153,300,250
66428,483,260,223,92,132,36,80,113,30
66429,656,358,298,142,147,69,70,153,75
66431,761,386,375,140,202,44,120,199,56
66432,441,242,199,89,105,48,48,100,51
66434,5181,2499,2682,744,1266,489,689,1240,753
66436,5539,2610,2929,852,1227,531,833,1274,822
66438,161,88,73,32,50,6,19,47,7
66439,2695,1270,1425,455,546,269,446,603,376
66440,1831,966,865,323,512,131,271,444,150
66441,21962,10487,11475,3704,5471,1312,3907,5710,1858
66442,11372,7264,4108,3668,3588,8,2082,2008,18
66449,853,367,486,105,183,79,147,182,157
66450,177,89,88,30,42,17,34,45,9
66451,1729,860,869,261,416,183,237,433,199
66501,270,142,128,51,74,17,38,71,19
66502,39697,20899,18798,8266,10931,1702,7053,9470,2275
66503,10877,5497,5380,1787,3053,657,1628,2982,770
66506,2472,925,1547,822,103,0,1465,82,0
66507,994,473,521,145,232,96,187,245,89
66508,4513,2140,2373,633,1016,491,641,981,751
66509,2324,1172,1152,440,571,161,425,601,126
66510,813,379,434,98,222,59,157,191,86
66512,3188,1595,1593,549,851,195,512,885,196
66514,1529,822,707,263,423,136,194,395,118
66515,488,233,255,66,121,46,94,116,45
66516,400,201,199,75,108,18,81,95,23
66517,1728,866,862,367,431,68,335,444,83
66518,267,151,116,68,62,21,42,61,13
66520,576,291,285,98,154,39,84,155,46
66521,1617,823,794,264,366,193,217,353,224
66522,43,22,21,14,7,1,0,15,6
66523,4018,2002,2016,668,890,444,521,950,545
66524,2500,1284,1216,406,637,241,321,600,295
66526,754,350,404,138,175,37,167,177,60
66527,475,241,234,108,83,50,75,104,55
66528,998,503,495,205,248,50,205,230,60
66531,1271,604,667,205,277,122,225,318,124
66532,851,450,401,171,190,89,107,189,105
66533,1565,742,823,227,374,141,184,434,205
66534,3579,1697,1882,507,786,404,553,732,597
66535,2363,1168,1195,367,645,156,433,603,159
66536,3111,1548,1563,705,658,185,652,644,267
66537,1360,658,702,200,350,108,222,361,119
66538,3486,1715,1771,583,719,413,536,697,538
66539,2732,1444,1288,544,757,143,403,732,153
66540,550,300,250,100,134,66,58,143,49
66541,249,122,127,33,47,42,25,43,59
66542,2930,1486,1444,585,707,194,404,822,218
66543,737,373,364,103,177,93,84,194,86
66544,403,179,224,52,84,43,86,89,49
66546,1139,584,555,185,327,72,204,281,70
66547,6535,3212,3323,1127,1617,468,1048,1653,622
66548,981,480,501,157,211,112,141,210,150
66549,1404,664,740,178,310,176,200,333,207
66550,675,344,331,102,167,75,89,159,83
66552,342,161,181,47,65,49,31,86,64
66554,560,292,268,95,143,54,85,130,53
66603,1876,1001,875,392,484,125,379,379,117
66604,23786,11083,12703,3200,6161,1722,3433,6375,2895
66605,18886,8878,10008,3144,4432,1302,3416,4750,1842
66606,12440,5861,6579,1584,3275,1002,1628,3350,1601
66607,9770,5014,4756,1747,2674,593,1659,2189,908
66608,5865,2867,2998,904,1580,383,870,1517,611
66609,6963,3402,3561,1084,1775,543,995,1944,622
66610,6826,3346,3480,1082,1796,468,1132,1955,393
66611,10033,4746,5287,1262,2374,1110,1112,2603,1572
66612,2887,1461,1426,440,872,149,373,707,346
66614,30241,14206,16035,4463,7524,2219,4262,8322,3451
66615,1796,707,1089,189,324,194,167,746,176
66616,6420,3159,3261,978,1655,526,928,1637,696
66617,8182,4269,3913,1458,2137,674,1054,2149,710
66618,7569,3846,3723,1342,1900,604,1117,2024,582
66619,3179,1573,1606,715,809,49,697,824,85
66701,12474,5993,6481,2127,2728,1138,1917,2916,1648
66710,879,432,447,127,175,130,108,186,153
66711,810,404,406,125,204,75,145,162,99
66712,2075,985,1090,275,495,215,273,481,336
66713,6027,2847,3180,931,1394,522,986,1429,765
66714,142,65,77,17,26,22,20,29,28
66716,539,280,259,97,109,74,58,125,76
66717,556,296,260,103,146,47,69,121,70
66720,11758,5628,6130,1884,2678,1066,1788,2830,1512
66724,957,482,475,156,240,86,127,242,106
66725,6120,2854,3266,924,1414,516,996,1453,817
66732,383,198,185,74,70,54,58,65,62
66733,2332,1116,1216,333,559,224,330,519,367
66734,242,136,106,39,81,16,21,73,12
66735,396,236,160,91,82,63,35,81,44
66736,4336,2099,2237,694,897,508,599,980,658
66738,461,225,236,83,129,13,70,114,52
66739,5830,2876,2954,980,1495,401,840,1510,604
66740,420,225,195,95,113,17,45,118,32
66741,238,132,106,4,74,54,21,58,27
66743,4255,2088,2167,654,1049,385,605,992,570
66746,272,139,133,40,61,38,46,60,27
66748,2851,1398,1453,454,632,312,412,647,394
66749,8552,4041,4511,1449,1819,773,1398,2006,1107
66751,1023,541,482,204,254,83,147,242,93
66753,1149,596,553,218,252,126,175,251,127
66754,470,229,241,85,99,45,73,93,75
66755,1205,608,597,195,262,151,140,267,190
66756,1055,486,569,144,271,71,167,286,116
66757,4027,1930,2097,645,949,336,605,979,513
66758,288,135,153,52,45,38,60,62,31
66759,50,23,27,2,15,6,5,12,10
66760,95,49,46,12,24,13,6,26,14
66761,275,162,113,48,78,36,45,45,23
66762,24157,11769,12388,4216,6105,1448,4187,5708,2493
66763,2868,1259,1609,383,621,255,431,667,511
66767,533,270,263,76,117,77,32,127,104
66769,563,308,255,133,152,23,62,147,46
66770,1119,588,531,203,318,67,177,265,89
66771,1047,501,546,167,228,106,196,218,132
66772,263,131,132,52,66,13,36,66,30
66773,884,432,452,159,205,68,121,223,108
66775,237,130,107,48,56,26,27,56,24
66776,1152,581,571,207,258,116,216,248,107
66777,638,326,312,39,174,113,59,108,145
66778,148,86,62,29,41,16,19,29,14
66779,617,315,302,111,135,69,79,140,83
66780,704,354,350,127,151,76,119,148,83
66781,1535,763,772,258,368,137,255,367,150
66782,271,145,126,46,80,19,42,70,14
66783,2526,1206,1320,357,554,295,350,566,404
66801,30378,15062,15316,5657,7698,1707,5593,7245,2478
66830,330,167,163,55,98,14,56,89,18
66833,532,266,266,79,134,53,65,138,63
66834,972,493,479,149,261,83,146,221,112
66835,1369,660,709,219,340,101,253,361,95
66838,178,93,85,17,41,35,18,39,28
66839,4144,2007,2137,657,1043,307,614,1065,458
66840,810,423,387,154,192,77,119,174,94
66842,302,149,153,35,68,46,36,73,44
66843,239,146,93,40,69,37,15,51,27
66845,1200,573,627,175,276,122,159,268,200
66846,4029,1927,2102,594,860,473,548,924,630
66849,521,258,263,65,134,59,65,141,57
66850,284,144,140,52,71,21,28,81,31
66851,832,383,449,108,189,86,120,219,110
66852,759,391,368,146,181,64,121,153,94
66853,474,245,229,69,126,50,60,114,55
66854,976,516,460,158,258,100,128,234,98
66856,1611,806,805,274,417,115,236,400,169
66857,980,476,504,152,217,107,131,267,106
66858,509,260,249,105,116,39,67,100,82
66859,173,77,96,21,41,15,32,38,26
66860,1428,667,761,186,327,154,203,332,226
66861,3397,1614,1783,488,722,404,480,772,531
66862,166,86,80,17,35,34,23,29,28
66863,67,38,29,7,20,11,5,6,18
66864,559,281,278,108,108,65,74,123,81
66865,1031,516,515,170,250,96,157,243,115
66866,1916,951,965,283,453,215,243,449,273
66868,847,430,417,148,214,68,152,186,79
66869,882,446,436,146,241,59,143,208,85
66870,238,131,107,40,50,41,23,54,30
66871,1420,691,729,213,353,125,222,337,170
66872,1066,547,519,167,265,115,150,263,106
66901,7018,3265,3753,1069,1461,735,1145,1478,1130
66930,173,87,86,24,39,24,21,39,26
66932,231,118,113,38,64,16,29,57,27
66933,376,180,196,25,70,85,60,59,77
66935,2859,1292,1567,310,593,389,362,594,611
66936,570,256,314,69,132,55,90,138,86
66937,964,486,478,163,218,105,141,225,112
66938,1105,525,580,160,220,145,136,211,233
66939,731,358,373,98,162,98,117,135,121
66940,397,203,194,51,98,54,41,92,61
66941,309,167,142,41,81,45,30,56,56
66942,280,142,138,35,59,48,18,61,59
66943,551,291,260,102,120,69,54,124,82
66944,281,164,117,55,58,51,21,44,52
66945,1132,582,550,194,252,136,151,216,183
66946,154,77,77,10,43,24,22,29,26
66948,708,371,337,119,153,99,91,135,111
66949,730,353,377,101,165,87,106,153,118
66951,866,391,475,113,178,100,151,178,146
66952,696,366,330,71,171,124,77,140,113
66953,736,345,391,92,155,98,71,160,160
66955,144,63,81,14,35,14,23,28,30
66956,1312,652,660,171,281,200,134,265,261
66958,382,208,174,60,92,56,63,71,40
66959,279,145,134,42,79,24,40,68,26
66960,220,115,105,40,41,34,25,43,37
66962,304,158,146,46,85,27,50,62,34
66963,198,90,108,20,43,27,37,35,36
66964,281,140,141,22,71,47,15,69,57
66966,668,333,335,107,157,69,94,136,105
66967,2395,1111,1284,325,450,336,271,519,494
66968,1828,893,935,266,392,235,204,388,343
66970,137,70,67,9,36,25,12,33,22
67001,1170,610,560,288,256,66,269,235,56
67002,9561,4696,4865,1774,2457,465,1681,2402,782
67003,2914,1428,1486,465,579,384,383,584,519
67004,998,499,499,196,204,99,158,211,130
67005,16267,7853,8414,2655,3705,1493,2635,3842,1937
67008,795,378,417,126,166,86,125,186,106
67009,890,390,500,113,176,101,137,178,185
67010,13199,6423,6776,2257,3272,894,2270,3176,1330
67012,14,7,7,0,0,7,0,0,7
67013,3469,1791,1678,701,883,207,561,872,245
67016,382,196,186,70,100,26,61,106,19
67017,1746,909,837,323,457,129,259,433,145
67018,152,78,74,29,38,11,12,45,17
67019,964,486,478,166,217,103,144,208,126
67020,1820,907,913,285,457,165,307,431,175
67021,102,46,56,17,15,14,19,17,20
67022,1815,843,972,250,403,190,252,390,330
67023,262,128,134,40,65,23,38,70,26
67024,1090,542,548,181,192,169,144,220,184
67025,3629,1845,1784,706,919,220,610,855,319
67026,4632,2339,2293,880,1167,292,776,1124,393
67028,265,144,121,50,64,30,29,63,29
67029,996,481,515,141,181,159,101,205,209
67030,2349,1174,1175,525,513,136,473,523,179
67031,2323,1126,1197,462,513,151,423,516,258
67035,1142,527,615,153,234,140,173,249,193
67036,146,64,82,11,31,22,30,27,25
67037,22460,11035,11425,4154,5641,1240,3998,5933,1494
67038,677,330,347,110,162,58,125,155,67
67039,3597,1781,1816,631,906,244,619,901,296
67041,238,121,117,52,45,24,41,54,22
67042,17072,8814,8258,2766,4678,1370,2526,3836,1896
67045,4129,1939,2190,602,905,432,602,895,693
67047,756,404,352,72,175,157,58,137,157
67049,93,56,37,15,18,23,2,13,22
67050,1796,867,929,308,427,132,365,430,134
67051,506,216,290,66,114,36,114,144,32
67052,5790,3035,2755,1333,1438,264,1024,1416,315
67053,591,248,343,74,109,65,84,119,140
67054,1965,946,1019,244,444,258,237,452,330
67056,2627,1254,1373,382,593,279,384,643,346
67057,224,130,94,39,50,41,11,34,49
67058,2220,1089,1131,329,506,254,339,500,292
67059,908,461,447,163,194,104,162,194,91
67060,11760,5839,5921,2107,2980,752,1981,2957,983
67061,246,111,135,24,57,30,61,47,27
67062,4036,1944,2092,782,849,313,725,871,496
67063,3845,1863,1982,649,803,411,637,760,585
67065,266,121,145,34,55,32,56,57,32
67066,289,129,160,35,66,28,37,89,34
67067,1246,634,612,239,343,52,223,363,26
67068,4664,2153,2511,652,1054,447,764,1030,717
67070,1260,585,675,199,285,101,185,278,212
67071,116,58,58,10,46,2,10,36,12
67072,417,211,206,81,102,28,84,109,13
67073,338,170,168,57,90,23,63,79,26
67074,1537,784,753,256,402,126,235,401,117
67101,2570,1328,1242,529,645,154,430,641,171
67102,53,29,24,13,12,4,5,12,7
67103,324,166,158,41,83,42,40,87,31
67104,2752,1374,1378,437,608,329,377,623,378
67105,244,135,109,59,51,25,31,52,26
67106,381,177,204,50,103,24,74,101,29
67107,2776,1362,1414,406,628,328,298,659,457
67108,1996,985,1011,341,479,165,311,476,224
67109,448,217,231,80,105,32,81,98,52
67110,7595,3693,3902,1288,1841,564,1304,1814,784
67111,333,165,168,43,55,67,41,73,54
67112,351,189,162,66,82,41,30,86,46
67114,20781,10282,10499,3436,5040,1806,3087,4948,2464
67117,1442,638,804,222,211,205,224,213,367
67118,930,486,444,156,243,87,163,182,99
67119,1675,808,867,255,382,171,239,379,249
67120,1232,635,597,211,359,65,190,320,87
67122,241,134,107,29,51,54,14,65,28
67123,732,414,318,136,214,64,71,171,76
67124,8036,3808,4228,1312,1678,818,1191,1868,1169
67127,809,423,386,122,185,116,77,183,126
67128,123,67,56,26,36,5,28,23,5
67131,78,38,40,12,15,11,11,18,11
67132,330,162,168,57,81,24,62,81,25
67133,5912,3024,2888,1229,1507,288,1058,1501,329
67134,376,177,199,52,88,37,68,97,34
67135,3258,1638,1620,582,844,212,577,760,283
67137,772,409,363,128,189,92,84,179,100
67138,450,204,246,65,88,51,67,97,82
67140,885,455,430,138,221,96,132,209,89
67142,347,197,150,55,101,41,33,67,50
67143,87,31,56,5,21,5,16,18,22
67144,2952,1425,1527,497,775,153,501,778,248
67146,1798,868,930,305,465,98,342,450,138
67147,7942,3895,4047,1313,2062,520,1447,1940,660
67149,843,401,442,126,197,78,149,229,64
67150,14,6,8,0,0,6,0,0,8
67151,569,307,262,93,162,52,85,146,31
67152,10050,4923,5127,1721,2321,881,1556,2371,1200
67154,1547,808,739,304,364,140,223,322,194
67155,219,87,132,18,56,13,49,53,30
67156,15190,7491,7699,2644,3612,1235,2471,3475,1753
67159,154,73,81,18,28,27,30,30,21
67202,938,737,201,112,589,36,51,130,20
67203,30846,15472,15374,4509,8935,2028,4150,7940,3284
67204,20295,10070,10225,3324,4898,1848,3082,4899,2244
67205,8373,4226,4147,1527,2355,344,1484,2307,356
67206,13388,6426,6962,2010,3184,1232,1901,3418,1643
67207,22734,11091,11643,3285,6487,1319,3700,6308,1635
67208,19476,9586,9890,3418,5047,1121,3116,5083,1691
67209,12751,6279,6472,2085,3322,872,1944,3460,1068
67210,11245,5812,5433,2584,2951,277,2363,2696,374
67211,20684,10476,10208,3223,5920,1333,2995,5274,1939
67212,45685,22528,23157,7922,11903,2703,7549,12154,3454
67213,21654,10499,11155,3364,5828,1307,3601,5089,2465
67214,17648,8641,9007,3561,4068,1012,3218,4237,1552
67215,4212,2140,2072,793,1199,148,710,1196,166
67216,25277,12408,12869,4631,6324,1453,4544,6629,1696
67217,30128,14771,15357,5096,7751,1924,5102,7656,2599
67218,23396,11301,12095,3389,6288,1624,3177,6107,2811
67219,10488,5100,5388,2021,2434,645,1881,2746,761
67220,12313,6004,6309,2069,3239,696,1873,3328,1108
67226,14922,7421,7501,2396,4221,804,2292,4227,982
67230,6279,3176,3103,1058,1614,504,1007,1653,443
67233,0,0,0,0,0,0,0,0,0
67235,6207,3004,3203,1121,1595,288,1248,1654,301
67301,13664,6626,7038,2204,3153,1269,2019,3320,1699
67330,1545,753,792,268,366,119,257,360,175
67332,285,125,160,41,54,30,62,59,39
67333,2925,1380,1545,455,655,270,478,703,364
67334,75,37,38,18,9,10,12,7,19
67335,3642,1770,1872,571,896,303,538,861,473
67336,1728,827,901,225,420,182,223,407,271
67337,14303,6911,7392,2358,3107,1446,1984,3192,2216
67340,413,212,201,51,116,45,65,104,32
67341,331,184,147,51,88,45,28,85,34
67342,981,421,560,105,219,97,170,240,150
67344,967,465,502,153,210,102,131,242,129
67345,180,89,91,23,43,23,29,46,16
67346,443,213,230,46,113,54,61,111,58
67347,439,234,205,49,108,77,52,109,44
67349,1193,581,612,159,259,163,134,258,220
67351,401,196,205,54,103,39,65,102,38
67352,651,315,336,95,137,83,121,122,93
67353,679,340,339,88,142,110,65,129,145
67354,717,333,384,101,172,60,125,164,95
67355,253,117,136,35,35,47,25,47,64
67356,3031,1615,1416,625,740,250,362,680,374
67357,13995,6914,7081,2332,3379,1203,2036,3371,1674
67360,429,197,232,55,95,47,71,88,73
67361,2185,1032,1153,298,442,292,304,485,364
67363,66,35,31,14,15,6,8,13,10
67364,236,108,128,39,53,16,42,67,19
67401,49291,24394,24897,8264,12465,3665,7456,12338,5103
67410,10041,4833,5208,1491,2398,944,1512,2340,1356
67416,1230,624,606,251,293,80,205,306,95
67417,200,103,97,31,58,14,23,54,20
67418,243,143,100,36,64,43,21,53,26
67420,5023,2457,2566,890,1096,471,733,1064,769
67422,1145,558,587,187,255,116,179,293,115
67423,392,190,202,58,92,40,68,104,30
67425,752,396,356,121,200,75,99,178,79
67427,470,224,246,70,112,42,70,112,64
67428,1601,808,793,283,385,140,241,364,188
67430,774,368,406,86,182,100,104,176,126
67431,2237,1124,1113,362,528,234,301,572,240
67432,6221,3056,3165,882,1494,680,805,1378,982
67436,793,418,375,146,189,83,129,166,80
67437,1289,642,647,187,291,164,148,252,247
67438,299,153,146,61,62,30,48,66,32
67439,3572,2024,1548,479,1204,341,352,719,477
67441,1098,532,566,174,231,127,169,242,155
67442,192,105,87,18,79,8,8,58,21
67443,1582,806,776,300,383,123,256,405,115
67444,559,281,278,73,105,103,54,146,78
67445,700,343,357,78,144,121,88,137,132
67446,742,397,345,111,186,100,81,161,103
67447,354,186,168,44,83,59,58,57,53
67448,1416,717,699,227,371,119,220,362,117
67449,3293,1573,1720,509,713,351,442,700,578
67450,646,318,328,107,141,70,78,179,71
67451,1010,516,494,144,221,151,128,210,156
67452,238,113,125,24,59,30,30,50,45
67454,652,300,352,64,146,90,84,166,102
67455,2105,1008,1097,302,426,280,218,482,397
67456,4571,2286,2285,863,1002,421,680,1018,587
67457,888,407,481,143,179,85,133,197,151
67458,200,112,88,18,71,23,23,45,20
67459,233,127,106,42,62,23,27,52,27
67460,15943,7689,8254,2555,3853,1281,2660,3799,1795
67464,972,486,486,149,238,99,127,195,164
67466,833,418,415,135,147,136,94,173,148
67467,2975,1440,1535,407,713,320,389,706,440
67468,360,171,189,60,88,23,78,84,27
67470,626,337,289,106,169,62,97,146,46
67473,1966,928,1038,281,395,252,299,366,373
67474,247,133,114,49,55,29,26,58,30
67475,180,92,88,12,43,37,19,35,34
67478,91,46,45,11,32,3,14,22,9
67480,1713,896,817,292,452,152,241,423,153
67481,709,359,350,93,185,81,108,167,75
67482,104,54,50,25,19,10,25,25,0
67483,428,221,207,82,101,38,69,96,42
67484,931,484,447,146,247,91,135,227,85
67485,444,226,218,79,100,47,79,85,54
67487,1304,653,651,202,328,123,200,325,126
67490,1073,518,555,156,250,112,144,200,211
67491,403,184,219,48,98,38,69,101,49
67492,334,173,161,50,105,18,50,84,27
67501,27923,14743,13180,4438,8298,2007,4217,6610,2353
67502,22989,11071,11918,3409,5250,2412,2912,5515,3491
67505,2545,1145,1400,317,561,267,367,582,451
67510,362,201,161,55,81,65,34,77,50
67511,398,205,193,70,99,36,51,90,52
67512,260,149,111,44,74,31,14,65,32
67513,98,51,47,25,19,7,14,23,10
67514,761,387,374,122,157,108,105,165,104
67515,125,71,54,17,31,23,20,17,17
67516,423,197,226,40,103,54,40,101,85
67518,111,60,51,20,28,12,13,26,12
67519,209,102,107,40,43,19,30,41,36
67520,328,173,155,47,87,39,32,79,44
67521,228,124,104,45,53,26,30,52,22
67522,2082,985,1097,334,448,203,372,471,254
67523,377,208,169,68,104,36,50,77,42
67524,688,337,351,118,164,55,121,162,68
67525,1232,593,639,223,244,126,220,257,162
67526,2793,1336,1457,429,595,312,424,604,429
67529,473,248,225,82,135,31,73,117,35
67530,19285,9317,9968,3182,4466,1669,3079,4476,2413
67543,1968,989,979,336,486,167,320,475,184
67544,3686,1733,1953,563,754,416,538,898,517
67545,259,126,133,37,56,33,35,56,42
67546,2650,1316,1334,429,595,292,412,555,367
67547,2059,1020,1039,283,461,276,261,414,364
67548,1555,727,828,211,331,185,184,340,304
67550,5938,3080,2858,994,1452,634,727,1292,839
67552,811,405,406,149,173,83,135,187,84
67553,72,40,32,10,14,16,3,18,11
67554,4520,2156,2364,722,962,472,718,1016,630
67556,416,220,196,63,97,60,40,83,73
67557,746,382,364,132,180,70,124,145,95
67559,69,32,37,4,19,9,9,10,18
67560,1863,912,951,261,421,230,226,413,312
67561,1699,810,889,293,409,108,299,443,147
67563,419,213,206,73,107,33,66,108,32
67564,347,186,161,48,85,53,50,58,53
67565,529,263,266,69,124,70,80,118,68
67566,538,244,294,82,109,53,92,127,75
67567,775,379,396,151,180,48,144,185,67
67568,301,147,154,45,81,21,48,81,25
67570,1345,716,629,268,287,161,171,288,170
67572,539,280,259,67,128,85,49,111,99
67573,170,86,84,15,40,31,14,41,29
67574,299,127,172,42,70,15,61,75,36
67575,505,238,267,34,110,94,68,93,106
67576,1985,979,1006,324,444,211,269,450,287
67578,1658,784,874,244,364,176,246,352,276
67579,3385,1619,1766,575,793,251,674,753,339
67581,559,263,296,89,111,63,104,124,68
67583,1175,604,571,182,295,127,158,266,147
67584,387,194,193,58,75,61,73,75,45
67601,23047,11435,11612,4304,5534,1597,3959,5483,2170
67621,441,224,217,64,118,42,53,111,53
67622,664,337,327,138,138,61,93,143,91
67623,295,156,139,34,72,50,21,64,54
67625,309,155,154,42,65,48,33,55,66
67626,179,97,82,5,52,40,11,47,24
67628,105,69,36,34,23,12,3,20,13
67629,156,79,77,23,35,21,23,34,20
67631,265,141,124,47,51,43,25,59,40
67632,254,135,119,53,41,41,32,46,41
67634,334,152,182,41,73,38,31,77,74
67635,206,116,90,30,63,23,28,43,19
67637,2480,1190,1290,331,619,240,344,613,333
67638,225,97,128,4,59,34,24,53,51
67639,202,102,100,36,43,23,26,46,28
67640,520,252,268,69,101,82,85,115,68
67642,1937,906,1031,252,406,248,250,435,346
67643,320,167,153,50,77,40,40,56,57
67644,317,158,159,55,75,28,47,69,43
67645,670,353,317,98,177,78,78,158,81
67646,740,342,398,97,161,84,103,155,140
67647,345,175,170,60,78,37,64,73,33
67648,609,274,335,59,122,93,65,137,133
67649,366,168,198,36,82,50,52,74,72
67650,332,172,160,51,85,36,33,88,39
67651,631,340,291,110,170,60,88,129,74
67653,349,154,195,34,73,47,37,80,78
67654,4439,2526,1913,640,1463,423,441,882,590
67656,248,147,101,59,44,44,24,49,28
67657,410,216,194,78,86,52,51,78,65
67658,142,80,62,24,44,12,14,27,21
67659,131,74,57,17,35,22,10,28,19
67660,54,30,24,6,15,9,9,10,5
67661,3585,1737,1848,505,816,416,465,809,574
67663,2818,1331,1487,392,633,306,431,597,459
67664,281,148,133,47,63,38,27,70,36
67665,5361,2603,2758,790,1204,609,657,1252,849
67667,201,107,94,39,51,17,26,47,21
67669,1980,1020,960,307,497,216,239,419,302
67670,55,24,31,4,14,6,10,15,6
67671,1664,819,845,239,384,196,200,387,258
67672,2502,1105,1397,310,524,271,356,548,493
67673,127,61,66,17,23,21,25,27,14
67674,78,40,38,16,21,3,11,21,6
67675,262,144,118,51,57,36,36,45,37
67701,6659,3216,3443,1194,1494,528,1222,1491,730
67730,1788,854,934,212,371,271,212,351,371
67731,771,379,392,107,161,111,93,157,142
67732,549,264,285,82,125,57,106,110,69
67733,223,99,124,25,52,22,63,39,22
67734,201,111,90,48,58,5,26,46,18
67735,6052,3156,2896,1207,1398,551,762,1416,718
67736,255,122,133,34,64,24,41,52,40
67737,507,246,261,73,121,52,65,129,67
67738,631,324,307,88,145,91,99,119,89
67739,389,199,190,66,83,50,59,85,46
67740,1903,928,975,295,418,215,292,398,285
67741,433,186,247,50,91,45,83,100,64
67743,213,99,114,36,42,21,43,48,23
67744,298,171,127,64,79,28,41,48,38
67745,332,166,166,46,78,42,33,89,44
67747,187,102,85,26,62,14,23,47,15
67748,2751,1289,1462,375,594,320,456,598,408
67749,2621,1295,1326,423,550,322,291,563,472
67751,286,149,137,42,80,27,33,71,33
67752,1532,734,798,256,285,193,222,316,260
67753,509,264,245,86,132,46,86,115,44
67756,2374,1172,1202,348,531,293,302,487,413
67757,467,253,214,65,122,66,41,95,78
67758,1237,620,617,203,305,112,189,252,176
67761,226,125,101,32,56,37,20,45,36
67762,360,182,178,74,90,18,78,68,32
67764,440,226,214,76,111,39,71,96,47
67801,29231,15320,13911,5981,7747,1592,5144,6651,2116
67831,1218,594,624,200,257,137,158,283,183
67834,969,480,489,166,219,95,142,219,128
67835,2615,1297,1318,466,653,178,448,643,227
67836,114,52,62,6,24,22,13,24,25
67837,972,520,452,243,247,30,172,220,60
67838,1303,706,597,297,330,79,214,297,86
67839,1741,846,895,242,401,203,219,415,261
67840,141,79,62,24,39,16,9,31,22
67841,355,182,173,61,104,17,62,92,19
67842,482,257,225,81,120,56,63,99,63
67844,891,425,466,123,193,109,127,170,169
67846,37593,18971,18622,7854,9612,1505,7508,9060,2054
67849,408,208,200,61,96,51,53,90,57
67850,405,228,177,79,104,45,60,80,37
67851,2641,1367,1274,675,633,59,553,661,60
67853,931,489,442,182,262,45,190,224,28
67854,1427,677,750,218,311,148,240,309,201
67855,2086,1077,1009,367,538,172,348,463,198
67857,212,127,85,42,49,36,9,40,36
67859,779,399,380,185,168,46,144,183,53
67860,3148,1560,1588,643,728,189,606,709,273
67861,2146,1085,1061,352,540,193,346,482,233
67862,374,161,213,47,82,32,79,80,54
67863,382,179,203,34,103,42,78,90,35
67864,2219,1096,1123,353,511,232,335,463,325
67865,1099,527,572,184,226,117,176,237,159
67867,1656,814,842,338,323,153,273,351,218
67868,104,45,59,6,39,0,25,34,0
67869,1559,792,767,339,357,96,311,338,118
67870,1923,948,975,366,456,126,354,454,167
67871,5207,2592,2615,859,1281,452,777,1245,593
67876,1242,645,597,226,298,121,210,252,135
67877,2147,1103,1044,447,507,149,361,506,177
67878,2384,1193,1191,421,562,210,366,522,303
67879,1475,736,739,260,342,134,219,339,181
67880,7928,3984,3944,1580,2001,403,1407,2009,528
67882,387,187,200,59,109,19,59,122,19
67901,21618,11066,10552,4420,5580,1066,3906,5160,1486
67950,2648,1278,1370,462,592,224,446,636,288
67951,4573,2217,2356,849,1086,282,840,1010,506
67952,743,353,390,149,170,34,163,172,55
67953,118,61,57,11,35,15,12,25,20
67954,756,377,379,141,183,53,150,181,48
68001,179,94,85,39,35,20,25,39,21
68002,2170,1074,1096,374,508,192,348,522,226
68003,4069,2009,2060,595,1049,365,582,987,491
68004,968,495,473,164,209,122,132,206,135
68005,23677,11750,11927,3953,6177,1620,3647,6051,2229
68007,2231,1121,1110,412,541,168,369,558,183
68008,11049,5335,5714,1807,2711,817,1881,2643,1190
68010,775,512,263,475,34,3,230,33,0
68014,276,163,113,47,76,40,28,55,30
68015,1245,655,590,212,318,125,185,273,132
68016,351,165,186,36,76,53,36,99,51
68017,1726,855,871,280,470,105,328,436,107
68018,560,273,287,92,115,66,76,154,57
68019,608,292,316,84,136,72,101,138,77
68020,877,435,442,120,196,119,105,203,134
68022,9245,4619,4626,1725,2433,461,1614,2406,606
68023,2378,1188,1190,429,610,149,387,619,184
68025,29223,14085,15138,4517,7002,2566,4362,7162,3614
68028,4943,2376,2567,810,1264,302,863,1316,388
68029,1065,571,494,181,300,90,123,283,88
68030,885,431,454,148,217,66,146,220,88
68031,1994,966,1028,293,503,170,310,481,237
68033,378,179,199,51,95,33,78,83,38
68034,692,356,336,114,183,59,105,180,51
68035,132,72,60,22,43,7,19,26,15
68036,404,208,196,64,106,38,51,108,37
68037,2122,1058,1064,368,536,154,303,523,238
68038,1566,741,825,234,345,162,218,373,234
68039,1408,682,726,390,226,66,393,274,59
68040,282,136,146,22,67,47,42,54,50
68041,983,492,491,177,248,67,177,238,76
68042,113,62,51,16,39,7,15,24,12
68044,769,396,373,162,181,53,135,191,47
68045,2083,1023,1060,328,430,265,295,430,335
68046,19143,9426,9717,3458,5152,816,3304,5230,1183
68047,1921,966,955,278,451,237,258,404,293
68048,11920,5780,6140,1928,3046,806,1937,3128,1075
68050,740,376,364,127,176,73,133,154,77
68054,45,18,27,0,12,6,6,11,10
68055,336,172,164,55,70,47,53,73,38
68057,1707,806,901,237,405,164,276,379,246
68058,83,37,46,4,23,10,16,26,4
68059,2958,1531,1427,529,770,232,453,753,221
68061,2808,1369,1439,401,671,297,410,650,379
68062,272,129,143,33,66,30,54,57,32
68063,301,145,156,44,60,41,34,68,54
68064,3171,1589,1582,509,802,278,490,775,317
68065,1497,757,740,248,385,124,285,307,148
68066,5040,2456,2584,827,1196,433,740,1133,711
68067,1540,759,781,357,304,98,353,321,107
68068,148,76,72,25,31,20,11,28,33
68069,2108,1053,1055,309,528,216,272,559,224
68070,835,425,410,141,207,77,150,181,79
68071,1594,792,802,396,310,86,346,365,91
68073,1867,932,935,380,451,101,324,500,111
68102,5097,3183,1914,545,2344,294,433,1247,234
68104,35863,16933,18930,5976,8999,1958,6036,9695,3199
68105,24013,12405,11608,3685,7239,1481,3154,6316,2138
68106,20065,9334,10731,2456,5179,1699,2564,5439,2728
68107,26720,13661,13059,5184,6848,1629,4376,6244,2439
68108,13889,7005,6884,2412,3792,801,2360,3364,1160
68110,8955,4899,4056,1734,2592,573,1404,1882,770
68111,25890,11608,14282,5463,4953,1192,5566,6681,2035
68112,12171,5816,6355,2059,2798,959,1876,3054,1425
68113,1350,824,526,491,333,0,328,198,0
68114,17508,8001,9507,1949,4188,1864,2114,4398,2995
68116,8742,4407,4335,1374,2701,332,1450,2660,225
68117,8279,4165,4114,1363,2178,624,1143,2078,893
68118,8249,4171,4078,1703,2275,193,1588,2260,230
68122,5244,2548,2696,874,1450,224,883,1570,243
68123,25181,12550,12631,5138,6880,532,5006,6963,662
68124,15756,7242,8514,2208,3461,1573,2073,4089,2352
68127,22750,11610,11140,3333,7125,1152,3143,6746,1251
68128,11822,5705,6117,2066,3251,388,2018,3626,473
68130,10669,5338,5331,1847,3038,453,1658,3187,486
68131,14008,7107,6901,2402,4171,534,2710,3429,762
68132,13811,6917,6894,2165,4153,599,2134,3836,924
68133,4260,2146,2114,868,1130,148,792,1170,152
68134,27884,13031,14853,3755,7447,1829,4056,8002,2795
68135,13434,6719,6715,2871,3625,223,2877,3669,169
68136,2414,1167,1247,422,662,83,451,681,115
68137,25116,12459,12657,4358,6892,1209,3908,7284,1465
68138,11993,6052,5941,2325,3544,183,2107,3662,172
68142,1686,736,950,298,354,84,340,538,72
68144,25301,12228,13073,3663,6359,2206,3694,6957,2422
68147,9713,4913,4800,1616,2637,660,1425,2558,817
68152,6973,3277,3696,1091,1485,701,1075,1803,818
68154,23743,11190,12553,3532,6256,1402,3577,6963,2013
68157,5239,2521,2718,875,1315,331,887,1421,410
68164,25153,12465,12688,4328,7193,944,3856,7708,1124
68301,1268,589,679,179,303,107,202,322,155
68303,334,159,175,44,82,33,46,85,44
68304,302,153,149,54,66,33,40,67,42
68305,4481,2092,2389,652,1027,413,709,1030,650
68307,566,301,265,87,154,60,53,146,66
68309,138,66,72,24,35,7,25,35,12
68310,14874,7111,7763,2160,3599,1352,2039,3560,2164
68313,979,464,515,172,207,85,173,235,107
68314,331,178,153,44,88,46,36,75,42
68315,155,55,100,14,34,7,34,49,17
68316,578,308,270,134,137,37,103,137,30
68317,1389,712,677,233,350,129,187,374,116
68318,573,299,274,75,166,58,68,154,52
68319,687,354,333,121,191,42,117,155,61
68320,484,251,233,78,114,59,49,113,71
68321,400,203,197,62,90,51,37,96,64
68322,510,236,274,62,102,72,76,111,87
68323,320,160,160,40,72,48,42,64,54
68324,186,97,89,21,36,40,22,28,39
68325,302,147,155,44,59,44,41,70,44
68326,357,187,170,64,95,28,50,84,36
68327,343,167,176,32,87,48,31,79,66
68328,529,240,289,73,128,39,89,151,49
68329,798,392,406,116,178,98,109,183,114
68330,116,52,64,8,29,15,19,32,13
68331,826,440,386,132,205,103,107,184,95
68332,148,74,74,18,36,20,13,28,33
68333,7494,3777,3717,1494,1719,564,1387,1624,706
68335,677,344,333,112,158,74,97,134,102
68336,697,349,348,132,174,43,130,185,33
68337,510,276,234,114,112,50,68,119,47
68338,361,164,197,37,84,43,55,68,74
68339,922,496,426,147,279,70,115,254,57
68340,1111,545,566,146,236,163,148,225,193
68341,1097,547,550,157,279,111,144,288,118
68342,657,338,319,116,164,58,105,161,53
68343,1096,564,532,172,298,94,147,258,127
68344,423,217,206,65,114,38,72,105,29
68345,220,114,106,30,53,31,25,44,37
68346,676,335,341,130,162,43,126,155,60
68347,2232,1128,1104,419,624,85,380,592,132
68348,333,168,165,42,89,37,34,84,47
68349,1095,558,537,190,255,113,168,249,120
68350,230,125,105,34,54,37,20,54,31
68351,1022,515,507,159,228,128,134,217,156
68352,5588,2699,2889,758,1224,717,722,1163,1004
68354,1063,485,578,149,224,112,172,249,157
68355,5707,2699,3008,847,1273,579,805,1296,907
68357,431,226,205,57,119,50,51,106,48
68358,1417,674,743,237,326,111,268,325,150
68359,1692,830,862,252,381,197,255,370,237
68360,556,289,267,91,150,48,102,141,24
68361,2706,1256,1450,385,584,287,395,618,437
68362,66,35,31,10,18,7,9,13,9
68364,195,106,89,26,61,19,26,44,19
68365,275,153,122,51,77,25,38,60,24
68366,1046,518,528,158,283,77,160,269,99
68367,658,316,342,112,151,53,138,153,51
68368,536,280,256,89,160,31,87,135,34
68370,2189,1091,1098,328,466,297,259,448,391
68371,1644,789,855,251,349,189,232,356,267
68372,2003,1001,1002,381,501,119,397,473,132
68374,219,119,100,27,67,25,34,52,14
68375,178,93,85,25,47,21,24,38,23
68376,1682,809,873,223,366,220,224,367,282
68377,585,309,276,110,148,51,75,140,61
68378,683,319,364,86,169,64,89,155,120
68380,115,51,64,18,25,8,31,23,10
68381,254,125,129,30,58,37,38,50,41
68401,720,367,353,129,183,55,124,165,64
68402,1130,622,508,225,331,66,139,307,62
68403,210,83,127,24,46,13,49,63,15
68404,970,522,448,142,321,59,76,306,66
68405,3322,1849,1473,853,693,303,447,664,362
68406,504,250,254,96,107,47,58,101,95
68407,746,411,335,140,206,65,81,183,71
68409,716,377,339,131,203,43,103,173,63
68410,8497,4089,4408,1302,2013,774,1302,1938,1168
68413,606,317,289,116,169,32,89,164,36
68414,312,174,138,59,85,30,28,72,38
68415,717,364,353,127,165,72,110,157,86
68416,279,146,133,59,57,30,24,58,51
68417,305,159,146,53,72,34,45,58,43
68418,881,451,430,150,239,62,129,237,64
68419,353,188,165,63,103,22,45,93,27
68420,1547,707,840,195,299,213,206,298,336
68421,1089,552,537,260,222,70,284,191,62
68422,509,256,253,74,128,54,96,116,41
68423,754,403,351,80,288,35,86,219,46
68424,812,406,406,125,185,96,130,194,82
68428,1169,611,558,200,318,93,185,310,63
68430,1048,547,501,152,285,110,110,271,120
68431,390,189,201,39,101,49,50,86,65
68433,262,133,129,20,77,36,23,59,47
68434,8216,3997,4219,1584,1808,605,1565,1682,972
68436,653,322,331,104,149,69,96,152,83
68437,376,203,173,72,93,38,54,74,45
68439,544,273,271,92,138,43,87,130,54
68440,132,66,66,15,25,26,14,38,14
68441,274,144,130,45,68,31,24,51,55
68442,347,166,181,47,84,35,50,89,42
68443,998,496,502,155,252,89,139,250,113
68444,99,48,51,7,34,7,14,31,6
68445,164,84,80,30,43,11,13,37,30
68446,2443,1159,1284,340,529,290,290,547,447
68447,482,244,238,55,112,77,56,97,85
68448,456,223,233,66,111,46,83,99,51
68450,2398,1128,1270,343,500,285,347,500,423
68452,115,59,56,18,34,7,10,28,18
68453,376,178,198,61,81,36,67,82,49
68454,665,344,321,100,178,66,78,165,78
68455,759,380,379,127,189,64,120,210,49
68456,1121,567,554,178,268,121,149,253,152
68457,438,222,216,71,106,45,85,94,37
68458,180,91,89,21,52,18,19,54,16
68460,899,445,454,125,241,79,158,209,87
68461,586,326,260,104,152,70,68,152,40
68462,3117,1533,1584,599,761,173,573,787,224
68463,1585,754,831,250,358,146,275,386,170
68464,598,302,296,74,144,84,88,126,82
68465,2276,1081,1195,335,513,233,345,506,344
68466,2159,1031,1128,312,462,257,294,483,351
68467,9615,4500,5115,1432,2204,864,1544,2321,1250
68502,27871,14549,13322,4047,9113,1389,3820,7444,2058
68503,15906,8362,7544,3019,4740,603,2698,4043,803
68504,14436,7076,7360,2202,4105,769,2407,3933,1020
68505,13455,6439,7016,2067,3241,1131,1976,3489,1551
68506,27225,12916,14309,3928,6579,2409,3747,7011,3551
68507,13257,6430,6827,2064,3435,931,1997,3523,1307
68508,13341,7158,6183,3427,3329,402,3399,2218,566
68510,21230,10113,11117,2909,5470,1734,2906,5480,2731
68512,6885,3290,3595,1055,1864,371,1065,2082,448
68516,32882,16111,16771,5708,9061,1342,5485,9568,1718
68517,414,225,189,36,116,73,35,108,46
68520,1134,555,579,130,290,135,139,289,151
68521,25432,12704,12728,4582,7151,971,4483,6892,1353
68522,8159,4350,3809,1356,2700,294,1398,2066,345
68523,1166,593,573,185,357,51,194,348,31
68524,4920,2523,2397,1106,1319,98,950,1370,77
68526,1174,584,590,217,316,51,218,329,43
68527,737,372,365,105,206,61,115,181,69
68528,3864,2048,1816,563,1248,237,504,1084,228
68532,432,233,199,84,120,29,46,126,27
68601,27218,13475,13743,4680,6783,2012,4480,6612,2651
68620,3292,1599,1693,550,719,330,516,691,486
68621,453,222,231,69,105,48,80,111,40
68622,274,140,134,45,72,23,46,64,24
68623,290,151,139,45,75,31,38,59,42
68624,1077,557,520,181,268,108,178,255,87
68626,764,406,358,155,178,73,98,160,100
68627,804,423,381,141,179,103,110,159,112
68628,876,429,447,136,198,95,136,186,125
68629,1491,747,744,256,330,161,197,329,218
68631,542,280,262,80,139,61,98,114,50
68632,3809,1901,1908,647,854,400,553,810,545
68633,1416,696,720,218,324,154,230,292,198
68634,315,156,159,50,75,31,46,77,36
68635,540,281,259,66,144,71,87,108,64
68636,1497,757,740,254,304,199,228,299,213
68637,384,186,198,69,69,48,62,86,50
68638,1941,960,981,311,438,211,312,405,264
68640,1639,863,776,256,405,202,219,355,202
68641,1196,586,610,192,253,141,189,230,191
68642,1902,990,912,417,414,159,348,365,199
68643,1131,560,571,212,249,99,176,250,145
68644,966,517,449,212,231,74,172,204,73
68647,721,368,353,121,194,53,99,171,83
68648,424,215,209,65,107,43,63,93,53
68649,1856,926,930,299,417,210,266,416,248
68651,1533,757,776,234,357,166,206,343,227
68652,839,424,415,154,193,77,151,177,87
68653,779,385,394,101,210,74,121,174,99
68654,626,321,305,93,149,79,67,147,91
68655,198,101,97,30,55,16,33,39,25
68658,719,358,361,120,146,92,89,163,109
68659,252,130,122,44,65,21,54,50,18
68660,1270,647,623,210,272,165,156,286,181
68661,6809,3479,3330,1243,1783,453,1168,1544,618
68662,1228,608,620,204,280,124,202,286,132
68663,872,438,434,139,209,90,123,205,106
68664,318,145,173,43,67,35,65,75,33
68665,1057,515,542,175,216,124,170,209,163
68666,1645,787,858,239,342,206,199,345,314
68667,116,43,73,11,27,5,19,37,17
68669,501,264,237,85,129,50,82,109,46
68701,30407,14966,15441,5317,7519,2130,5042,7433,2966
68710,850,441,409,142,209,90,123,196,90
68711,237,125,112,33,63,29,35,59,18
68713,2414,1184,1230,353,572,259,333,569,328
68714,1421,650,771,178,331,141,194,347,230
68715,1530,784,746,320,349,115,233,374,139
68716,1145,583,562,174,257,152,141,223,198
68717,253,122,131,32,57,33,40,63,28
68718,2044,985,1059,267,455,263,254,428,377
68719,165,91,74,28,49,14,20,35,19
68720,482,220,262,72,110,38,104,112,46
68722,640,292,348,89,140,63,88,133,127
68723,673,371,302,129,186,56,102,127,73
68724,238,121,117,50,49,22,45,45,27
68725,594,303,291,90,143,70,65,140,86
68726,917,453,464,153,212,88,158,189,117
68727,859,424,435,147,175,102,116,166,153
68728,266,129,137,38,64,27,36,59,42
68729,1946,911,1035,286,386,239,278,415,342
68730,2130,1089,1041,371,508,210,345,483,213
68731,2527,1248,1279,434,681,133,461,652,166
68732,298,153,145,39,93,21,40,72,33
68733,1483,730,753,265,314,151,247,328,178
68734,220,111,109,40,51,20,40,51,18
68735,1154,596,558,228,263,105,198,230,130
68736,768,386,382,140,198,48,135,168,79
68737,97,47,50,8,26,13,24,16,10
68739,3225,1606,1619,579,714,313,566,639,414
68740,835,431,404,156,211,64,134,199,71
68741,752,402,350,144,190,68,108,177,65
68742,323,173,150,58,91,24,49,69,32
68743,633,341,292,119,170,52,91,142,59
68745,1697,855,842,288,393,174,270,323,249
68746,519,255,264,63,112,80,67,107,90
68747,335,184,151,74,85,25,51,76,24
68748,3362,1788,1574,674,864,250,541,701,332
68752,908,459,449,155,230,74,151,198,100
68753,118,69,49,27,35,7,15,24,10
68755,303,147,156,26,70,51,34,66,56
68756,2178,1040,1138,303,481,256,285,490,363
68757,829,424,405,146,195,83,103,192,110
68758,1281,643,638,215,299,129,173,257,208
68759,333,168,165,47,80,41,42,72,51
68760,1135,576,559,212,249,115,209,244,106
68761,463,235,228,64,105,66,58,101,69
68763,5030,2365,2665,759,1160,446,772,1158,735
68764,820,425,395,157,177,91,110,175,110
68765,1408,721,687,275,326,120,209,304,174
68766,477,239,238,75,110,54,61,105,72
68767,3172,1585,1587,582,736,267,516,717,354
68768,807,394,413,114,197,83,96,182,135
68769,2071,985,1086,316,442,227,301,445,340
68770,1746,863,883,318,390,155,249,428,206
68771,1723,861,862,313,368,180,248,359,255
68772,62,31,31,7,22,2,9,17,5
68773,205,110,95,25,56,29,37,41,17
68774,272,140,132,41,69,30,40,52,40
68776,14777,7331,7446,2692,3853,786,2658,3699,1089
68777,957,459,498,142,217,100,162,193,143
68778,756,371,385,97,175,99,110,163,112
68779,2506,1230,1276,466,528,236,403,571,302
68780,1143,566,577,190,227,149,175,215,187
68781,1675,798,877,252,343,203,288,354,235
68783,1214,598,616,157,267,174,111,241,264
68784,2303,1120,1183,350,535,235,372,497,314
68785,262,132,130,46,70,16,48,67,15
68786,1117,561,556,166,235,160,139,224,193
68787,6593,3016,3577,1294,1282,440,1687,1273,617
68788,5482,2784,2698,914,1286,584,777,1218,703
68789,241,132,109,43,49,40,28,51,30
68790,801,364,437,91,210,63,165,175,97
68791,1914,999,915,341,423,235,250,395,270
68792,488,255,233,77,118,60,74,89,70
68801,27326,13789,13537,4660,7253,1876,4395,6746,2396
68803,20666,9975,10691,3073,5070,1832,3156,5201,2334
68810,834,432,402,166,204,62,130,204,68
68812,878,468,410,156,228,84,136,194,80
68813,679,366,313,126,165,75,87,155,71
68814,784,390,394,115,184,91,112,171,111
68815,764,364,400,120,168,76,123,169,108
68816,226,127,99,46,49,32,20,47,32
68817,478,237,241,75,130,32,86,119,36
68818,5378,2594,2784,850,1280,464,823,1286,675
68819,282,150,132,63,69,18,53,54,25
68820,483,254,229,95,112,47,84,102,43
68821,217,119,98,42,55,22,31,44,23
68822,4880,2323,2557,741,1083,499,632,1142,783
68823,2251,1101,1150,343,479,279,264,510,376
68824,1359,665,694,220,312,133,222,314,158
68825,1153,558,595,176,250,132,186,254,155
68826,3940,1896,2044,647,880,369,568,914,562
68827,864,408,456,139,214,55,185,216,55
68828,336,169,167,43,69,57,48,62,57
68831,847,401,446,120,199,82,135,223,88
68832,1860,895,965,314,450,131,299,518,148
68833,319,162,157,44,84,34,37,79,41
68834,272,135,137,35,77,23,37,77,23
68835,404,226,178,101,85,40,60,78,40
68836,1705,862,843,304,442,116,299,405,139
68837,143,70,73,19,33,18,25,36,12
68838,421,215,206,74,99,42,66,97,43
68840,2803,1402,1401,487,710,205,490,654,257
68841,702,339,363,122,175,42,142,171,50
68842,713,356,357,114,151,91,92,148,117
68843,891,461,430,161,218,82,131,210,89
68844,235,120,115,37,46,37,32,51,32
68845,17481,8490,8991,3760,3969,761,3794,4197,1000
68846,347,179,168,66,78,35,63,65,40
68847,14432,7015,7417,2348,3697,970,2297,3578,1542
68850,11981,6221,5760,2379,3160,682,2165,2658,937
68852,586,280,306,73,121,86,97,125,84
68853,1573,741,832,206,338,197,181,331,320
68854,789,424,365,132,216,76,114,184,67
68855,447,226,221,73,100,53,71,102,48
68856,587,279,308,85,132,62,94,130,84
68858,300,152,148,47,70,35,36,79,33
68859,611,309,302,89,126,94,75,134,93
68860,340,177,163,44,80,53,39,76,48
68861,124,68,56,18,31,19,7,31,18
68862,3140,1487,1653,429,676,382,406,704,543
68863,1173,602,571,223,290,89,176,280,115
68864,1219,631,588,211,294,126,177,254,157
68865,977,515,462,204,239,72,159,257,46
68866,941,488,453,168,253,67,142,226,85
68869,2295,1091,1204,358,514,219,350,504,350
68870,522,290,232,118,133,39,52,137,43
68871,234,128,106,21,57,50,26,44,36
68872,940,482,458,179,235,68,170,214,74
68873,3274,1658,1616,515,812,331,411,741,464
68874,1050,520,530,159,225,136,123,229,178
68875,693,345,348,126,129,90,100,148,100
68876,1758,856,902,307,417,132,295,416,191
68878,439,228,211,87,108,33,77,98,36
68879,456,216,240,68,94,54,71,101,68
68881,87,43,44,14,21,8,15,21,8
68882,438,207,231,48,103,56,79,93,59
68883,2264,1163,1101,405,545,213,316,495,290
68901,26383,12950,13433,4397,6427,2126,4097,6168,3168
68920,1485,672,813,184,325,163,224,323,266
68922,1442,643,799,174,307,162,204,314,281
68923,192,89,103,30,44,15,34,51,18
68924,1705,870,835,290,477,103,280,443,112
68925,517,264,253,89,134,41,87,132,34
68926,762,350,412,80,175,95,109,167,136
68927,1354,685,669,215,336,134,205,306,158
68928,438,219,219,68,110,41,69,109,41
68929,250,116,134,22,74,20,35,59,40
68930,1492,701,791,210,309,182,224,317,250
68932,531,251,280,58,111,82,65,110,105
68933,1112,549,563,195,260,94,182,269,112
68934,269,156,113,45,76,35,40,53,20
68935,813,393,420,94,163,136,119,166,135
68936,269,130,139,34,76,20,40,66,33
68937,1881,938,943,235,443,260,229,420,294
68938,668,327,341,97,154,76,107,152,82
68939,1296,586,710,175,240,171,185,259,266
68940,488,257,231,83,118,56,62,114,55
68941,861,440,421,120,243,77,138,202,81
68942,525,272,253,77,121,74,69,111,73
68943,375,190,185,59,91,40,65,86,34
68944,1316,636,680,217,300,119,231,266,183
68945,224,116,108,39,60,17,34,49,25
68946,194,107,87,54,42,11,41,39,7
68947,560,283,277,84,145,54,69,136,72
68948,291,163,128,41,73,49,26,59,43
68949,6785,3215,3570,971,1547,697,995,1577,998
68950,378,189,189,54,106,29,57,96,36
68952,198,103,95,20,53,30,21,47,27
68954,108,52,56,13,24,15,9,32,15
68955,1583,768,815,264,409,95,311,411,93
68956,1254,626,628,206,299,121,158,283,187
68957,673,344,329,130,159,55,107,130,92
68958,713,390,323,127,190,73,90,160,73
68959,4165,2067,2098,667,1007,393,558,964,576
68960,240,113,127,39,39,35,32,46,49
68961,892,423,469,116,182,125,111,180,178
68964,134,71,63,25,35,11,23,19,21
68966,800,431,369,150,177,104,103,145,121
68967,1271,658,613,198,304,156,152,296,165
68970,1530,732,798,198,302,232,174,315,309
68971,542,300,242,61,121,118,34,131,77
68972,250,133,117,27,64,42,23,55,39
68973,489,238,251,67,144,27,74,133,44
68974,264,132,132,30,75,27,34,61,37
68975,163,89,74,34,40,15,24,34,16
68976,278,152,126,47,73,32,24,73,29
68977,375,178,197,47,86,45,63,81,53
68978,2406,1100,1306,282,477,341,321,528,457
68979,1902,897,1005,256,438,203,307,413,285
68980,449,222,227,75,113,34,80,100,47
68981,422,228,194,86,104,38,51,92,51
68982,831,396,435,130,184,82,151,198,86
69001,9599,4682,4917,1563,2105,1014,1465,2079,1373
69020,534,274,260,105,102,67,85,95,80
69021,1458,680,778,189,313,178,186,312,280
69022,1644,816,828,271,342,203,197,371,260
69023,500,244,256,84,102,58,66,126,64
69024,1170,563,607,162,262,139,183,271,153
69025,1323,652,671,274,252,126,252,241,178
69026,225,116,109,35,56,25,31,56,22
69027,154,75,79,26,42,7,26,40,13
69028,920,457,463,155,201,101,150,209,104
69029,321,159,162,51,77,31,46,71,45
69030,354,176,178,48,95,33,34,103,41
69031,49,26,23,7,13,6,4,9,10
69032,629,326,303,106,148,72,93,134,76
69033,2558,1275,1283,379,615,281,375,551,357
69034,1047,510,537,148,243,119,167,254,116
69036,176,87,89,28,44,15,24,48,17
69037,120,65,55,14,21,30,9,31,15
69038,511,247,264,89,131,27,105,110,49
69039,186,94,92,33,41,20,33,41,18
69040,645,305,340,102,138,65,123,125,92
69041,262,145,117,54,74,17,51,58,8
69042,52,32,20,10,20,2,2,18,0
69043,656,334,322,100,139,95,80,132,110
69044,894,451,443,118,223,110,81,203,159
69045,1101,557,544,154,259,144,128,236,180
69046,248,127,121,33,64,30,25,56,40
69101,28421,13784,14637,4641,6769,2374,4282,7055,3300
69120,996,502,494,146,233,123,128,211,155
69121,348,170,178,43,79,48,52,75,51
69122,694,336,358,78,154,104,103,149,106
69123,876,450,426,116,228,106,94,238,94
69125,433,216,217,55,125,36,67,93,57
69127,775,409,366,126,200,83,89,169,108
69128,391,192,199,53,100,39,61,87,51
69129,1478,734,744,214,326,194,195,330,219
69130,5562,2702,2860,884,1321,497,882,1285,693
69131,542,259,283,74,125,60,64,121,98
69132,38,20,18,5,9,6,2,9,7
69133,435,231,204,95,99,37,64,90,50
69134,364,176,188,43,88,45,49,86,53
69135,67,39,28,15,22,2,10,18,0
69138,4427,2127,2300,676,1030,421,668,1022,610
69140,1799,887,912,273,414,200,220,396,296
69141,430,201,229,70,104,27,84,102,43
69142,135,61,74,23,22,16,28,27,19
69143,1491,736,755,253,382,101,245,383,127
69144,233,116,117,35,54,27,27,61,29
69145,3310,1629,1681,488,721,420,423,757,501
69146,378,209,169,36,87,86,23,76,70
69147,783,388,395,63,163,162,74,173,148
69148,284,144,140,50,70,24,43,60,37
69149,798,411,387,121,193,97,92,179,116
69150,568,292,276,111,148,33,107,120,49
69151,780,394,386,111,212,71,133,181,72
69152,891,417,474,125,186,106,136,181,157
69153,6158,2981,3177,966,1415,600,894,1469,814
69154,1354,657,697,168,303,186,156,306,235
69155,1117,546,571,207,267,72,174,281,116
69156,680,341,339,97,175,69,100,168,71
69157,92,54,38,21,27,6,13,23,2
69161,243,124,119,34,64,26,26,71,22
69162,7452,3653,3799,1205,1798,650,1111,1756,932
69163,822,408,414,125,200,83,108,204,102
69165,1643,810,833,250,413,147,255,358,220
69166,445,234,211,71,120,43,29,120,62
69167,464,242,222,79,110,53,56,116,50
69168,294,152,142,57,66,29,44,64,34
69169,722,351,371,104,189,58,133,163,75
69170,342,167,175,58,89,20,65,87,23
69201,4089,2006,2083,665,943,398,543,988,552
69210,2841,1380,1461,412,609,359,375,633,453
69211,430,209,221,79,91,39,80,98,43
69212,186,97,89,30,47,20,18,51,20
69214,217,112,105,33,54,25,23,55,27
69216,193,95,98,25,47,23,36,41,21
69217,463,236,227,70,103,63,51,115,61
69218,269,141,128,50,62,29,35,61,32
69219,3,1,2,0,1,0,0,2,0
69220,54,27,27,9,14,4,7,18,2
69221,173,93,80,14,46,33,19,32,29
69301,10700,5378,5322,1874,2721,783,1611,2650,1061
69331,141,70,71,19,36,15,20,39,12
69333,155,80,75,25,37,18,16,35,24
69334,2457,1225,1232,408,618,199,368,581,283
69335,145,73,72,32,35,6,17,40,15
69336,2598,1268,1330,409,599,260,409,587,334
69337,7063,3491,3572,1451,1514,526,1344,1556,672
69339,1581,730,851,207,352,171,233,349,269
69340,137,85,52,30,41,14,15,27,10
69341,10538,4994,5544,1632,2372,990,1548,2719,1277
69343,3075,1490,1585,475,692,323,438,701,446
69345,681,357,324,127,150,80,85,167,72
69346,655,346,309,121,149,76,61,159,89
69347,1521,736,785,213,322,201,204,311,270
69348,1854,950,904,348,444,158,277,422,205
69349,163,88,75,40,36,12,10,35,30
69350,430,241,189,89,104,48,45,100,44
69351,227,124,103,27,64,33,24,52,27
69352,770,351,419,115,182,54,158,185,76
69354,81,42,39,15,16,11,11,22,6
69355,158,84,74,25,35,24,13,41,20
69356,2187,1086,1101,353,533,200,343,553,205
69357,3915,1916,1999,617,958,341,603,933,463
69358,1971,984,987,284,488,212,273,480,234
69360,1496,738,758,221,373,144,206,369,183
69361,17637,8082,9555,2698,3778,1606,2946,4324,2285
69365,76,37,39,17,13,7,11,15,13
69366,204,110,94,45,56,9,39,42,13
69367,283,153,130,43,57,53,36,56,38
70001,39478,18808,20670,4757,11079,2972,4886,11113,4671
70002,19441,9324,10117,2467,5134,1723,2298,5315,2504
70003,43561,20676,22885,6230,10793,3653,6128,11671,5086
70005,25408,12139,13269,2965,6561,2613,2508,7039,3722
70006,16658,7828,8830,1955,4424,1449,2084,4688,2058
70030,4016,2015,2001,671,1069,275,599,1068,334
70031,1272,645,627,247,301,97,135,358,134
70032,8103,3742,4361,894,1829,1019,900,1904,1557
70036,1390,671,719,189,314,168,202,376,141
70037,12123,6106,6017,2249,3198,659,1927,3287,803
70038,316,167,149,72,85,10,65,73,11
70039,2208,1054,1154,452,505,97,389,591,174
70040,2211,1135,1076,312,631,192,332,487,257
70041,6255,3194,3061,1077,1658,459,1028,1616,417
70043,32080,15458,16622,4778,8321,2359,4559,8504,3559
70047,12794,6186,6608,2315,3378,493,2399,3535,674
70049,2723,1362,1361,593,586,183,418,692,251
70050,587,282,305,134,126,22,129,145,31
70051,2317,1042,1275,420,499,123,464,556,255
70052,3066,1502,1564,539,720,243,468,789,307
70053,16651,8294,8357,2560,4496,1238,2345,4320,1692
70056,40301,19161,21140,6516,10591,2054,6834,11676,2630
70057,2757,1349,1408,423,736,190,477,707,224
70058,42733,20606,22127,8240,10781,1585,8145,12036,1946
70062,18347,8596,9751,3237,4283,1076,3235,4849,1667
70065,53565,26004,27561,8625,14622,2757,8267,15468,3826
70066,776,345,431,177,138,30,166,217,48
70067,3786,1977,1809,647,1054,276,650,957,202
70068,30377,14770,15607,5804,7740,1226,5448,8519,1640
70070,11610,5623,5987,2004,3021,598,2164,3111,712
70071,3962,1884,2078,683,894,307,658,974,446
70072,57543,27326,30217,10085,14130,3111,10003,15984,4230
70075,8475,4059,4416,1405,2267,387,1413,2412,591
70076,402,195,207,97,75,23,78,79,50
70079,3476,1701,1775,583,781,337,419,892,464
70080,1564,735,829,303,365,67,286,457,86
70082,814,417,397,174,197,46,152,174,71
70083,4052,2014,2038,811,994,209,746,1001,291
70084,7603,3632,3971,1456,1680,496,1378,1951,642
70085,7872,3858,4014,1517,1893,448,1304,2084,626
70086,2255,1039,1216,447,452,140,480,522,214
70087,6639,3273,3366,1333,1659,281,1088,1873,405
70090,7238,3515,3723,1341,1705,469,1273,1813,637
70091,399,207,192,41,129,37,60,80,52
70092,10699,5131,5568,1900,2633,598,1870,2994,704
70094,34150,16383,17767,6310,7948,2125,5984,9230,2553
70112,6308,2713,3595,1208,1219,286,1352,1879,364
70113,10216,4741,5475,1913,2143,685,1872,2639,964
70114,28396,13029,15367,5458,6234,1337,5377,7686,2304
70115,40287,18839,21448,5403,10971,2465,5429,11839,4180
70116,16715,8356,8359,2200,4905,1251,2317,4252,1790
70117,51176,23874,27302,9531,11265,3078,9459,13123,4720
70118,36887,17255,19632,6209,8789,2257,6488,9506,3638
70119,50347,26360,23987,8569,15136,2655,6877,12623,4487
70121,13021,6100,6921,1429,3510,1161,1643,3639,1639
70122,46747,21169,25578,7927,9991,3251,7772,12587,5219
70123,27892,13417,14475,3464,7758,2195,3395,7973,3107
70124,22865,10652,12213,2765,5801,2086,2387,6524,3302
70125,23664,10254,13410,3959,5036,1259,4970,6051,2389
70126,40796,18713,22083,7472,8988,2253,7053,11242,3788
70127,31363,14017,17346,5585,6830,1602,5890,9098,2358
70128,20633,9721,10912,4114,5040,567,3833,6262,817
70129,15087,7369,7718,3026,3504,839,2916,3916,886
70130,14801,7477,7324,1831,4684,962,1846,4139,1339
70131,28386,13142,15244,4397,6946,1799,4832,7893,2519
70163,0,0,0,0,0,0,0,0,0
70301,39832,18989,20843,6889,9667,2433,7249,10226,3368
70339,6841,3343,3498,1086,1805,452,1165,1850,483
70341,4678,2271,2407,921,1049,301,813,1170,424
70342,4418,2171,2247,781,1154,236,713,1196,338
70343,4712,2397,2315,922,1261,214,816,1265,234
70344,7105,3664,3441,1365,1811,488,1164,1649,628
70345,12888,6280,6608,2127,3260,893,2111,3216,1281
70346,10809,5144,5665,2082,2427,635,1975,2784,906
70353,2455,1143,1312,445,526,172,536,561,215
70354,4846,2497,2349,820,1298,379,665,1171,513
70355,1068,494,574,147,288,59,246,251,77
70356,2587,1235,1352,411,627,197,477,677,198
70357,3303,1690,1613,596,830,264,525,783,305
70358,1541,799,742,237,400,162,200,407,135
70359,6318,3041,3277,1264,1513,264,1269,1752,256
70360,21368,10333,11035,3493,5449,1391,3486,5668,1881
70363,26209,12785,13424,4904,6501,1380,5063,6793,1568
70364,27422,13567,13855,4686,7229,1652,4416,7347,2092
70372,2643,1300,1343,449,711,140,389,746,208
70373,43,27,16,4,23,0,0,16,0
70374,9931,4790,5141,1562,2563,665,1623,2612,906
70375,82,36,46,0,31,5,6,34,6
70377,4597,2349,2248,893,1229,227,830,1146,272
70380,21754,10607,11147,3461,5748,1398,3716,5531,1900
70390,7644,3731,3913,1362,1827,542,1201,2068,644
70391,97,42,55,14,14,14,8,14,33
70392,7398,3638,3760,1342,1917,379,1348,1865,547
70393,441,205,236,96,92,17,87,117,32
70394,13799,6535,7264,2137,3310,1088,2350,3642,1272
70395,4379,2124,2255,779,1150,195,853,1158,244
70397,1685,860,825,277,456,127,306,410,109
70401,18369,8356,10013,3092,4365,899,3862,4947,1204
70403,20213,9545,10668,3461,4778,1306,3336,5333,1999
70420,4985,2420,2565,789,1419,212,846,1414,305
70422,12313,6297,6016,2281,3170,846,1964,2892,1160
70426,6448,3656,2792,1123,2220,313,996,1350,446
70427,20867,9769,11098,3418,4578,1773,3364,5064,2670
70431,4485,2335,2150,822,1132,381,573,1197,380
70433,24101,11628,12473,3882,6156,1590,3734,6433,2306
70435,11117,5512,5605,1934,2916,662,1858,2925,822
70436,438,207,231,111,76,20,86,112,33
70437,5905,2749,3156,870,1380,499,1033,1600,523
70438,14892,7144,7748,2492,3457,1195,2387,3604,1757
70441,4715,2241,2474,835,1055,351,758,1170,546
70442,399,179,220,63,81,35,94,114,12
70443,9658,4727,4931,1723,2403,601,1594,2511,826
70444,9774,4808,4966,1845,2212,751,1481,2454,1031
70445,9452,4549,4903,1530,2414,605,1549,2504,850
70446,4699,2349,2350,892,1181,276,755,1292,303
70447,3907,1952,1955,649,1096,207,555,1124,276
70448,20188,9825,10363,3592,5397,836,3363,5813,1187
70449,2779,1419,1360,409,748,262,389,735,236
70450,2299,1039,1260,337,529,173,444,584,232
70451,150,79,71,34,41,4,29,27,15
70452,11099,5578,5521,1946,2924,708,1585,3143,793
70453,1054,477,577,185,269,23,208,291,78
70454,19771,9598,10173,3588,4732,1278,3301,5275,1597
70455,1244,637,607,242,333,62,231,290,86
70456,3032,1403,1629,524,677,202,613,793,223
70458,32803,16090,16713,5214,8402,2474,4541,8895,3277
70460,19843,9617,10226,3365,5096,1156,3384,5500,1342
70461,22860,11376,11484,4245,6080,1051,3862,6390,1232
70462,4407,2145,2262,703,1134,308,690,1219,353
70463,138,60,78,12,44,4,17,45,16
70464,153,76,77,19,36,21,16,41,20
70465,527,226,301,106,100,20,159,122,20
70466,6724,3184,3540,1124,1709,351,1368,1709,463
70471,19695,9502,10193,3442,5155,905,3346,5447,1400
70501,30661,14963,15698,5271,7735,1957,5131,7514,3053
70503,24324,11741,12583,4279,5835,1627,4344,6043,2196
70506,36342,17330,19012,5960,9463,1907,5772,10169,3071
70507,15627,7425,8202,2831,3808,786,2919,4315,968
70508,27031,13147,13884,4143,7771,1233,4447,7704,1733
70510,24651,11761,12890,4328,5677,1756,4265,6134,2491
70512,9381,4585,4796,1685,2186,714,1546,2352,898
70513,149,86,63,41,31,14,22,28,13
70514,3034,1522,1512,555,781,186,502,785,225
70515,3985,2363,1622,752,1380,231,531,759,332
70516,1227,656,571,250,350,56,193,309,69
70517,22811,11356,11455,4220,5758,1378,3802,5816,1837
70518,11341,5565,5776,2012,3107,446,2173,3053,550
70520,14691,7077,7614,2781,3597,699,2598,4010,1006
70521,20,6,14,0,0,6,0,0,14
70523,632,331,301,133,129,69,104,152,45
70524,419,202,217,82,103,17,80,107,30
70525,12231,5917,6314,2389,2668,860,2280,2992,1042
70526,20344,9769,10575,3735,4536,1498,3446,4932,2197
70528,2837,1395,1442,539,684,172,498,698,246
70529,9560,4700,4860,1819,2339,542,1741,2552,567
70531,1014,577,437,205,260,112,89,232,116
70532,2841,1324,1517,535,588,201,589,617,311
70533,7405,3596,3809,1261,1812,523,1286,1875,648
70534,839,400,439,134,218,48,141,210,88
70535,18454,8835,9619,3289,4160,1386,3304,4426,1889
70537,771,383,388,169,161,53,159,170,59
70538,15773,7407,8366,2868,3444,1095,2643,4145,1578
70540,19,9,10,0,9,0,0,10,0
70541,444,208,236,62,120,26,71,118,47
70542,3805,1783,2022,594,884,305,605,948,469
70543,3371,1507,1864,573,746,188,708,849,307
70544,12268,5750,6518,2358,2615,777,2351,3017,1150
70546,16416,7858,8558,3044,3572,1242,2875,3939,1744
70548,10150,4803,5347,1691,2240,872,1611,2433,1303
70549,4223,2047,2176,698,977,372,690,1102,384
70550,221,103,118,23,33,47,36,28,54
70552,1247,639,608,188,312,139,182,319,107
70554,6051,2915,3136,1111,1298,506,1071,1383,682
70555,7196,3535,3661,1313,1830,392,1224,1942,495
70556,739,363,376,122,189,52,120,180,76
70558,242,100,142,25,54,21,46,83,13
70559,2165,1067,1098,402,528,137,425,537,136
70560,41165,19899,21266,7430,9834,2635,7185,10510,3571
70563,17616,8394,9222,3006,4143,1245,2988,4582,1652
70570,43042,20428,22614,7801,9616,3011,7512,10678,4424
70576,736,356,380,167,141,48,143,154,83
70577,4429,2133,2296,743,999,391,750,1139,407
70578,14928,7124,7804,2620,3564,940,2605,3852,1347
70580,193,102,91,37,57,8,34,43,14
70581,841,415,426,156,204,55,173,174,79
70582,20159,9682,10477,3727,4706,1249,3635,5242,1600
70583,10330,5017,5313,1944,2599,474,1874,2859,580
70584,6117,2930,3187,1051,1463,416,1101,1590,496
70585,157,62,95,21,30,11,36,36,23
70586,21356,10557,10799,3981,4926,1650,3694,5027,2078
70589,3696,1775,1921,615,860,300,543,973,405
70591,5277,2589,2688,988,1221,380,861,1311,516
70592,11139,5561,5578,2037,3101,423,1929,3166,483
70601,34954,16238,18716,5635,7833,2770,5585,8450,4681
70605,29591,14299,15292,4955,7232,2112,4750,7684,2858
70607,22744,11025,11719,3984,5763,1278,4036,6056,1627
70611,16752,8232,8520,3090,4379,763,3004,4547,969
70615,14195,7346,6849,2438,4038,870,2144,3762,943
70630,1013,497,516,202,226,69,172,274,70
70631,3401,1669,1732,517,881,271,621,796,315
70632,1248,629,619,213,288,128,180,332,107
70633,7806,3782,4024,1371,1756,655,1298,1950,776
70634,23461,11495,11966,4111,5658,1726,3754,5993,2219
70637,625,322,303,143,126,53,91,137,75
70638,1007,453,554,162,224,67,214,260,80
70639,657,303,354,86,147,70,124,142,88
70640,439,201,238,78,102,21,78,121,39
70643,642,317,325,68,165,84,98,161,66
70644,152,63,89,13,43,7,32,51,6
70645,1639,819,820,285,444,90,243,426,151
70646,324,125,199,43,65,17,74,70,55
70647,7059,3517,3542,1318,1762,437,1167,1887,488
70648,7237,4269,2968,1106,2737,426,901,1435,632
70650,344,154,190,48,63,43,51,99,40
70651,228,140,88,65,50,25,28,48,12
70652,2044,989,1055,319,523,147,433,498,124
70653,3346,1602,1744,506,822,274,527,838,379
70654,291,113,178,43,55,15,65,80,33
70655,3167,1577,1590,539,741,297,446,807,337
70656,4137,2075,2062,723,1065,287,688,1051,323
70657,3772,2029,1743,736,1020,273,607,857,279
70658,772,385,387,145,198,42,142,201,44
70659,768,356,412,103,193,60,135,154,123
70660,2375,1533,842,369,1105,59,255,474,113
70661,2451,1233,1218,401,600,232,393,593,232
70662,439,207,232,83,89,35,90,104,38
70663,27032,13434,13598,4598,6986,1850,4203,6830,2565
70665,9124,4490,4634,1536,2400,554,1503,2585,546
70668,6556,3163,3393,1104,1598,461,1048,1772,573
70669,10052,4929,5123,1749,2532,648,1583,2624,916
70706,13461,6783,6678,2724,3466,593,2444,3607,627
70710,3082,1500,1582,607,757,136,591,819,172
70711,4047,1994,2053,755,956,283,647,1073,333
70712,5513,5271,242,288,4856,127,103,139,0
70714,20392,9963,10429,4200,4568,1195,3399,5495,1535
70715,1275,600,675,208,257,135,213,298,164
70717,83,40,43,17,17,6,18,17,8
70719,3608,1772,1836,635,927,210,582,971,283
70720,551,238,313,99,119,20,126,172,15
70721,437,211,226,93,87,31,65,101,60
70722,5990,2902,3088,981,1527,394,924,1604,560
70723,2040,1044,996,412,487,145,346,532,118
70725,1166,581,585,307,200,74,221,272,92
70726,36398,17866,18532,6530,9408,1928,6078,9768,2686
70729,103,47,56,26,14,7,12,28,16
70730,4045,2080,1965,537,1007,536,683,966,316
70732,1074,542,532,173,276,93,164,276,92
70733,1479,719,760,226,371,122,246,391,123
70734,2920,1408,1512,508,735,165,544,819,149
70736,523,250,273,75,129,46,66,175,32
70737,28636,14106,14530,4969,7705,1432,4896,7815,1819
70739,10650,5309,5341,1893,2782,634,1665,2982,694
70740,1337,645,692,209,344,92,207,369,116
70743,295,151,144,43,69,39,32,89,23
70744,4738,2422,2316,835,1333,254,784,1254,278
70747,75,42,33,13,18,11,13,20,0
70748,7641,4720,2921,1171,3156,393,881,1490,550
70749,1478,778,700,211,422,145,177,380,143
70750,1656,815,841,270,398,147,270,408,163
70752,742,374,368,110,192,72,82,208,78
70753,1179,585,594,204,312,69,186,306,102
70754,7246,3690,3556,1323,1938,429,1206,1839,511
70755,2397,1190,1207,404,635,151,383,655,169
70756,344,175,169,61,90,24,49,85,35
70757,3297,1561,1736,619,712,230,639,783,314
70759,1492,689,803,243,326,120,269,374,160
70760,7559,3525,4034,1352,1607,566,1281,1741,1012
70761,1273,597,676,263,244,90,240,303,133
70762,639,319,320,95,202,22,79,197,44
70763,3098,1461,1637,502,809,150,604,829,204
70764,17796,8554,9242,3103,4317,1134,2968,4600,1674
70767,14269,7083,7186,2511,3719,853,2295,3657,1234
70769,24005,12077,11928,4501,6738,838,4077,6864,987
70770,3790,1793,1997,597,1011,185,710,1076,211
70772,765,391,374,163,181,47,117,183,74
70773,190,116,74,48,55,13,3,38,33
70774,7455,3707,3748,1350,2018,339,1341,1982,425
70775,8122,3854,4268,1466,1933,455,1409,2203,656
70776,5277,3184,2093,691,2312,181,430,1501,162
70777,3863,1913,1950,644,1013,256,616,1020,314
70778,1633,806,827,297,395,114,278,419,130
70780,1012,453,559,148,242,63,212,242,105
70781,255,153,102,45,76,32,30,51,21
70782,298,142,156,66,58,18,77,67,12
70783,2347,1183,1164,396,631,156,344,651,169
70785,15252,7557,7695,2832,4037,688,2531,4276,888
70787,152,84,68,41,28,15,8,33,27
70788,4407,2036,2371,740,951,345,872,1089,410
70789,739,340,399,140,139,61,135,200,64
70791,19805,9745,10060,3635,5008,1102,3356,5178,1526
70801,90,51,39,8,43,0,7,32,0
70802,30410,14387,16023,5677,7162,1548,5697,7459,2867
70805,31110,14600,16510,6504,6728,1368,6247,8384,1879
70806,27611,12805,14806,3965,7029,1811,3777,7675,3354
70807,22372,10978,11394,4999,4898,1081,4541,5011,1842
70808,34336,16542,17794,5649,8676,2217,6548,8093,3153
70809,19388,9116,10272,2451,5324,1341,2288,5821,2163
70810,29973,14430,15543,5130,8113,1187,4992,9162,1389
70811,12359,5768,6591,2297,2712,759,2273,3211,1107
70812,11959,5487,6472,2473,2522,492,2478,3307,687
70814,14148,6541,7607,2407,3294,840,2557,3986,1064
70815,28918,13602,15316,4514,6568,2520,4372,7368,3576
70816,37156,18085,19071,5834,10533,1718,5620,11219,2232
70817,27313,13617,13696,4775,7813,1029,4338,8187,1171
70818,10014,4744,5270,1631,2461,652,1815,2671,784
70819,4989,2313,2676,654,1325,334,713,1407,556
70820,14904,7575,7329,3344,4010,221,3632,3423,274
70836,0,0,0,0,0,0,0,0,0
71001,4659,2182,2477,850,891,441,717,1096,664
71002,124,61,63,20,30,11,13,34,16
71003,1075,569,506,185,259,125,141,245,120
71004,705,359,346,145,143,71,97,158,91
71006,9741,4738,5003,1639,2317,782,1529,2578,896
71007,1429,650,779,193,356,101,336,346,97
71008,905,398,507,135,179,84,132,230,145
71009,462,222,240,105,101,16,76,117,47
71016,2218,1089,1129,420,498,171,409,514,206
71018,1650,787,863,266,349,172,255,408,200
71019,8927,4270,4657,1678,1900,692,1492,2176,989
71021,860,389,471,174,169,46,150,209,112
71023,3656,1768,1888,487,964,317,588,924,376
71024,1211,567,644,164,288,115,201,316,127
71027,1662,780,882,246,441,93,275,428,179
71028,2008,932,1076,308,438,186,316,486,274
71029,248,123,125,47,54,22,46,54,25
71030,1253,621,632,276,285,60,215,328,89
71031,1199,635,564,208,311,116,145,298,121
71032,1628,748,880,237,355,156,309,383,188
71033,2438,1205,1233,381,654,170,304,711,218
71034,178,93,85,27,56,10,22,42,21
71037,18263,9069,9194,3200,4769,1100,3026,4895,1273
71038,4887,2303,2584,810,1011,482,797,1148,639
71039,2303,1173,1130,426,546,201,350,540,240
71040,9039,4622,4417,1354,2476,792,1340,1932,1145
71043,686,361,325,131,157,73,78,160,87
71044,715,368,347,103,157,108,76,161,110
71045,644,300,344,82,150,68,102,147,95
71046,1043,542,501,136,294,112,125,251,125
71047,10963,5721,5242,1853,3147,721,1579,2869,794
71048,42,18,24,0,5,13,3,11,10
71049,3663,1688,1975,640,769,279,661,881,433
71051,1886,1030,856,305,507,218,257,444,155
71052,11273,5235,6038,1867,2453,915,1973,2803,1262
71055,20125,9614,10511,3323,4647,1644,3009,4907,2595
71060,2845,1341,1504,425,708,208,490,784,230
71061,1924,872,1052,269,417,186,361,462,229
71063,815,447,368,161,200,86,86,190,92
71064,4274,2117,2157,617,1163,337,655,1013,489
71065,1173,530,643,190,223,117,188,288,167
71066,44,22,22,8,12,2,8,6,8
71067,1736,835,901,268,478,89,304,464,133
71068,4081,1900,2181,655,863,382,650,971,560
71069,824,380,444,123,174,83,154,190,100
71070,1563,779,784,229,408,142,211,360,213
71071,3158,1482,1676,432,755,295,530,762,384
71072,1612,792,820,210,431,151,244,428,148
71073,2244,1123,1121,327,626,170,355,540,226
71075,6351,2885,3466,879,1373,633,929,1503,1034
71078,4194,2177,2017,728,1155,294,562,1133,322
71079,298,182,116,67,56,59,29,62,25
71082,5538,2537,3001,858,1256,423,916,1302,783
71101,9938,4784,5154,1733,2279,772,1706,2254,1194
71103,10362,4679,5683,1716,2045,918,1648,2340,1695
71104,15232,7175,8057,2291,4023,861,2497,4130,1430
71105,20300,9477,10823,2597,5182,1698,2721,5398,2704
71106,33556,15669,17887,5823,7366,2480,5623,8756,3508
71107,30071,14787,15284,5433,7484,1870,5114,7515,2655
71108,20901,9431,11470,4005,4435,991,4284,5364,1822
71109,25878,11902,13976,4940,5415,1547,4732,6744,2500
71110,3376,1942,1434,1011,931,0,744,690,0
71111,31159,14754,16405,5494,7469,1791,5312,8329,2764
71112,26843,12948,13895,4381,6757,1810,4158,7226,2511
71115,11011,4783,6228,1241,2795,747,1480,3164,1584
71118,23644,11173,12471,3579,5636,1958,3185,6368,2918
71119,11205,5319,5886,1631,2739,949,1681,3160,1045
71129,12125,5832,6293,2031,3103,698,1863,3576,854
71201,21940,10007,11933,2888,5395,1724,3403,5541,2989
71202,30607,14379,16228,6915,6038,1426,6389,7576,2263
71203,33853,15755,18098,5881,7914,1960,6585,8724,2789
71218,78,32,46,6,13,13,10,22,14
71219,1238,617,621,228,292,97,233,269,119
71220,26301,12269,14032,4448,5795,2026,4428,6442,3162
71222,3652,1687,1965,619,775,293,595,856,514
71223,687,315,372,117,139,59,149,157,66
71225,4715,2254,2461,662,1248,344,734,1295,432
71226,1748,865,883,266,439,160,270,443,170
71227,2995,1525,1470,498,805,222,412,791,267
71229,1692,1035,657,327,602,106,199,325,133
71232,6828,3168,3660,1133,1458,577,1095,1699,866
71234,4172,2101,2071,701,1123,277,605,1136,330
71235,4103,2036,2067,689,1000,347,638,1014,415
71237,2033,1277,756,368,797,112,256,374,126
71238,2518,1232,1286,392,709,131,411,674,201
71241,9424,4592,4832,1481,2206,905,1326,2384,1122
71243,328,183,145,73,65,45,57,47,41
71245,2607,1195,1412,423,581,191,463,655,294
71247,954,426,528,116,200,110,134,216,178
71250,337,185,152,84,80,21,56,76,20
71251,8287,3939,4348,1394,1758,787,1203,2019,1126
71253,181,74,107,8,46,20,41,38,28
71254,8303,4266,4037,1602,2128,536,1518,1771,748
71256,440,227,213,68,122,37,54,95,64
71259,1727,831,896,313,360,158,243,455,198
71260,3139,1560,1579,541,770,249,506,748,325
71261,1604,766,838,313,323,130,293,385,160
71263,8580,4119,4461,1470,1848,801,1274,2060,1127
71264,1151,638,513,234,285,119,125,247,141
71266,1768,869,899,281,420,168,266,406,227
71268,3148,1471,1677,523,701,247,553,818,306
71269,12548,5622,6926,2030,2628,964,2137,3357,1432
71270,31434,15166,16268,6653,6869,1644,6702,7057,2509
71275,2444,1208,1236,385,625,198,409,609,218
71276,344,169,175,78,82,9,64,78,33
71277,2295,1117,1178,369,583,165,443,521,214
71280,2611,1277,1334,474,610,193,372,637,325
71282,12547,6298,6249,2846,2796,656,2421,2776,1052
71286,696,381,315,123,166,92,68,165,82
71291,31198,14713,16485,5071,7558,2084,4989,8174,3322
71292,19962,9814,10148,3142,5230,1442,3106,5305,1737
71295,14262,6702,7560,2429,3214,1059,2255,3515,1790
71301,23173,10694,12479,4046,5065,1583,3837,5887,2755
71302,14832,6714,8118,2601,3059,1054,2613,3803,1702
71303,19399,9125,10274,2984,4673,1468,3224,4854,2196
71316,45,15,30,0,9,6,4,10,16
71320,0,0,0,0,0,0,0,0,0
71322,7455,3698,3757,1421,1689,588,1143,1725,889
71323,1029,510,519,142,267,101,146,284,89
71325,1725,863,862,317,403,143,264,451,147
71326,1097,519,578,144,270,105,177,277,124
71327,5808,3401,2407,781,2376,244,808,1211,388
71328,6467,3035,3432,1093,1573,369,1215,1724,493
71330,52,31,21,11,20,0,0,21,0
71331,790,359,431,90,222,47,141,205,85
71333,686,359,327,129,172,58,50,189,88
71334,9480,4629,4851,1595,2205,829,1481,2206,1164
71336,1838,871,967,311,423,137,282,510,175
71339,138,75,63,24,43,8,14,28,21
71340,1291,813,478,264,479,70,106,247,125
71341,2668,1242,1426,416,634,192,385,712,329
71342,7485,3622,3863,1383,1651,588,1097,1836,930
71343,8052,3979,4073,1370,1901,708,1211,1967,895
71345,198,147,51,82,56,9,21,30,0
71346,3180,1418,1762,438,711,269,544,819,399
71350,4481,2150,2331,758,981,411,700,1101,530
71351,10954,5142,5812,1891,2520,731,1828,2896,1088
71353,2262,1071,1191,414,485,172,402,569,220
71354,1595,803,792,241,422,140,221,392,179
71355,2380,1163,1217,374,566,223,348,558,311
71356,566,270,296,96,120,54,72,106,118
71357,2828,1501,1327,486,803,212,450,576,301
71358,1263,609,654,257,221,131,222,277,155
71360,38435,18991,19444,6174,9935,2882,5949,9930,3565
71362,1767,880,887,262,456,162,236,397,254
71366,2250,1091,1159,353,595,143,354,536,269
71367,1512,765,747,280,399,86,236,365,146
71368,1487,680,807,269,278,133,289,362,156
71369,3315,1436,1879,548,665,223,589,977,313
71371,1846,917,929,284,465,168,297,423,209
71373,7197,3458,3739,1217,1661,580,1257,1804,678
71375,1416,618,798,232,283,103,224,366,208
71377,336,125,211,58,60,7,121,67,23
71378,2834,1318,1516,484,563,271,495,616,405
71401,106,70,36,41,19,10,6,19,11
71403,4032,1960,2072,678,961,321,631,1059,382
71404,911,461,450,156,238,67,153,231,66
71406,174,108,66,46,44,18,11,48,7
71407,588,323,265,127,153,43,62,165,38
71409,6912,3339,3573,1192,1705,442,1181,1876,516
71410,110,54,56,21,21,12,13,31,12
71411,3175,1518,1657,610,714,194,623,752,282
71414,226,98,128,46,44,8,33,55,40
71415,1089,728,361,203,477,48,112,189,60
71416,754,353,401,97,174,82,128,175,98
71417,5176,2428,2748,827,1153,448,922,1240,586
71418,6652,3192,3460,998,1573,621,928,1726,806
71419,2175,1093,1082,365,451,277,331,496,255
71422,1711,849,862,324,424,101,261,433,168
71423,4813,2374,2439,964,1139,271,964,1176,299
71424,1107,541,566,199,304,38,218,293,55
71425,252,140,112,50,61,29,28,60,24
71426,167,86,81,26,54,6,19,49,13
71427,377,201,176,93,83,25,64,83,29
71429,3106,1530,1576,441,766,323,504,763,309
71430,2243,1157,1086,408,565,184,353,515,218
71432,987,514,473,164,260,90,108,241,124
71433,4044,1960,2084,717,906,337,722,948,414
71434,35,20,15,0,14,6,6,9,0
71435,2885,1427,1458,462,753,212,440,782,236
71438,1135,535,600,131,268,136,154,232,214
71439,1850,849,1001,276,422,151,292,490,219
71441,698,375,323,118,180,77,102,164,57
71446,21941,11118,10823,3957,5699,1462,3355,5556,1912
71447,1615,759,856,250,361,148,285,412,159
71449,9430,4528,4902,1485,2127,916,1426,2294,1182
71450,1171,576,595,226,290,60,180,300,115
71452,59,32,27,0,13,19,0,7,20
71454,2343,1144,1199,385,565,194,357,577,265
71455,271,149,122,67,62,20,35,55,32
71456,1044,457,587,169,211,77,205,239,143
71457,27202,12872,14330,5281,6059,1532,5624,6332,2374
71459,14323,8285,6038,4023,4255,7,3053,2979,6
71461,2443,1220,1223,436,692,92,396,737,90
71462,1538,753,785,248,394,111,255,388,142
71463,11499,6588,4911,1565,4269,754,1563,2298,1050
71465,3083,1509,1574,504,735,270,479,774,321
71466,474,247,227,71,150,26,51,115,61
71467,4633,2297,2336,657,1258,382,715,1201,420
71468,942,437,505,166,207,64,142,255,108
71469,2631,1207,1424,336,616,255,389,723,312
71472,141,59,82,9,36,14,18,52,12
71473,504,237,267,48,130,59,79,111,77
71474,606,311,295,108,153,50,76,162,57
71479,846,425,421,99,242,84,98,224,99
71480,1197,809,388,204,527,78,128,178,82
71483,12423,6616,5807,1841,3748,1027,1810,2715,1282
71485,1642,862,780,365,409,88,259,427,94
71486,4764,2370,2394,827,1020,523,695,1119,580
71601,20492,9438,11054,3901,4213,1324,4102,4986,1966
71602,19721,10403,9318,3082,5975,1346,2930,4811,1577
71603,35769,16478,19291,5833,8083,2562,5756,9318,4217
71630,684,325,359,129,151,45,107,170,82
71631,758,409,349,145,185,79,55,179,115
71635,13595,6490,7105,2136,3275,1079,2131,3531,1443
71638,4866,2512,2354,723,1377,412,721,1079,554
71639,7491,3456,4035,1294,1704,458,1401,1886,748
71640,4039,1840,2199,747,746,347,712,1005,482
71642,532,244,288,58,127,59,86,119,83
71643,1716,810,906,304,348,158,301,404,201
71644,4171,3566,605,666,2823,77,229,267,109
71646,7189,3641,3548,1268,1801,572,1057,1749,742
71647,2481,1393,1088,452,743,198,369,467,252
71651,171,79,92,12,45,22,28,45,19
71652,1246,580,666,155,315,110,213,305,148
71653,5740,2854,2886,1086,1279,489,746,1447,693
71654,5220,2341,2879,827,1105,409,926,1305,648
71655,15273,7427,7846,2629,3794,1004,2510,3892,1444
71656,150,0,150,0,0,0,142,8,0
71658,942,465,477,170,238,57,179,232,66
71659,24,17,7,0,8,9,0,7,0
71660,1016,546,470,174,257,115,129,222,119
71661,526,241,285,101,83,57,93,110,82
71663,930,494,436,179,221,94,110,233,93
71665,5881,2830,3051,928,1417,485,960,1482,609
71666,79,35,44,5,17,13,25,19,0
71667,8176,3851,4325,1301,1908,642,1361,1980,984
71670,1495,757,738,246,347,164,207,375,156
71671,9249,4392,4857,1353,2152,887,1305,2250,1302
71674,1012,511,501,141,289,81,145,252,104
71675,1985,974,1011,300,473,201,353,460,198
71676,948,465,483,152,219,94,128,200,155
71677,212,112,100,52,50,10,32,49,19
71701,22199,10335,11864,3463,4959,1913,3407,5620,2837
71720,2875,1381,1494,482,709,190,434,697,363
71722,131,69,62,24,36,9,10,37,15
71724,412,205,207,56,97,52,53,106,48
71725,701,365,336,139,145,81,108,164,64
71726,1474,756,718,214,322,220,172,338,208
71730,35298,16699,18599,5728,8221,2750,5411,8865,4323
71740,1782,899,883,332,420,147,233,449,201
71742,6520,3146,3374,1063,1507,576,1014,1566,794
71743,4316,2040,2276,624,1057,359,676,1064,536
71744,3639,1735,1904,513,928,294,587,842,475
71745,313,137,176,51,68,18,54,85,37
71747,1361,671,690,200,352,119,185,365,140
71749,3024,1505,1519,478,737,290,415,745,359
71751,952,517,435,117,294,106,119,232,84
71752,1207,588,619,241,251,96,177,323,119
71753,17195,8094,9101,2918,3796,1380,2863,4102,2136
71758,585,269,316,88,132,49,95,143,78
71759,282,124,158,41,63,20,56,76,26
71762,2872,1384,1488,491,640,253,331,635,522
71763,1825,903,922,280,452,171,246,459,217
71764,2454,1091,1363,402,500,189,443,616,304
71765,2394,1166,1228,434,547,185,339,612,277
71766,900,413,487,138,210,65,133,260,94
71770,3558,1689,1869,569,827,293,521,876,472
71801,17236,8160,9076,2836,4083,1241,2913,4290,1873
71820,25,10,15,0,10,0,0,9,6
71822,8973,4310,4663,1402,2092,816,1315,2316,1032
71823,149,92,57,47,26,19,10,29,18
71825,675,328,347,121,167,40,115,168,64
71826,1394,659,735,208,305,146,231,329,175
71827,638,325,313,111,157,57,83,168,62
71832,9693,4799,4894,1768,2397,634,1685,2282,927
71833,2452,1190,1262,346,625,219,326,628,308
71834,1431,679,752,180,338,161,192,341,219
71835,1400,678,722,230,303,145,241,329,152
71836,3396,1650,1746,560,818,272,521,835,390
71837,4281,2142,2139,801,1092,249,707,1098,334
71838,1493,717,776,262,356,99,253,334,189
71839,421,211,210,90,78,43,72,100,38
71841,994,519,475,136,297,86,127,246,102
71842,2273,1128,1145,403,531,194,343,551,251
71845,2619,1247,1372,424,615,208,381,618,373
71846,2700,1341,1359,415,688,238,418,654,287
71847,715,366,349,115,189,62,108,170,71
71851,2440,1187,1253,375,593,219,370,615,268
71852,10194,4941,5253,1625,2524,792,1683,2497,1073
71853,510,268,242,64,160,44,83,119,40
71854,34310,16623,17687,5691,8534,2398,5275,8835,3577
71855,883,449,434,151,245,53,150,199,85
71857,6401,3134,3267,1036,1640,458,817,1658,792
71858,2609,1327,1282,462,616,249,334,635,313
71859,389,187,202,54,92,41,44,114,44
71860,3232,1542,1690,532,695,315,450,790,450
71861,2159,1052,1107,267,525,260,289,501,317
71862,789,365,424,111,171,83,104,220,100
71865,111,55,56,9,31,15,18,19,19
71866,613,304,309,78,173,53,100,161,48
71901,29615,14122,15493,4089,7446,2587,4513,7176,3804
71909,12742,6171,6571,728,1454,3989,515,1899,4157
71913,36838,17510,19328,4483,8514,4513,4335,9115,5878
71921,3286,1624,1662,499,839,286,466,862,334
71922,421,212,209,99,84,29,63,84,62
71923,17190,8295,8895,3273,3808,1214,3290,3830,1775
71929,4005,1991,2014,586,974,431,556,996,462
71933,1613,792,821,194,423,175,245,381,195
71935,986,509,477,145,261,103,132,257,88
71937,2137,1072,1065,380,499,193,350,515,200
71940,1799,915,884,265,474,176,226,432,226
71941,1955,1040,915,348,549,143,244,476,195
71943,3929,1928,2001,655,912,361,616,874,511
71944,847,436,411,156,213,67,134,216,61
71945,1647,781,866,230,388,163,289,387,190
71949,681,333,348,91,192,50,106,197,45
71950,698,347,351,105,193,49,91,176,84
71952,190,90,100,30,33,27,25,57,18
71953,14364,6949,7415,2157,3295,1497,1962,3559,1894
71956,3067,1494,1573,441,792,261,478,834,261
71957,3087,1473,1614,384,647,442,346,677,591
71958,2491,1153,1338,317,575,261,317,607,414
71959,869,492,377,169,227,96,95,197,85
71960,1778,860,918,258,424,178,270,419,229
71961,837,404,433,107,209,88,120,211,102
71962,874,426,448,107,197,122,110,205,133
71964,4149,2116,2033,752,1111,253,611,1103,319
71965,326,154,172,62,50,42,55,78,39
71968,4204,2140,2064,744,1052,344,646,1101,317
71969,358,168,190,55,98,15,58,104,28
71970,718,382,336,73,174,135,77,125,134
71971,376,172,204,48,87,37,80,91,33
71972,209,101,108,37,40,24,45,36,27
71973,1259,661,598,263,315,83,207,293,98
72001,504,260,244,61,124,75,67,109,68
72002,12926,6636,6290,2094,3671,871,1752,3594,944
72003,903,460,443,134,279,47,129,239,75
72004,1730,759,971,314,293,152,387,382,202
72005,126,62,64,6,42,14,6,41,17
72006,3213,1558,1655,555,751,252,490,793,372
72007,4747,2378,2369,797,1279,302,721,1338,310
72010,6403,3077,3326,941,1683,453,1061,1668,597
72011,2932,1459,1473,509,821,129,542,793,138
72012,9011,4525,4486,1564,2306,655,1308,2390,788
72013,1780,914,866,322,449,143,257,463,146
72014,93,42,51,9,20,13,28,18,5
72015,39898,19716,20182,6345,10538,2833,5881,10380,3921
72016,2957,1480,1477,542,786,152,457,852,168
72017,828,428,400,113,219,96,108,210,82
72020,4570,2249,2321,723,1142,384,707,1208,406
72021,5399,2542,2857,907,1131,504,881,1258,718
72022,8182,3887,4295,1436,2017,434,1303,2290,702
72023,24984,12392,12592,4244,6842,1306,4118,6838,1636
72024,4006,1924,2082,659,933,332,562,1024,496
72025,896,441,455,115,236,90,114,238,103
72026,366,187,179,46,118,23,42,107,30
72027,1372,690,682,199,325,166,219,307,156
72029,2249,1042,1207,374,516,152,353,562,292
72030,695,380,315,123,176,81,99,137,79
72031,7284,3572,3712,1054,1641,877,971,1679,1062
72032,59242,28740,30502,10674,15107,2959,10709,15802,3991
72036,1253,558,695,195,259,104,240,261,194
72038,43,17,26,2,15,0,10,16,0
72039,1702,874,828,251,438,185,201,399,228
72040,3111,1545,1566,503,747,295,398,750,418
72041,1677,839,838,260,418,161,237,403,198
72042,5712,2816,2896,907,1383,526,753,1421,722
72043,201,83,118,52,24,7,50,51,17
72044,774,378,396,77,116,185,67,161,168
72045,1172,556,616,174,251,131,189,295,132
72046,5654,3132,2522,810,1936,386,781,1182,559
72047,935,503,432,149,286,68,134,219,79
72048,139,76,63,16,53,7,11,36,16
72051,778,406,372,112,198,96,101,156,115
72053,320,166,154,34,103,29,47,59,48
72055,1003,482,521,129,252,101,125,245,151
72057,922,496,426,161,231,104,93,241,92
72058,12035,5951,6084,2130,3111,710,1953,3262,869
72060,813,435,378,126,167,142,88,178,112
72061,137,67,70,28,32,7,19,38,13
72063,1355,635,720,168,336,131,209,355,156
72064,2588,1270,1318,366,643,261,308,670,340
72065,4396,2220,2176,608,1268,344,592,1246,338
72067,2781,1396,1385,402,645,349,342,646,397
72068,330,163,167,51,85,27,63,80,24
72069,1867,866,1001,279,386,201,283,415,303
72070,1634,824,810,222,415,187,239,369,202
72072,619,305,314,113,147,45,95,131,88
72073,1501,741,760,250,378,113,210,409,141
72074,216,100,116,15,42,43,24,54,38
72075,278,129,149,33,73,23,34,86,29
72076,38671,19069,19602,6909,10311,1849,6439,10686,2477
72079,352,188,164,47,122,19,47,106,11
72080,155,89,66,21,45,23,12,37,17
72081,7401,3682,3719,1177,1895,610,1047,1860,812
72082,2016,960,1056,304,512,144,315,478,263
72083,249,132,117,27,70,35,22,66,29
72084,1281,650,631,235,320,95,207,294,130
72085,121,52,69,13,20,19,25,25,19
72086,9813,4755,5058,1528,2509,718,1452,2536,1070
72087,1334,690,644,151,397,142,180,362,102
72088,2571,1167,1404,127,336,704,158,356,890
72099,1309,1006,303,533,454,19,233,64,6
72101,3765,1748,2017,571,893,284,579,946,492
72102,2383,1157,1226,378,593,186,403,585,238
72103,11437,5725,5712,1781,3240,704,1795,3215,702
72104,21676,10510,11166,3390,5248,1872,3316,5310,2540
72105,53,22,31,0,14,8,4,20,7
72106,4136,2070,2066,599,1123,348,530,1117,419
72107,390,176,214,60,76,40,77,87,50
72108,168,87,81,40,31,16,38,37,6
72110,10613,5088,5525,1644,2450,994,1542,2533,1450
72111,1094,572,522,159,316,97,156,246,120
72112,11035,5151,5884,1857,2335,959,1382,3022,1480
72113,12405,5871,6534,1805,3504,562,1902,3919,713
72114,14366,6459,7907,2837,2816,806,2716,3626,1565
72116,20366,9679,10687,2618,5167,1894,2237,5703,2747
72117,12485,5967,6518,2185,2881,901,2148,3140,1230
72118,22572,11133,11439,3641,5909,1583,2974,6221,2244
72120,27876,13264,14612,4136,7517,1611,4314,8227,2071
72121,2461,1236,1225,379,621,236,357,600,268
72122,995,462,533,165,239,58,145,278,110
72123,557,311,246,72,154,85,79,104,63
72125,1728,862,866,279,468,115,283,462,121
72126,3485,1663,1822,510,775,378,475,848,499
72127,1975,938,1037,271,526,141,300,557,180
72128,724,368,356,137,180,51,110,179,67
72129,1318,696,622,230,354,112,172,315,135
72130,434,223,211,73,99,51,53,102,56
72131,4003,2029,1974,633,920,476,540,902,532
72132,2993,1486,1507,499,820,167,460,848,199
72133,19,10,9,0,0,10,0,0,9
72134,399,208,191,60,94,54,36,101,54
72135,2723,1387,1336,432,803,152,371,735,230
72136,1583,853,730,268,488,97,231,383,116
72137,2080,1006,1074,316,471,219,382,518,174
72139,190,86,104,20,55,11,38,50,16
72140,315,168,147,37,80,51,35,70,42
72141,552,270,282,85,130,55,75,157,50
72142,1934,952,982,296,484,172,285,544,153
72143,29861,14419,15442,5115,7020,2284,5064,7215,3163
72150,11021,5415,5606,1770,2859,786,1698,2885,1023
72152,701,379,322,101,184,94,72,145,105
72153,2309,1164,1145,328,588,248,293,592,260
72156,537,255,282,82,141,32,79,129,74
72157,1382,741,641,260,382,99,178,333,130
72160,11381,5203,6178,1650,2692,861,1780,2981,1417
72165,143,68,75,7,39,22,10,36,29
72166,304,149,155,31,81,37,27,97,31
72167,1942,930,1012,350,481,99,318,566,128
72168,1050,872,178,73,759,40,47,122,9
72169,237,116,121,39,57,20,50,54,17
72170,223,110,113,32,55,23,30,54,29
72173,6453,3215,3238,1252,1551,412,1135,1703,400
72175,363,175,188,34,91,50,16,90,82
72176,5367,2616,2751,1013,1297,306,1010,1355,386
72179,508,237,271,76,117,44,93,128,50
72180,139,59,80,11,30,18,43,26,11
72181,14,0,14,0,0,0,6,0,8
72183,837,760,77,31,729,0,0,77,0
72201,546,394,152,10,352,32,0,120,32
72202,12904,6163,6741,1746,3503,914,1664,3562,1515
72204,32519,15507,17012,5721,8229,1557,5334,9135,2543
72205,23892,11043,12849,2608,6724,1711,2511,6947,3391
72206,26486,12752,13734,4374,6578,1800,4026,6951,2757
72207,9778,4414,5364,1067,2605,742,1125,3053,1186
72209,36599,16855,19744,6875,8378,1602,6912,10450,2382
72210,6362,3241,3121,1018,1766,457,853,1796,472
72211,15521,7310,8211,1831,4886,593,2030,5286,895
72212,9851,4763,5088,1239,2705,819,1397,2963,728
72223,16122,7816,8306,2596,4452,768,2374,4857,1075
72227,12220,5731,6489,1444,3088,1199,1425,3550,1514
72301,27500,12757,14743,5202,6086,1469,4925,7335,2483
72311,153,61,92,15,29,17,38,37,17
72315,27381,12859,14522,4894,6161,1804,4958,6907,2657
72320,1865,1755,110,119,1627,9,30,69,11
72321,175,90,85,23,52,15,23,47,15
72322,223,109,114,45,62,2,31,64,19
72324,2344,1200,1144,393,638,169,361,576,207
72326,2105,1026,1079,345,515,166,318,575,186
72327,2043,1021,1022,332,531,158,290,550,182
72328,68,26,42,13,11,2,21,14,7
72329,87,46,41,21,25,0,16,18,7
72330,895,437,458,170,217,50,172,220,66
72331,4088,1924,2164,855,751,318,778,978,408
72332,147,76,71,26,38,12,27,32,12
72333,1081,502,579,214,205,83,203,249,127
72335,19539,10292,9247,3169,5984,1139,3216,4237,1794
72338,37,24,13,7,17,0,0,13,0
72339,356,189,167,100,72,17,63,82,22
72340,127,47,80,28,15,4,38,35,7
72341,299,150,149,47,50,53,63,40,46
72342,7315,3309,4006,1381,1343,585,1421,1725,860
72346,992,514,478,197,260,57,138,252,88
72347,918,446,472,115,233,98,126,239,107
72348,3398,1584,1814,568,782,234,618,855,341
72350,1435,654,781,225,319,110,237,376,168
72351,855,397,458,112,211,74,133,228,97
72353,99,39,60,14,22,3,26,23,11
72354,2672,1288,1384,501,598,189,440,653,291
72355,3142,1495,1647,516,802,177,502,829,316
72358,1973,1061,912,408,513,140,311,398,203
72359,698,322,376,176,106,40,113,190,73
72360,8065,3597,4468,1408,1558,631,1575,1939,954
72364,12448,6207,6241,2211,3507,489,2158,3424,659
72365,3490,1630,1860,543,762,325,497,871,492
72366,3048,1398,1650,575,553,270,531,706,413
72367,255,122,133,52,55,15,59,56,18
72368,1383,665,718,226,275,164,196,291,231
72369,51,26,25,5,14,7,4,8,13
72370,10071,4763,5308,1931,2219,613,1871,2514,923
72372,2394,1177,1217,407,538,232,381,586,250
72373,1939,909,1030,335,414,160,355,453,222
72374,850,408,442,140,172,96,117,220,105
72376,1967,939,1028,306,463,170,391,491,146
72377,92,61,31,19,29,13,5,26,0
72379,107,59,48,18,28,13,12,21,15
72383,129,43,86,22,0,21,43,15,28
72384,1330,664,666,312,262,90,240,271,155
72386,2227,1083,1144,396,568,119,365,602,177
72387,28,9,19,0,9,0,0,13,6
72389,378,197,181,74,74,49,63,84,34
72390,10562,4798,5764,2127,2024,647,2160,2586,1018
72392,537,252,285,90,115,47,64,148,73
72394,778,405,373,164,156,85,126,171,76
72395,1144,529,615,179,272,78,211,290,114
72396,14167,6793,7374,2356,3397,1040,2291,3678,1405
72401,47317,22439,24878,7604,11816,3019,7907,12244,4727
72404,16526,8298,8228,2845,4630,823,2626,4680,922
72410,557,279,278,67,143,69,66,126,86
72411,2397,1158,1239,420,539,199,401,601,237
72412,618,324,294,102,170,52,69,150,75
72413,562,263,299,78,131,54,98,130,71
72414,398,201,197,68,108,25,47,94,56
72415,1723,892,831,286,436,170,258,381,192
72416,5108,2498,2610,814,1345,339,803,1402,405
72417,2756,1394,1362,480,730,184,419,733,210
72419,1888,934,954,318,467,149,253,493,208
72421,546,259,287,66,153,40,82,122,83
72422,5551,2677,2874,855,1257,565,743,1377,754
72424,70,43,27,8,25,10,3,14,10
72425,542,292,250,112,134,46,73,119,58
72426,198,100,98,41,42,17,31,39,28
72427,186,82,104,19,41,22,31,47,26
72428,110,50,60,7,34,9,11,38,11
72429,467,233,234,70,130,33,63,126,45
72430,421,238,183,72,132,34,37,100,46
72431,452,225,227,57,126,42,56,126,45
72432,6553,3252,3301,1034,1710,508,932,1712,657
72433,3590,1764,1826,642,836,286,544,945,337
72434,1883,906,977,286,403,217,266,453,258
72435,567,270,297,83,126,61,67,146,84
72436,1080,533,547,151,309,73,166,300,81
72437,3344,1640,1704,590,764,286,486,854,364
72438,2571,1224,1347,408,601,215,423,639,285
72440,125,62,63,17,30,15,18,30,15
72441,141,59,82,13,19,27,12,47,23
72442,4600,2216,2384,726,1142,348,710,1196,478
72443,2678,1308,1370,366,710,232,383,703,284
72444,2102,1063,1039,306,500,257,252,529,258
72445,0,0,0,0,0,0,0,0,0
72447,2011,958,1053,258,506,194,218,484,351
72449,220,106,114,35,48,23,27,57,30
72450,31297,15141,16156,4935,7941,2265,4649,8043,3464
72453,327,152,175,61,65,26,46,75,54
72454,5287,2505,2782,734,1167,604,644,1214,924
72455,12682,6087,6595,1878,3077,1132,1796,3134,1665
72456,706,345,361,111,179,55,104,183,74
72457,259,118,141,47,51,20,35,57,49
72458,471,237,234,54,110,73,57,105,72
72459,1050,527,523,173,250,104,146,268,109
72460,813,398,415,146,168,84,110,213,92
72461,4132,2059,2073,598,1005,456,512,938,623
72462,508,247,261,95,125,27,92,133,36
72464,261,144,117,65,60,19,27,70,20
72466,1096,567,529,195,275,97,158,257,114
72467,434,122,312,104,18,0,227,78,7
72469,1321,657,664,212,290,155,196,312,156
72470,435,210,225,80,95,35,67,122,36
72471,1243,576,667,175,299,102,212,305,150
72472,9218,4542,4676,1521,2296,725,1353,2355,968
72473,2459,1172,1287,319,586,267,348,612,327
72475,99,54,45,11,35,8,14,22,9
72476,7061,3278,3783,1048,1601,629,1033,1696,1054
72478,267,157,110,56,83,18,16,51,43
72479,1741,844,897,267,431,146,245,466,186
72482,1553,790,763,178,400,212,170,363,230
72501,23948,11688,12260,3777,5938,1973,3483,6059,2718
72512,2332,1064,1268,154,346,564,190,407,671
72513,2928,1338,1590,375,667,296,452,701,437
72515,118,52,66,10,29,13,19,33,14
72517,294,154,140,49,80,25,38,70,32
72519,3260,1856,1404,450,1144,262,427,642,335
72520,200,94,106,29,48,17,19,72,15
72521,4903,2280,2623,707,1114,459,757,1237,629
72522,242,126,116,32,80,14,32,66,18
72523,1282,605,677,188,308,109,210,339,128
72524,365,180,185,41,88,51,59,78,48
72525,239,122,117,14,27,81,12,36,69
72526,91,39,52,18,18,3,16,31,5
72527,396,174,222,50,96,28,34,143,45
72528,234,115,119,41,57,17,35,52,32
72529,4519,2261,2258,523,768,970,357,846,1055
72530,1936,932,1004,278,514,140,303,523,178
72531,525,243,282,49,114,80,58,131,93
72532,1189,588,601,162,304,122,158,306,137
72533,383,165,218,36,97,32,66,110,42
72534,1055,537,518,188,253,96,130,293,95
72536,617,302,315,79,159,64,80,167,68
72537,876,499,377,132,245,122,40,209,128
72538,407,197,210,83,106,8,88,97,25
72539,234,135,99,45,71,19,15,55,29
72540,167,83,84,18,41,24,16,42,26
72542,3517,1724,1793,548,746,430,458,797,538
72543,11408,5386,6022,1381,2525,1480,1380,2807,1835
72544,665,339,326,85,148,106,84,149,93
72550,663,398,265,116,170,112,32,136,97
72553,53,27,26,6,9,12,3,5,18
72554,3192,1520,1672,402,705,413,418,771,483
72555,161,79,82,8,39,32,22,37,23
72556,3324,1574,1750,459,791,324,466,840,444
72560,7581,3684,3897,974,1742,968,971,1783,1143
72561,1079,555,524,179,268,108,151,278,95
72562,2096,989,1107,328,531,130,337,551,219
72564,312,162,150,60,69,33,37,76,37
72565,1188,598,590,203,271,124,172,291,127
72566,415,225,190,76,111,38,45,117,28
72567,250,139,111,51,53,35,29,54,28
72568,1577,818,759,253,425,140,197,399,163
72569,629,344,285,121,167,56,85,156,44
72571,562,305,257,135,127,43,42,156,59
72572,183,99,84,20,61,18,17,47,20
72573,167,88,79,38,31,19,21,25,33
72576,3606,1772,1834,527,771,474,428,828,578
72577,692,333,359,94,169,70,111,161,87
72578,110,48,62,17,31,0,22,32,8
72579,1171,619,552,228,314,77,170,286,96
72581,945,485,460,85,208,192,52,256,152
72583,1549,761,788,215,406,140,244,404,140
72584,319,156,163,20,80,56,41,67,55
72585,167,91,76,27,46,18,14,45,17
72587,130,60,70,13,26,21,10,43,17
72601,27793,13435,14358,4128,6736,2571,3950,6954,3454
72610,150,83,67,21,51,11,15,41,11
72611,1421,722,699,209,392,121,172,367,160
72616,9617,4884,4733,1684,2429,771,1337,2327,1069
72617,372,174,198,45,78,51,61,79,58
72619,1985,976,1009,137,367,472,143,354,512
72623,465,213,252,34,143,36,64,157,31
72624,693,337,356,89,187,61,112,178,66
72626,1160,572,588,110,272,190,124,278,186
72628,955,497,458,145,248,104,113,228,117
72629,603,294,309,74,152,68,87,163,59
72630,333,169,164,27,70,72,24,70,70
72631,3354,1654,1700,350,671,633,252,817,631
72632,4191,1923,2268,418,1106,399,528,1207,533
72633,1694,796,898,264,432,100,292,464,142
72634,4497,2166,2331,689,1035,442,634,1171,526
72635,3163,1490,1673,446,736,308,452,815,406
72638,6948,3510,3438,1233,1802,475,1189,1715,534
72639,429,222,207,43,138,41,57,99,51
72640,466,243,223,96,115,32,59,123,41
72641,2747,1339,1408,386,677,276,373,674,361
72642,1954,959,995,128,280,551,126,332,537
72644,1850,928,922,247,408,273,216,454,252
72645,1813,901,912,260,398,243,242,401,269
72648,839,448,391,170,219,59,120,215,56
72650,4597,2305,2292,652,1084,569,560,1090,642
72651,1118,527,591,173,217,137,190,252,149
72653,26480,12435,14045,2827,5336,4272,2873,6093,5079
72655,431,233,198,59,120,54,56,86,56
72658,1534,762,772,209,361,192,166,390,216
72660,476,225,251,78,119,28,82,125,44
72661,528,269,259,17,116,136,22,112,125
72662,2474,1219,1255,386,599,234,329,671,255
72663,433,206,227,45,109,52,53,119,55
72666,77,37,40,0,12,25,5,16,19
72668,245,131,114,35,42,54,24,60,30
72669,236,107,129,41,51,15,31,74,24
72672,484,254,230,83,137,34,96,114,20
72675,1439,714,725,207,365,142,196,357,172
72677,277,129,148,56,60,13,55,65,28
72679,54,21,33,8,10,3,7,11,15
72680,674,378,296,102,182,94,64,174,58
72682,42,33,9,14,10,9,0,5,4
72683,242,118,124,36,67,15,47,59,18
72685,1310,644,666,227,319,98,198,351,117
72686,58,28,30,7,9,12,5,10,15
72687,6656,3354,3302,1006,1579,769,853,1670,779
72701,33913,17197,16716,6228,9282,1687,6192,8440,2084
72703,25966,13041,12925,4188,7409,1444,4030,6684,2211
72704,13294,6688,6606,2279,3793,616,2262,3664,680
72711,18,7,11,0,4,3,3,2,6
72712,24554,11899,12655,4237,6393,1269,4293,6654,1708
72714,9345,4449,4896,771,1488,2190,690,1790,2416
72715,6463,3170,3293,192,952,2026,296,918,2079
72717,821,399,422,135,198,66,138,204,80
72718,918,513,405,176,266,71,114,235,56
72719,2502,1255,1247,509,654,92,437,696,114
72721,222,80,142,27,48,5,60,52,30
72722,2602,1374,1228,546,666,162,409,661,158
72727,4565,2314,2251,817,1256,241,711,1212,328
72729,351,186,165,54,101,31,44,95,26
72730,5994,2948,3046,1116,1488,344,959,1667,420
72732,4341,2210,2131,648,1162,400,663,1033,435
72734,6793,3391,3402,1247,1724,420,1172,1699,531
72736,5045,2495,2550,854,1267,374,814,1278,458
72738,2225,1188,1037,375,638,175,294,556,187
72739,578,288,290,76,159,53,100,139,51
72740,8106,4073,4033,1428,1974,671,1238,1934,861
72742,566,287,279,95,144,48,81,134,64
72744,4550,2263,2287,747,1144,372,656,1149,482
72745,9339,4637,4702,1451,2774,412,1591,2594,517
72747,216,109,107,47,51,11,44,43,20
72749,53,32,21,23,8,1,5,11,5
72751,4406,2133,2273,778,1039,316,754,1146,373
72752,369,205,164,57,96,52,48,68,48
72753,6342,3122,3220,1062,1532,528,1015,1618,587
72756,36791,18311,18480,6188,9617,2506,6022,9174,3284
72758,17989,8607,9382,2858,4450,1299,2912,4709,1761
72760,607,305,302,76,155,74,73,161,68
72761,16004,7907,8097,2943,3980,984,2626,4116,1355
72762,26137,12469,13668,4126,6737,1606,4385,6913,2370
72764,31946,16163,15783,5828,8565,1770,5416,8054,2313
72768,1578,793,785,311,378,104,280,386,119
72769,934,477,457,141,271,65,154,235,68
72773,871,430,441,143,158,129,135,205,101
72774,5242,2630,2612,901,1375,354,792,1431,389
72776,549,303,246,98,163,42,73,138,35
72801,16490,7833,8657,2730,3933,1170,2847,3861,1949
72802,18345,9135,9210,3128,4814,1193,2883,4945,1382
72820,279,124,155,28,69,27,63,69,23
72821,1650,829,821,294,404,131,259,376,186
72823,6492,3125,3367,1009,1585,531,1036,1640,691
72824,1769,907,862,257,474,176,258,438,166
72826,71,45,26,11,13,21,2,13,11
72827,244,113,131,30,52,31,49,54,28
72828,138,72,66,24,35,13,23,26,17
72829,38,23,15,0,14,9,0,15,0
72830,12476,6021,6455,1973,2974,1074,1882,3071,1502
72832,1023,545,478,163,272,110,141,216,121
72833,4553,2246,2307,716,1226,304,723,1033,551
72834,9309,4634,4675,1625,2310,699,1273,2402,1000
72835,796,420,376,90,217,113,86,206,84
72837,7281,3655,3626,1217,1820,618,1052,1953,621
72838,172,78,94,26,39,13,17,42,35
72839,152,72,80,25,33,14,12,43,25
72840,1964,959,1005,335,476,148,306,493,206
72841,175,82,93,31,32,19,30,42,21
72842,1452,706,746,242,328,136,228,363,155
72843,2161,1095,1066,344,554,197,319,519,228
72845,1066,565,501,209,275,81,129,262,110
72846,4094,2121,1973,756,1044,321,617,974,382
72847,2487,1220,1267,392,614,214,403,601,263
72851,544,245,299,56,137,52,93,121,85
72852,313,171,142,54,80,37,43,77,22
72853,2170,1089,1081,379,526,184,341,522,218
72854,554,277,277,74,152,51,72,118,87
72855,6491,3109,3382,966,1532,611,882,1586,914
72856,531,283,248,86,149,48,68,129,51
72857,1450,760,690,246,343,171,215,305,170
72858,2554,1304,1250,434,679,191,419,650,181
72860,503,266,237,91,123,52,62,115,60
72863,1650,814,836,275,402,137,262,384,190
72865,1068,533,535,151,280,102,153,297,85
72901,22708,11379,11329,3684,6291,1404,3443,5720,2166
72903,23820,11282,12538,3426,5831,2025,3227,6255,3056
72904,19965,9489,10476,3266,4918,1305,3423,5001,2052
72908,12023,5778,6245,1869,3128,781,1923,3291,1031
72916,5293,2791,2502,850,1664,277,689,1470,343
72921,11311,5617,5694,1960,2858,799,1854,2997,843
72923,4298,2083,2215,663,1193,227,645,1154,416
72926,682,360,322,103,166,91,72,177,73
72927,8475,4208,4267,1392,2024,792,1185,2028,1054
72928,621,319,302,112,129,78,70,154,78
72930,438,243,195,43,124,76,31,67,97
72932,684,323,361,109,188,26,122,194,45
72933,5092,2576,2516,881,1331,364,744,1227,545
72934,778,399,379,112,233,54,151,181,47
72935,236,107,129,37,50,20,29,67,33
72936,12408,6030,6378,2109,3168,753,2047,3300,1031
72937,3302,1653,1649,532,841,280,487,866,296
72938,1548,745,803,245,364,136,266,363,174
72940,2513,1229,1284,445,622,162,430,642,212
72941,4346,2067,2279,674,1104,289,707,1210,362
72943,2812,1454,1358,514,687,253,465,705,188
72944,2420,1212,1208,388,628,196,389,578,241
72945,251,124,127,46,56,22,47,59,21
72946,3977,2025,1952,665,1011,349,628,970,354
72947,4203,2181,2022,702,1116,363,533,1053,436
72948,569,288,281,111,122,55,85,138,58
72949,10064,4981,5083,1646,2400,935,1464,2442,1177
72950,383,204,179,44,77,83,17,67,95
72951,1032,502,530,151,238,113,168,245,117
72952,2805,1550,1255,611,779,160,311,769,175
72955,490,246,244,99,122,25,88,133,23
72956,29294,14295,14999,5075,7217,2003,4742,7640,2617
72958,7975,4052,3923,1477,1904,671,1135,1895,893
72959,2700,1392,1308,479,689,224,409,671,228
73002,1242,632,610,246,272,114,189,299,122
73003,36280,17445,18835,6446,9726,1273,6569,10689,1577
73004,833,415,418,150,202,63,132,219,67
73005,10097,4853,5244,2014,2195,644,1914,2337,993
73006,3869,1867,2002,643,902,322,684,965,353
73007,1637,846,791,233,459,154,242,420,129
73008,20986,10013,10973,3408,4812,1793,3246,5159,2568
73009,1358,651,707,199,318,134,218,315,174
73010,12166,6145,6021,2146,3164,835,1990,3187,844
73011,369,195,174,64,86,45,39,87,48
73013,32126,15350,16776,5685,7685,1980,5441,8628,2707
73014,1553,740,813,272,359,109,289,383,141
73015,3190,1595,1595,573,704,318,444,707,444
73016,1372,660,712,229,352,79,272,357,83
73017,1791,862,929,266,438,158,267,495,167
73018,19529,9172,10357,3190,4532,1450,3038,4968,2351
73020,17147,8482,8665,2747,4594,1141,2501,4947,1217
73021,431,217,214,64,116,37,72,111,31
73022,141,89,52,56,33,0,27,25,0
73024,701,294,407,108,123,63,121,137,149
73026,9215,4685,4530,1396,2665,624,1342,2620,568
73027,1062,566,496,180,306,80,152,251,93
73028,3254,1640,1614,521,726,393,420,771,423
73029,1872,880,992,283,421,176,313,417,262
73030,4115,1993,2122,728,882,383,552,1087,483
73031,74,33,41,3,16,14,8,19,14
73032,217,113,104,23,57,33,19,48,37
73033,245,125,120,27,67,31,27,56,37
73034,30180,14827,15353,5255,7888,1684,4997,8196,2160
73036,17780,9541,8239,2538,5707,1296,2598,3917,1724
73038,2171,1069,1102,344,477,248,319,512,271
73040,1917,935,982,302,418,215,317,443,222
73041,425,204,221,65,104,35,48,109,64
73042,1102,565,537,195,269,101,146,270,121
73043,138,60,78,5,41,14,27,33,18
73044,18416,8800,9616,3050,4270,1480,2902,4744,1970
73045,9227,4504,4723,1606,2274,624,1546,2329,848
73047,3735,2202,1533,503,1360,339,451,724,358
73048,2152,1054,1098,371,470,213,315,496,287
73049,5251,2576,2675,813,1354,409,846,1397,432
73050,1653,773,880,506,235,32,642,190,48
73051,9267,5811,3456,1402,3769,640,964,1939,553
73052,5965,2798,3167,852,1241,705,870,1449,848
73053,733,373,360,107,191,75,97,175,88
73054,4027,1986,2041,695,1003,288,651,1010,380
73055,9471,4619,4852,1553,2137,929,1332,2317,1203
73056,423,218,205,54,107,57,53,92,60
73057,2587,1265,1322,403,627,235,382,616,324
73058,268,133,135,46,66,21,46,70,19
73059,2729,1359,1370,456,666,237,425,655,290
73061,1282,642,640,240,322,80,198,341,101
73062,1622,779,843,238,329,212,213,341,289
73063,663,331,332,83,169,79,105,159,68
73064,15965,7872,8093,2863,4151,858,2517,4381,1195
73065,5411,2722,2689,900,1464,358,852,1455,382
73066,224,115,109,34,62,19,19,54,36
73067,2008,1010,998,334,529,147,321,538,139
73068,10616,5132,5484,1830,2707,595,1897,2837,750
73069,22291,11335,10956,3702,6283,1350,3148,5569,2239
73071,28351,14133,14218,4714,8100,1319,4672,8093,1453
73072,38269,19225,19044,7453,9971,1801,6997,9605,2442
73073,561,293,268,101,143,49,89,131,48
73074,1117,567,550,190,271,106,155,276,119
73075,8963,4218,4745,1307,2224,687,1261,2299,1185
73077,7200,3559,3641,1070,1818,671,975,1678,988
73078,4846,2417,2429,864,1296,257,820,1333,276
73079,588,278,310,79,145,54,105,144,61
73080,7986,3938,4048,1216,2049,673,1205,1968,875
73082,3135,1596,1539,557,734,305,420,742,377
73084,6779,3445,3334,1257,1624,564,1090,1437,807
73086,8030,4031,3999,1219,1896,916,1017,1970,1012
73089,8111,3991,4120,1354,2143,494,1290,2272,558
73090,869,482,387,217,202,63,128,204,55
73092,917,419,498,136,181,102,165,213,120
73093,2023,1021,1002,383,526,112,319,546,137
73095,1863,892,971,300,440,152,363,442,166
73096,12092,5837,6255,2329,2901,607,2615,2773,867
73097,15,6,9,0,0,6,0,0,9
73098,4434,2108,2326,665,974,469,613,1092,621
73099,41538,20118,21420,6929,10939,2250,6870,11593,2957
73102,3600,2667,933,461,2021,185,110,699,124
73103,4638,2351,2287,591,1561,199,599,1398,290
73104,2090,994,1096,430,440,124,384,579,133
73105,4854,2230,2624,746,1114,370,615,1263,746
73106,13314,7042,6272,2434,4150,458,2396,3258,618
73107,24719,12132,12587,3687,6974,1471,3307,6755,2525
73108,14930,7631,7299,3088,3912,631,3070,3347,882
73109,19463,9555,9908,3351,4873,1331,3118,4640,2150
73110,34286,16080,18206,5558,8240,2282,5424,8996,3786
73111,12519,5289,7230,1978,2118,1193,1968,3313,1949
73112,30222,14188,16034,3463,8209,2516,3370,8641,4023
73114,16558,7685,8873,3177,3744,764,3141,4407,1325
73115,21563,10331,11232,3473,5175,1683,3449,5445,2338
73116,10170,4860,5310,1264,2502,1094,1079,2638,1593
73117,5225,2234,2991,735,1052,447,883,1285,823
73118,14132,6953,7179,1785,4328,840,1686,4318,1175
73119,28819,14004,14815,5213,6962,1829,4872,7068,2875
73120,35308,16592,18716,4057,9654,2881,4285,10197,4234
73121,3144,1540,1604,485,658,397,453,725,426
73122,13436,6420,7016,2078,3233,1109,1880,3543,1593
73127,25326,12500,12826,4706,6287,1507,4231,6463,2132
73128,2011,1047,964,353,564,130,282,524,158
73129,19924,9903,10021,3904,4929,1070,3929,4623,1469
73130,17988,8626,9362,2948,4429,1249,2807,4994,1561
73131,2440,1270,1170,301,794,175,339,667,164
73132,24969,12003,12966,4101,6598,1304,3988,7302,1676
73134,3542,1648,1894,354,1034,260,443,890,561
73135,15534,7512,8022,2757,4162,593,2899,4372,751
73139,16140,7942,8198,2215,4462,1265,2182,4219,1797
73141,2755,1380,1375,477,668,235,388,761,226
73142,8115,3815,4300,1054,2374,387,1234,2476,590
73145,3066,1686,1380,892,784,10,704,659,17
73149,5380,2705,2675,884,1507,314,919,1346,410
73150,4608,2382,2226,702,1299,381,630,1203,393
73151,925,466,459,166,261,39,126,276,57
73159,28014,13490,14524,4433,7075,1982,4053,7525,2946
73160,40548,19728,20820,7045,10778,1905,6974,11334,2512
73162,25703,12195,13508,4068,6615,1512,3799,7492,2217
73165,4912,2543,2369,777,1327,439,699,1345,325
73169,1642,793,849,237,430,126,245,464,140
73170,22043,10734,11309,3609,6021,1104,3635,6410,1264
73173,479,263,216,113,118,32,41,129,46
73179,3197,2378,819,301,2008,69,156,570,93
73401,33240,16013,17227,5253,7905,2855,4902,8148,4177
73425,127,66,61,18,30,18,20,27,14
73430,1175,579,596,140,243,196,144,268,184
73432,878,433,445,120,234,79,141,215,89
73433,2676,1341,1335,398,624,319,388,616,331
73434,347,165,182,71,74,20,48,97,37
73435,226,112,114,37,46,29,32,48,34
73437,105,57,48,5,40,12,16,20,12
73438,3518,1691,1827,522,858,311,521,835,471
73439,6101,3020,3081,808,1355,857,708,1463,910
73440,355,169,186,43,85,41,42,98,46
73441,304,151,153,41,57,53,37,65,51
73442,622,346,276,112,165,69,81,138,57
73443,3286,1574,1712,516,833,225,539,902,271
73444,148,84,64,31,41,12,27,20,17
73446,6728,3298,3430,1103,1573,622,996,1505,929
73447,1179,598,581,206,284,108,177,298,106
73448,5170,2496,2674,825,1196,475,802,1255,617
73449,2305,1141,1164,261,581,299,265,579,320
73450,1105,555,550,172,261,122,154,302,94
73453,629,299,330,85,163,51,97,169,64
73455,657,308,349,99,148,61,111,163,75
73456,2107,980,1127,293,467,220,329,519,279
73458,922,425,497,112,202,111,153,242,102
73459,1281,672,609,227,343,102,184,310,115
73460,4579,2224,2355,798,1009,417,746,1050,559
73461,722,368,354,110,181,77,105,168,81
73463,3282,1596,1686,531,742,323,513,769,404
73481,904,420,484,117,205,98,157,203,124
73487,308,132,176,53,54,25,56,76,44
73488,43,21,22,8,7,6,6,12,4
73491,1108,522,586,183,273,66,182,291,113
73501,22201,12064,10137,3677,6987,1400,3224,5164,1749
73503,12033,8590,3443,4547,4038,5,1744,1684,15
73505,46396,22246,24150,8084,11459,2703,8408,12004,3738
73507,18299,8707,9592,3200,4433,1074,3155,4762,1675
73520,193,93,100,24,50,19,30,58,12
73521,23076,11262,11814,4269,5629,1364,4123,5571,2120
73526,2277,1124,1153,378,570,176,365,563,225
73527,4188,2065,2123,792,1010,263,757,1051,315
73528,562,281,281,87,148,46,85,143,53
73529,4720,2357,2363,722,1142,493,664,1107,592
73530,574,294,280,90,126,78,76,112,92
73531,426,235,191,75,104,56,45,100,46
73532,619,308,311,99,154,55,87,157,67
73533,27287,13063,14224,4038,6255,2770,3935,6615,3674
73537,742,360,382,126,151,83,122,146,114
73538,3589,1816,1773,587,945,284,456,1002,315
73539,182,107,75,43,49,15,24,32,19
73540,414,218,196,61,113,44,60,88,48
73541,2553,1184,1369,391,604,189,455,675,239
73542,5466,2705,2761,922,1283,500,723,1199,839
73543,1443,717,726,269,328,120,232,385,109
73544,270,120,150,45,60,15,49,70,31
73546,1331,621,710,184,274,163,220,294,196
73547,2211,1524,687,246,1093,185,167,315,205
73548,628,334,294,76,135,123,69,124,101
73549,383,217,166,73,103,41,42,107,17
73550,2833,1350,1483,433,631,286,445,612,426
73551,63,40,23,14,24,2,9,14,0
73552,1276,693,583,344,236,113,228,225,130
73553,78,38,40,14,20,4,11,21,8
73554,3537,1638,1899,473,767,398,531,731,637
73555,343,198,145,109,69,20,52,72,21
73556,320,170,150,60,92,18,48,76,26
73557,433,186,247,51,99,36,81,118,48
73559,536,284,252,88,123,73,74,115,63
73560,940,446,494,175,209,62,189,232,73
73561,22,8,14,2,6,0,8,6,0
73562,868,461,407,157,231,73,119,222,66
73564,591,295,296,65,182,48,50,148,98
73565,1117,512,605,159,213,140,152,270,183
73566,1746,847,899,306,378,163,246,411,242
73567,838,396,442,150,177,69,127,225,90
73568,1362,657,705,202,288,167,170,306,229
73569,535,252,283,78,99,75,77,115,91
73570,1281,623,658,222,258,143,209,243,206
73571,94,50,44,0,20,30,0,4,40
73572,3877,1906,1971,628,938,340,587,875,509
73573,2727,1418,1309,375,793,250,330,621,358
73601,9977,4921,5056,1792,2214,915,1409,2402,1245
73620,991,529,462,165,291,73,153,228,81
73622,302,156,146,48,70,38,28,69,49
73624,1852,882,970,349,437,96,371,482,117
73625,578,280,298,75,153,52,99,142,57
73626,989,490,499,149,247,94,169,224,106
73627,543,289,254,100,143,46,87,129,38
73628,1556,794,762,235,391,168,173,345,244
73632,3568,1673,1895,525,795,353,472,839,584
73638,115,53,62,21,25,7,29,27,6
73639,679,303,376,52,139,112,100,173,103
73641,801,397,404,109,165,123,124,164,116
73642,187,97,90,16,44,37,26,35,29
73644,12375,5987,6388,2035,3003,949,1928,3117,1343
73645,1487,715,772,212,331,172,235,318,219
73646,402,214,188,73,104,37,53,94,41
73647,627,321,306,101,135,85,59,162,85
73650,944,469,475,169,232,68,167,222,86
73651,4447,2230,2217,755,1074,401,534,1000,683
73654,921,412,509,120,188,104,134,203,172
73655,1054,553,501,162,256,135,132,245,124
73658,240,121,119,21,65,35,27,51,41
73659,185,89,96,10,58,21,18,64,14
73660,457,216,241,51,113,52,52,100,89
73661,503,271,232,112,123,36,60,119,53
73662,5578,3417,2161,616,2331,470,551,988,622
73663,1333,653,680,221,296,136,199,293,188
73664,1067,518,549,162,239,117,147,242,160
73666,94,41,53,10,19,12,7,21,25
73667,618,330,288,108,165,57,93,126,69
73668,40,21,19,5,15,1,2,16,1
73669,1622,782,840,269,331,182,232,366,242
73673,315,153,162,28,73,52,34,73,55
73701,23746,11471,12275,3877,5904,1690,3970,5673,2632
73703,26551,12685,13866,3729,6558,2398,3613,6709,3544
73716,551,273,278,83,119,71,64,135,79
73717,6929,3621,3308,1070,1886,665,941,1408,959
73718,494,253,241,71,115,67,61,117,63
73719,139,62,77,25,24,13,27,28,22
73720,236,119,117,16,74,29,18,47,52
73722,464,217,247,45,100,72,61,108,78
73724,1123,522,601,161,261,100,175,258,168
73726,608,307,301,89,124,94,76,116,109
73727,224,124,100,38,59,27,36,42,22
73728,2014,966,1048,297,441,228,271,447,330
73729,607,301,306,99,141,61,75,160,71
73730,741,368,373,129,154,85,113,167,93
73731,136,75,61,24,36,15,9,29,23
73733,221,99,122,30,49,20,45,55,22
73734,964,476,488,161,214,101,152,229,107
73735,727,352,375,110,182,60,132,172,71
73736,362,177,185,37,94,46,36,97,52
73737,3607,1716,1891,549,793,374,459,890,542
73738,1153,572,581,184,251,137,160,245,176
73739,436,198,238,59,93,46,74,101,63
73741,1635,1286,349,108,1022,156,94,136,119
73742,3604,1739,1865,602,869,268,610,839,416
73743,168,84,84,33,42,9,34,39,11
73744,394,191,203,76,78,37,71,95,37
73746,88,38,50,8,24,6,16,27,7
73747,419,219,200,71,86,62,63,80,57
73749,469,236,233,40,102,94,46,94,93
73750,6539,3142,3397,1010,1517,615,1009,1567,821
73753,438,227,211,74,106,47,53,107,51
73754,1122,523,599,180,271,72,179,334,86
73755,950,496,454,168,193,135,138,225,91
73756,336,177,159,66,88,23,54,88,17
73757,184,81,103,17,50,14,44,41,18
73758,265,138,127,28,70,40,28,50,49
73759,1771,900,871,267,390,243,261,345,265
73760,376,176,200,42,82,52,61,81,58
73761,446,215,231,67,109,39,72,100,59
73762,2013,1027,986,377,507,143,269,510,207
73763,1605,801,804,249,366,186,230,323,251
73764,175,101,74,42,43,16,19,40,15
73766,1061,500,561,151,236,113,170,268,123
73768,1285,645,640,204,318,123,192,317,131
73771,627,291,336,80,126,85,68,126,142
73772,6037,3633,2404,916,2316,401,751,1064,589
73773,1675,806,869,279,418,109,291,432,146
73801,14343,7054,7289,2397,3549,1108,2241,3560,1488
73802,17,4,13,0,2,2,1,7,5
73832,969,494,475,129,226,139,122,206,147
73834,1658,807,851,211,410,186,240,363,248
73835,184,90,94,19,52,19,16,44,34
73838,450,206,244,50,111,45,74,109,61
73840,709,341,368,108,163,70,115,178,75
73841,965,725,240,220,445,60,68,108,64
73842,534,260,274,90,120,50,85,126,63
73843,940,496,444,122,228,146,108,202,134
73844,241,110,131,19,59,32,28,61,42
73847,107,55,52,22,21,12,14,26,12
73848,1641,798,843,228,377,193,235,350,258
73851,77,38,39,1,23,14,10,23,6
73852,1995,948,1047,308,452,188,320,462,265
73853,327,150,177,31,78,41,33,100,44
73855,199,108,91,35,46,27,37,35,19
73857,546,285,261,102,142,41,75,139,47
73858,1590,757,833,210,346,201,154,365,314
73859,1312,615,697,177,303,135,195,279,223
73860,1364,637,727,186,288,163,193,274,260
73901,207,112,95,48,54,10,38,42,15
73931,506,255,251,61,127,67,56,121,74
73932,2316,1144,1172,347,531,266,330,512,330
73933,1954,972,982,303,438,231,271,445,266
73937,255,124,131,42,53,29,48,57,26
73938,783,398,385,143,201,54,127,183,75
73939,1695,901,794,381,466,54,406,320,68
73942,12160,6167,5993,2175,3286,706,2209,2911,873
73944,568,260,308,89,117,54,124,133,51
73945,2663,1341,1322,463,668,210,446,624,252
73946,67,32,35,8,10,14,7,12,16
73947,694,343,351,116,160,67,111,163,77
73949,1866,977,889,387,448,142,290,424,175
73950,1787,946,841,349,481,116,307,415,119
73951,1330,675,655,245,337,93,236,321,98
74001,484,247,237,98,117,32,84,99,54
74002,2316,1111,1205,353,546,212,343,552,310
74003,14839,7176,7663,2486,3603,1087,2360,3824,1479
74006,24077,11447,12630,3417,5271,2759,3282,5846,3502
74008,15407,7730,7677,2663,4128,939,2344,4143,1190
74010,10115,5002,5113,1701,2422,879,1406,2491,1216
74011,23072,11366,11706,4202,5911,1253,3815,6444,1447
74012,47236,22905,24331,8505,12467,1933,8308,13191,2832
74014,23395,11773,11622,4047,6393,1333,3706,6583,1333
74015,7918,3759,4159,1289,2008,462,1337,2224,598
74016,5601,2604,2997,923,1316,365,1066,1436,495
74017,38750,19207,19543,6645,9592,2970,6125,9891,3527
74020,7598,3750,3848,1188,1888,674,1060,1911,877
74021,12360,6047,6313,2059,3118,870,1993,3179,1141
74022,1664,846,818,266,402,178,221,407,190
74023,11954,6097,5857,1743,3354,1000,1792,2703,1362
74026,1041,490,551,179,225,86,194,253,104
74027,1024,529,495,151,246,132,146,231,118
74028,1738,870,868,304,428,138,302,423,143
74029,4966,2401,2565,771,1107,523,649,1252,664
74030,3829,1829,2000,626,816,387,586,869,545
74032,1870,937,933,332,456,149,295,462,176
74033,9073,4315,4758,1703,2358,254,1771,2525,462
74034,236,99,137,25,57,17,61,56,20
74035,4883,2992,1891,671,1951,370,597,893,401
74036,6234,3099,3135,1130,1593,376,1053,1651,431
74037,9336,4540,4796,1618,2318,604,1506,2583,707
74038,2021,976,1045,276,511,189,339,505,201
74039,2967,1520,1447,555,774,191,477,749,221
74041,567,278,289,109,151,18,90,152,47
74042,485,249,236,114,108,27,67,114,55
74044,7045,3557,3488,1202,1820,535,1120,1753,615
74045,307,154,153,49,74,31,38,88,27
74047,6632,3334,3298,1176,1784,374,1113,1808,377
74048,6179,3001,3178,922,1409,670,883,1390,905
74050,559,278,281,126,111,41,107,89,85
74051,1673,867,806,347,385,135,270,413,123
74052,1386,646,740,228,290,128,258,333,149
74053,2682,1300,1382,477,678,145,440,720,222
74054,771,409,362,139,214,56,101,204,57
74055,26161,12893,13268,4780,6646,1467,4451,7003,1814
74056,5816,2759,3057,909,1270,580,902,1365,790
74058,4198,2064,2134,728,942,394,621,1015,498
74059,4589,2322,2267,824,1143,355,597,1256,414
74060,507,258,249,83,122,53,72,127,50
74061,1893,901,992,285,419,197,255,517,220
74062,1005,513,492,197,248,68,176,227,89
74063,28399,14001,14398,4855,7270,1876,4379,7576,2443
74066,29887,14593,15294,4968,7464,2161,4453,7705,3136
74068,180,91,89,44,32,15,32,44,13
74070,10952,5449,5503,2070,2647,732,1764,2851,888
74071,166,85,81,32,49,4,22,49,10
74072,1799,878,921,278,438,162,283,465,173
74073,4867,2425,2442,859,1211,355,800,1236,406
74074,26060,13422,12638,5359,6853,1210,4885,5923,1830
74075,21314,10695,10619,3465,6287,943,3974,5367,1278
74079,4980,2483,2497,885,1121,477,706,1181,610
74080,2493,1298,1195,519,588,191,425,573,197
74081,1779,915,864,307,459,149,278,474,112
74083,1087,548,539,194,254,100,158,251,130
74084,683,346,337,96,165,85,92,168,77
74085,2533,1243,1290,386,623,234,374,642,274
74103,2175,1773,402,172,1534,67,27,375,0
74104,14105,6990,7115,2263,4150,577,2347,3698,1070
74105,28407,13605,14802,3582,7771,2252,3558,7756,3488
74106,18169,8074,10095,3410,3406,1258,3467,4438,2190
74107,20340,9547,10793,3210,4937,1400,3545,5336,1912
74108,7662,3621,4041,1300,1899,422,1357,2100,584
74110,15293,7453,7840,2933,3798,722,2912,3743,1185
74112,21205,10191,11014,2805,5826,1560,2646,5650,2718
74114,16882,7804,9078,2063,4267,1474,2042,4828,2208
74115,23626,11306,12320,4146,5604,1556,4083,6203,2034
74116,3585,1717,1868,620,887,210,720,893,255
74117,198,124,74,73,45,6,17,49,8
74119,3771,1950,1821,294,1360,296,191,1130,500
74120,5518,2935,2583,772,1912,251,701,1563,319
74126,12131,5534,6597,2568,2344,622,2559,3158,880
74127,17997,8785,9212,2968,4564,1253,2703,4701,1808
74128,12359,5991,6368,1808,3097,1086,1730,3120,1518
74129,18542,8778,9764,2775,4712,1291,2949,4714,2101
74130,2675,1420,1255,520,661,239,375,695,185
74131,2399,1260,1139,442,630,188,332,667,140
74132,7453,3686,3767,1314,1970,402,1287,2025,455
74133,37933,18677,19256,6147,10502,2028,5626,10813,2817
74134,13119,6648,6471,2238,4012,398,2218,3849,404
74135,21170,9816,11354,2318,5155,2343,2501,5241,3612
74136,32754,15827,16927,5094,8801,1932,5047,8989,2891
74137,22888,10871,12017,3594,5820,1457,3751,6432,1834
74145,18193,8612,9581,2117,4824,1671,2285,4681,2615
74146,14182,7312,6870,2694,4038,580,2266,3709,895
74301,11543,5876,5667,1614,3211,1051,1474,2750,1443
74330,2776,1407,1369,456,698,253,437,672,260
74331,6291,3146,3145,779,1468,899,709,1549,887
74332,1804,897,907,251,478,168,255,453,199
74333,1212,599,613,202,313,84,199,311,103
74335,125,62,63,16,34,12,17,32,14
74337,4578,2229,2349,711,1116,402,745,1150,454
74338,4694,2261,2433,771,1152,338,765,1200,468
74339,2776,1359,1417,524,621,214,431,638,348
74340,984,481,503,65,231,185,61,270,172
74342,1759,889,870,322,414,153,302,404,164
74343,2891,1439,1452,428,676,335,376,717,359
74344,11952,5714,6238,1431,2514,1769,1369,2732,2137
74346,7569,3778,3791,1295,1855,628,1160,1942,689
74347,3579,1796,1783,755,815,226,689,844,250
74349,593,275,318,87,123,65,80,156,82
74350,793,351,442,87,181,83,131,194,117
74352,6553,3362,3191,1138,1621,603,905,1600,686
74354,17828,8520,9308,2969,3832,1719,2695,4091,2522
74358,275,125,150,57,53,15,72,63,15
74360,1921,987,934,342,475,170,299,413,222
74361,14626,7118,7508,2485,3411,1222,2259,3542,1707
74363,2820,1454,1366,537,711,206,377,738,251
74364,1588,788,800,291,407,90,359,353,88
74365,4979,2525,2454,905,1194,426,808,1165,481
74366,1682,836,846,280,383,173,231,417,198
74367,524,265,259,78,115,72,82,125,52
74368,178,85,93,31,41,13,35,43,15
74369,1781,848,933,256,397,195,270,424,239
74370,3278,1618,1660,499,809,310,534,795,331
74401,17822,8569,9253,2958,3997,1614,2986,4108,2159
74403,30043,14214,15829,4534,7205,2475,4375,7595,3859
74421,4154,1988,2166,689,984,315,717,1007,442
74422,799,387,412,140,163,84,134,173,105
74423,1070,550,520,173,302,75,123,297,100
74425,848,394,454,76,173,145,98,192,164
74426,9429,4495,4934,1409,1987,1099,1409,2258,1267
74427,1255,640,615,111,303,226,96,315,204
74428,914,457,457,145,199,113,125,207,125
74429,10347,5062,5285,1898,2579,585,1750,2798,737
74430,540,258,282,101,111,46,91,144,47
74431,1046,514,532,196,258,60,178,256,98
74432,8803,4315,4488,1026,1883,1406,859,2135,1494
74434,8328,4125,4203,1474,2081,570,1344,2192,667
74435,3226,1599,1627,522,710,367,467,786,374
74436,4454,2194,2260,750,1090,354,731,1089,440
74437,10425,5026,5399,1713,2312,1001,1498,2491,1410
74438,237,113,124,34,45,34,30,54,40
74440,96,39,57,15,18,6,21,25,11
74441,4657,2368,2289,830,1120,418,727,1163,399
74442,1163,555,608,180,279,96,188,294,126
74444,71,38,33,9,23,6,14,13,6
74445,2668,1282,1386,473,580,229,436,673,277
74446,731,368,363,160,172,36,116,172,75
74447,17900,8782,9118,3264,3962,1556,2692,4168,2258
74450,1816,936,880,338,471,127,283,448,149
74451,3530,1836,1694,573,840,423,458,885,351
74452,502,243,259,91,122,30,77,143,39
74454,2961,1428,1533,491,721,216,492,749,292
74455,2867,1418,1449,426,671,321,397,711,341
74456,185,91,94,37,42,12,39,53,2
74457,309,164,145,61,84,19,61,62,22
74459,57,29,28,13,9,7,7,10,11
74460,484,228,256,87,108,33,91,111,54
74461,351,173,178,51,74,48,42,81,55
74462,7462,3650,3812,1135,1748,767,1022,1758,1032
74463,1913,1090,823,117,877,96,112,660,51
74464,27831,13386,14445,5251,6394,1741,5214,6826,2405
74467,13947,6749,7198,2143,3314,1292,2043,3518,1637
74468,249,130,119,53,55,22,30,64,25
74469,2160,1049,1111,421,435,193,429,407,275
74470,1620,796,824,252,361,183,242,392,190
74471,1493,793,700,256,409,128,216,368,116
74472,223,103,120,20,53,30,34,55,31
74501,28299,14535,13764,4108,7987,2440,3723,6518,3523
74521,290,132,158,36,59,37,53,75,30
74522,313,152,161,48,73,31,54,81,26
74523,5981,2785,3196,872,1302,611,886,1413,897
74525,9125,4672,4453,1381,2505,786,1288,2094,1071
74528,139,62,77,9,38,15,24,32,21
74530,237,128,109,49,54,25,36,49,24
74531,956,477,479,148,228,101,97,257,125
74533,700,355,345,142,145,68,92,174,79
74534,343,196,147,77,91,28,37,69,41
74535,92,51,41,22,25,4,8,23,10
74536,1652,823,829,265,361,197,236,379,214
74538,4267,2081,2186,677,945,459,618,1012,556
74540,200,95,105,32,37,26,28,48,29
74543,329,150,179,48,76,26,59,84,36
74545,272,134,138,32,79,23,18,70,50
74546,889,425,464,152,194,79,142,206,116
74547,3466,1630,1836,488,814,328,580,823,433
74549,135,57,78,17,16,24,23,31,24
74552,872,418,454,137,179,102,132,211,111
74553,1446,707,739,209,367,131,234,342,163
74554,1365,673,692,239,330,104,180,330,182
74555,1005,517,488,161,261,95,132,239,117
74556,345,181,164,59,87,35,55,76,33
74557,531,261,270,88,125,48,76,145,49
74558,463,202,261,44,106,52,94,111,56
74560,625,295,330,94,143,58,100,146,84
74561,2260,1174,1086,415,520,239,249,522,315
74562,827,365,462,106,198,61,177,213,72
74563,2041,1009,1032,329,457,223,288,504,240
74565,767,388,379,128,194,66,107,194,78
74567,265,161,104,56,60,45,25,57,22
74569,1432,1099,333,208,785,106,111,131,91
74570,1091,541,550,139,266,136,140,272,138
74571,3454,1701,1753,547,690,464,529,742,482
74572,736,338,398,117,154,67,154,162,82
74574,862,437,425,147,199,91,115,206,104
74576,221,98,123,26,49,23,30,60,33
74577,325,152,173,34,85,33,57,72,44
74578,6725,3237,3488,1254,1418,565,1243,1536,709
74601,20398,9752,10646,3279,4951,1522,3448,4926,2272
74604,13345,6498,6847,2058,3015,1425,1744,3250,1853
74630,782,408,374,130,202,76,105,189,80
74631,8391,4013,4378,1357,1834,822,1354,1915,1109
74632,617,297,320,86,150,61,100,145,75
74633,400,183,217,33,100,50,65,87,65
74636,310,159,151,61,61,37,37,68,46
74637,2003,949,1054,350,390,209,289,464,301
74640,398,184,214,58,97,29,70,98,46
74641,534,243,291,64,125,54,87,134,70
74643,613,277,336,96,128,53,116,134,86
74644,693,349,344,142,161,46,127,155,62
74646,247,119,128,24,58,37,33,55,40
74647,3722,1856,1866,632,883,341,504,882,480
74650,730,348,382,97,165,86,104,165,113
74651,666,315,351,107,161,47,142,150,59
74652,1093,549,544,166,267,116,145,249,150
74653,3943,1964,1979,770,887,307,723,859,397
74701,19471,9419,10052,3263,4592,1564,3348,4635,2069
74720,714,357,357,152,161,44,132,180,45
74721,111,52,59,11,34,7,7,42,10
74722,392,202,190,103,78,21,68,102,20
74723,1468,727,741,211,357,159,221,335,185
74724,322,162,160,66,83,13,53,79,28
74726,1963,954,1009,321,461,172,292,461,256
74727,2053,997,1056,364,430,203,314,472,270
74728,11809,5696,6113,2052,2699,945,1849,2963,1301
74729,2456,1208,1248,398,585,225,367,587,294
74730,3251,1609,1642,516,793,300,478,802,362
74731,1387,666,721,166,333,167,233,385,103
74733,2634,1248,1386,407,637,204,371,692,323
74734,1161,588,573,180,285,123,170,289,114
74735,1796,907,889,277,442,188,234,427,228
74736,731,368,363,114,189,65,109,181,73
74737,112,59,53,13,33,13,11,38,4
74738,647,349,298,145,145,59,93,147,58
74740,2582,1255,1327,415,611,229,389,669,269
74741,1046,526,520,153,259,114,141,249,130
74743,8540,3957,4583,1362,1829,766,1207,2221,1155
74745,9846,4616,5230,1636,2193,787,1724,2423,1083
74747,147,69,78,17,37,15,22,37,19
74748,555,291,264,83,146,62,72,128,64
74750,700,334,366,118,184,32,129,198,39
74753,66,17,49,0,7,10,7,6,36
74754,411,210,201,49,85,76,48,80,73
74755,92,44,48,17,19,8,6,27,15
74756,736,370,366,107,203,60,111,187,68
74759,1290,612,678,179,303,130,210,296,172
74760,310,167,143,65,58,44,35,74,34
74761,250,116,134,35,47,34,43,62,29
74764,3518,1661,1857,486,898,277,585,905,367
74766,1742,842,900,287,424,131,316,437,147
74801,22114,10666,11448,3799,5209,1658,3450,5637,2361
74804,17846,8847,8999,3564,3812,1471,2768,4256,1975
74820,28524,13712,14812,4883,6576,2253,4507,7025,3280
74824,1055,556,499,209,253,94,169,242,88
74825,2288,1143,1145,389,551,203,345,531,269
74826,1165,583,582,165,305,113,154,301,127
74827,445,235,210,66,127,42,57,103,50
74829,1561,1098,463,159,827,112,158,209,96
74830,205,90,115,26,46,18,38,61,16
74831,874,437,437,118,216,103,110,209,118
74832,1008,503,505,182,238,83,157,270,78
74833,724,370,354,155,159,56,130,153,71
74834,6909,3422,3487,1144,1703,575,1058,1699,730
74836,218,103,115,21,48,34,33,43,39
74837,692,332,360,130,155,47,163,130,67
74839,888,451,437,138,208,105,123,200,114
74840,1608,804,804,298,366,140,268,391,145
74842,421,205,216,76,95,34,66,107,43
74843,280,134,146,29,83,22,52,74,20
74844,466,222,244,69,112,41,77,118,49
74845,513,258,255,78,120,60,83,112,60
74848,8226,4396,3830,1148,2511,737,1030,1670,1130
74849,3329,1649,1680,566,745,338,486,857,337
74850,336,152,184,47,71,34,62,95,27
74851,8698,3862,4836,1236,2021,605,1256,2916,664
74852,1406,731,675,209,364,158,188,350,137
74854,2050,990,1060,338,461,191,328,496,236
74855,4256,2076,2180,714,1013,349,730,1030,420
74856,753,381,372,149,173,59,114,186,72
74857,8709,4405,4304,1497,2421,487,1413,2437,454
74859,5796,2766,3030,916,1254,596,910,1325,795
74860,1466,758,708,243,347,168,202,356,150
74864,4587,2187,2400,668,1067,452,634,1148,618
74865,1638,797,841,275,367,155,263,389,189
74866,216,113,103,35,55,23,39,41,23
74867,893,441,452,116,221,104,127,217,108
74868,12140,5721,6419,1942,2635,1144,2019,2826,1574
74869,588,280,308,93,131,56,92,140,76
74871,2107,1017,1090,284,549,184,327,545,218
74872,3248,1574,1674,538,713,323,472,806,396
74873,10541,5189,5352,1822,2536,831,1703,2551,1098
74875,1118,551,567,162,267,122,169,268,130
74878,1348,707,641,246,347,114,205,302,134
74880,2263,1105,1158,367,512,226,353,513,292
74881,3604,1819,1785,606,924,289,568,930,287
74883,2574,1220,1354,354,596,270,370,616,368
74884,6115,2880,3235,963,1291,626,1037,1370,828
74901,2236,1109,1127,373,558,178,274,568,285
74902,4412,2185,2227,762,1140,283,669,1171,387
74930,1796,914,882,344,440,130,256,452,174
74931,1468,708,760,253,363,92,261,379,120
74932,1914,972,942,354,455,163,297,473,172
74935,214,105,109,28,58,19,36,44,29
74936,1311,694,617,238,339,117,188,305,124
74937,5292,2634,2658,912,1340,382,881,1244,533
74939,1402,1054,348,164,809,81,96,183,69
74940,2355,1189,1166,456,567,166,382,604,180
74941,2460,1196,1264,388,590,218,424,576,264
74942,307,164,143,57,66,41,46,64,33
74943,123,58,65,17,24,17,19,32,14
74944,1014,508,506,174,252,82,168,253,85
74945,596,318,278,119,175,24,82,166,30
74946,225,99,126,35,45,19,54,40,32
74947,141,58,83,13,31,14,36,20,27
74948,11352,5648,5704,2023,2774,851,1774,2976,954
74949,290,150,140,49,69,32,46,63,31
74951,1696,842,854,277,418,147,261,423,170
74953,10814,5281,5533,1836,2630,815,1684,2705,1144
74954,4091,2019,2072,780,956,283,702,1028,342
74955,13580,6686,6894,2388,3179,1119,2002,3327,1565
74956,1610,765,845,228,412,125,292,408,145
74957,1018,502,516,141,242,119,145,244,127
74959,7122,3421,3701,1104,1827,490,1141,1776,784
74960,12534,6104,6430,2243,3045,816,2242,2954,1234
74962,5107,2529,2578,852,1122,555,749,1221,608
74963,778,397,381,128,177,92,113,185,83
74964,2641,1330,1311,435,696,199,417,666,228
74965,4862,2421,2441,865,1186,370,825,1136,480
74966,2982,1482,1500,537,664,281,447,704,349
75001,8175,4112,4063,511,3259,342,573,3124,366
75002,37171,18614,18557,7207,10428,979,6727,10799,1031
75006,45990,23046,22944,7475,13571,2000,6886,13416,2642
75007,50357,24726,25631,8448,14871,1407,8234,15643,1754
75009,4913,2503,2410,870,1304,329,780,1237,393
75010,13141,6487,6654,2253,3978,256,2046,4076,532
75013,11584,5743,5841,2184,3316,243,2170,3383,288
75019,35805,17683,18122,6869,10112,702,6534,10753,835
75020,21730,10340,11390,3377,5034,1929,3002,5525,2863
75021,7676,3745,3931,1101,1872,772,1048,1911,972
75022,13823,6831,6992,2528,3953,350,2549,4081,362
75023,46692,22876,23816,7576,13673,1627,7003,14548,2265
75024,19844,9747,10097,3052,6373,322,2970,6770,357
75025,39639,19823,19816,7408,11693,722,7044,11944,828
75028,36393,18239,18154,7095,10483,661,6564,10835,755
75032,14256,7262,6994,2489,4032,741,2361,3862,771
75034,16049,7893,8156,2616,4681,596,2614,4855,687
75035,19023,9475,9548,3323,5904,248,3054,6179,315
75038,25191,13070,12121,3512,9176,382,3097,8630,394
75039,2837,1756,1081,140,1560,56,104,970,7
75040,55409,27535,27874,10828,14753,1954,10220,14789,2865
75041,31621,15910,15711,6089,8080,1741,5181,7945,2585
75042,38918,20130,18788,7676,10614,1840,6338,10043,2407
75043,53389,25919,27470,9359,14292,2268,8639,15484,3347
75044,36336,17645,18691,5962,10364,1319,5763,11224,1704
75048,9801,4878,4923,1795,2777,306,1748,2886,289
75050,38160,19474,18686,6687,11055,1732,6256,10132,2298
75051,31257,15165,16092,6131,7504,1530,6067,7860,2165
75052,56225,27383,28842,10416,15385,1582,10354,16620,1868
75056,28635,14179,14456,5417,8231,531,5292,8487,677
75057,12113,6366,5747,1973,3885,508,1851,3136,760
75058,2113,988,1125,405,467,116,363,486,276
75060,45221,23068,22153,8731,12285,2052,7559,11820,2774
75061,53265,27229,26036,9329,15571,2329,8843,13988,3205
75062,41631,20932,20699,6819,11933,2180,6188,11856,2655
75063,24463,12095,12368,2482,9230,383,2563,9358,447
75065,8251,4174,4077,1427,2390,357,1251,2380,446
75067,48766,24137,24629,7495,15447,1195,7496,15540,1593
75068,7776,4021,3755,1442,2274,305,1280,2153,322
75069,28189,14403,13786,5439,7641,1323,4668,7059,2059
75070,34729,17484,17245,6395,9884,1205,5991,9752,1502
75074,37589,19450,18139,6836,11136,1478,5989,10370,1780
75075,34715,17316,17399,5395,9870,2051,4880,10321,2198
75076,6941,3401,3540,980,1618,803,914,1766,860
75077,31543,15546,15997,5469,9030,1047,5440,9429,1128
75078,2944,1471,1473,554,801,116,561,779,133
75080,43244,21490,21754,6811,11509,3170,5732,11736,4286
75081,32637,16098,16539,5041,9323,1734,4723,9635,2181
75082,15432,7723,7709,2343,4780,600,2525,4588,596
75087,16792,8300,8492,2933,4284,1083,2551,4545,1396
75088,24890,12292,12598,4810,6656,826,4571,7040,987
75089,18267,9101,9166,3424,5149,528,3147,5331,688
75090,22408,10958,11450,4045,5569,1344,3932,5399,2119
75092,20337,9817,10520,2841,5321,1655,3020,5175,2325
75093,43864,21798,22066,7229,13306,1263,6700,13636,1730
75094,3254,1610,1644,573,913,124,541,959,144
75098,20775,10369,10406,3812,5760,797,3643,5722,1041
75101,484,244,240,108,104,32,94,116,30
75102,1058,549,509,193,268,88,121,236,152
75103,11342,5564,5778,1640,2601,1323,1446,2747,1585
75104,32113,15304,16809,6081,8449,774,5837,9765,1207
75105,288,138,150,30,77,31,34,92,24
75110,31200,15218,15982,5821,7268,2129,5319,7360,3303
75114,4056,2009,2047,775,1055,179,748,1089,210
75115,37755,17985,19770,6446,9431,2108,5848,11149,2773
75116,18215,8558,9657,3050,4350,1158,2930,5086,1641
75117,3120,1558,1562,471,699,388,400,737,425
75119,23698,11632,12066,4430,5675,1527,4085,5758,2223
75121,33,13,20,0,0,13,0,9,11
75124,4272,2106,2166,680,956,470,631,993,542
75125,5964,2947,3017,1081,1539,327,1114,1567,336
75126,10908,5399,5509,2033,2815,551,1788,3054,667
75127,1533,756,777,278,347,131,264,369,144
75132,169,73,96,20,39,14,30,47,19
75134,11607,5430,6177,2268,2669,493,2097,3365,715
75135,4481,2228,2253,801,1154,273,779,1174,300
75137,17779,8300,9479,2979,4411,910,2947,5275,1257
75140,6511,3286,3225,1134,1462,690,872,1449,904
75141,2852,1413,1439,470,783,160,470,779,190
75142,17648,8640,9008,3195,4431,1014,3188,4443,1377
75143,12900,6453,6447,1973,3059,1421,1623,3183,1641
75144,2989,1434,1555,519,663,252,492,683,380
75146,15430,7104,8326,2561,3859,684,2566,4566,1194
75147,19683,9593,10090,2885,4395,2313,2768,4624,2698
75148,5780,2830,2950,770,1331,729,752,1354,844
75149,54541,26305,28236,10355,13781,2169,9785,15345,3106
75150,55353,26794,28559,9602,14761,2431,8893,15719,3947
75152,3433,1727,1706,683,858,186,626,826,254
75153,466,233,233,56,131,46,65,112,56
75154,27376,13592,13784,5128,7442,1022,5181,7414,1189
75155,1998,1004,994,393,496,115,393,493,108
75158,3887,1963,1924,685,1032,246,601,1062,261
75159,14208,7684,6524,2239,4704,741,2070,3391,1063
75160,19670,9565,10105,3332,4979,1254,3097,4980,2028
75161,5450,2837,2613,954,1506,377,724,1478,411
75163,2610,1231,1379,295,584,352,368,595,416
75164,669,340,329,134,172,34,113,173,43
75165,28578,14015,14563,4890,7301,1824,4920,7235,2408
75166,498,221,277,70,130,21,103,130,44
75167,3827,1864,1963,664,981,219,633,1023,307
75169,14146,6974,7172,2164,3489,1321,2105,3462,1605
75172,3641,1929,1712,767,1021,141,636,910,166
75173,4014,2076,1938,825,1113,138,709,1070,159
75180,19446,9515,9931,4112,4736,667,3758,5219,954
75181,16326,7810,8516,3142,4347,321,3249,4786,481
75182,2700,1376,1324,478,695,203,417,704,203
75189,10028,5025,5003,1786,2719,520,1778,2633,592
75201,3324,1680,1644,247,1323,110,244,1282,118
75202,1423,903,520,74,741,88,65,435,20
75203,19746,10796,8950,4404,5540,852,3503,4185,1262
75204,20718,11508,9210,2712,8226,570,2390,6119,701
75205,24156,11432,12724,3980,6094,1358,4310,6615,1799
75206,39693,21936,17757,4456,16265,1215,3876,12123,1758
75207,8121,6059,2062,829,5179,51,189,1873,0
75208,35800,18941,16859,7223,10314,1404,6250,8592,2017
75209,14697,7207,7490,1639,4622,946,1707,4200,1583
75210,9369,4261,5108,1733,1988,540,1933,2379,796
75211,68730,35050,33680,15115,17647,2288,14244,15937,3499
75212,22239,10852,11387,5086,4816,950,4926,4964,1497
75214,35533,17655,17878,4462,11140,2053,3984,10215,3679
75215,18643,8640,10003,3245,4212,1183,3153,4846,2004
75216,49440,23350,26090,8912,10786,3652,8699,11940,5451
75217,72437,36060,36377,15469,17980,2611,14967,17437,3973
75218,21682,10312,11370,2529,6057,1726,2329,6237,2804
75219,22682,13223,9459,2752,9565,906,2547,5970,942
75220,50597,27986,22611,10583,16166,1237,8861,11921,1829
75223,15813,8034,7779,3224,4255,555,3175,3834,770
75224,32553,15881,16672,7055,7622,1204,6507,8169,1996
75225,20157,9241,10916,2985,4532,1724,2928,5149,2839
75226,2693,1685,1008,308,1331,46,240,723,45
75227,49019,23705,25314,9968,12020,1717,9645,12887,2782
75228,65884,31588,34296,11581,16297,3710,11341,17163,5792
75229,30994,15584,15410,4738,8355,2491,4411,7612,3387
75230,27641,12983,14658,2936,7588,2459,2957,7754,3947
75231,52363,27570,24793,9126,17343,1101,8524,14507,1762
75232,28773,13225,15548,4992,6627,1606,5036,8365,2147
75233,13760,6887,6873,2775,3499,613,2650,3271,952
75234,29676,14909,14767,4982,7721,2206,4323,7457,2987
75235,17438,9762,7676,3203,5971,588,2879,3918,879
75236,10113,4736,5377,2011,2395,330,1764,3076,537
75237,12697,5563,7134,2625,2825,113,2601,4319,214
75238,31366,15065,16301,4983,8087,1995,4753,8757,2791
75240,49931,26114,23817,7248,17046,1820,6742,14665,2410
75241,23815,10695,13120,4321,4577,1797,4225,6298,2597
75243,59610,29072,30538,8615,18273,2184,8408,19037,3093
75244,17206,8633,8573,2410,5123,1100,2243,4777,1553
75246,4686,2671,2015,742,1526,403,560,983,472
75247,250,230,20,9,218,3,0,2,18
75248,33211,16217,16994,3759,9651,2807,3673,10338,2983
75249,9161,4289,4872,1818,2308,163,1843,2707,322
75251,1373,745,628,55,652,38,53,545,30
75252,22557,11218,11339,2530,7845,843,2433,7970,936
75253,15796,8005,7791,3142,4251,612,2956,4112,723
75270,0,0,0,0,0,0,0,0,0
75287,44816,22189,22627,4613,16707,869,5017,16613,997
75401,17691,8698,8993,3238,4359,1101,3037,4248,1708
75402,14171,6881,7290,1975,3550,1356,1996,3635,1659
75407,9690,4833,4857,1675,2616,542,1594,2610,653
75409,4703,2411,2292,814,1321,276,746,1267,279
75410,3818,1884,1934,600,853,431,544,985,405
75411,1078,567,511,158,282,127,171,219,121
75412,925,479,446,126,251,102,112,231,103
75413,412,190,222,75,91,24,73,117,32
75414,3069,1492,1577,510,745,237,527,778,272
75415,255,135,120,50,57,28,24,65,31
75416,3129,1584,1545,560,820,204,431,840,274
75417,2762,1349,1413,416,634,299,363,655,395
75418,13701,8034,5667,1876,4860,1298,1583,2524,1560
75420,1083,569,514,191,289,89,116,278,120
75421,1182,609,573,182,330,97,182,295,96
75422,2736,1375,1361,416,700,259,399,701,261
75423,2388,1188,1200,420,598,170,398,598,204
75424,2890,1408,1482,482,756,170,481,774,227
75426,6241,2844,3397,857,1378,609,1000,1491,906
75428,9353,4733,4620,1670,2500,563,1709,2234,677
75431,1856,949,907,342,451,156,308,450,149
75432,3550,1749,1801,691,764,294,534,859,408
75433,2433,1234,1199,393,603,238,317,620,262
75434,51,24,27,5,0,19,7,0,20
75435,1270,604,666,131,271,202,127,286,253
75436,1791,857,934,279,406,172,272,454,208
75437,1004,499,505,170,260,69,163,254,88
75438,937,474,463,177,224,73,124,243,96
75439,874,409,465,134,208,67,150,212,103
75440,4792,2438,2354,750,1175,513,595,1184,575
75441,48,21,27,0,5,16,0,4,23
75442,7375,3656,3719,1319,1847,490,1150,1956,613
75444,145,72,73,9,51,12,14,38,21
75446,2818,1335,1483,425,621,289,376,668,439
75447,1005,529,476,156,264,109,145,235,96
75448,692,329,363,54,178,97,67,174,122
75449,1196,575,621,180,288,107,166,296,159
75450,415,205,210,58,90,57,51,108,51
75451,1388,720,668,223,355,142,253,310,105
75452,3914,1883,2031,703,878,302,672,949,410
75453,3070,1545,1525,475,732,338,424,749,352
75454,2364,1228,1136,457,629,142,365,617,154
75455,24674,12228,12446,4654,5954,1620,4243,5846,2357
75457,5848,2796,3052,920,1368,508,879,1428,745
75459,3675,1751,1924,613,923,215,657,966,301
75460,23827,10991,12836,3788,5253,1950,3613,5929,3294
75462,10211,4893,5318,1661,2373,859,1713,2666,939
75468,694,321,373,90,176,55,118,195,60
75469,367,176,191,47,85,44,44,88,59
75470,426,207,219,70,93,44,73,99,47
75471,1109,544,565,171,285,88,200,264,101
75472,2591,1296,1295,423,576,297,352,615,328
75473,3936,1958,1978,633,1027,298,565,1067,346
75474,13353,6719,6634,2169,3468,1082,2008,3415,1211
75475,162,74,88,29,30,15,14,48,26
75476,1095,585,510,170,286,129,127,253,130
75477,925,411,514,159,178,74,186,198,130
75478,825,409,416,122,178,109,149,168,99
75479,1721,856,865,285,398,173,224,421,220
75480,1365,683,682,148,296,239,141,304,237
75481,262,125,137,13,70,42,45,59,33
75482,22824,10936,11888,3632,5511,1793,3463,5793,2632
75485,41,17,24,0,9,8,4,14,6
75486,1771,897,874,261,435,201,258,493,123
75487,1625,802,823,292,364,146,257,382,184
75488,986,508,478,137,249,122,126,254,98
75489,1094,532,562,193,283,56,198,284,80
75490,1551,727,824,245,373,109,292,395,137
75491,4091,1976,2115,631,967,378,608,1034,473
75492,583,275,308,66,136,73,103,136,69
75493,536,264,272,111,126,27,106,131,35
75494,10320,5322,4998,1573,2680,1069,1254,2214,1530
75495,5478,2761,2717,1013,1335,413,799,1422,496
75496,2816,1334,1482,460,633,241,406,718,358
75497,2076,1031,1045,245,547,239,266,519,260
75501,36262,18395,17867,5754,10150,2491,5715,8796,3356
75503,21271,9761,11510,3125,4910,1726,3127,5598,2785
75550,904,435,469,115,200,120,135,185,149
75551,11277,5301,5976,1671,2615,1015,1667,2826,1483
75554,1820,916,904,282,461,173,226,430,248
75555,1449,727,722,246,314,167,188,357,177
75556,766,372,394,113,204,55,111,210,73
75558,1350,667,683,188,328,151,206,320,157
75559,5980,2834,3146,879,1356,599,860,1434,852
75560,995,490,505,158,263,69,128,251,126
75561,5162,2433,2729,804,1200,429,819,1361,549
75562,111,35,76,4,21,10,11,20,45
75563,4463,2276,2187,696,1061,519,491,992,704
75564,112,46,66,15,23,8,29,17,20
75565,539,237,302,100,104,33,112,144,46
75566,905,421,484,116,196,109,140,235,109
75567,3903,1987,1916,693,999,295,583,939,394
75568,2799,1330,1469,383,533,414,386,591,492
75569,2439,1221,1218,436,661,124,387,638,193
75570,11829,6962,4867,1713,4448,801,1355,2466,1046
75571,2855,1321,1534,441,671,209,454,706,374
75572,3511,1646,1865,562,794,290,581,901,383
75573,333,157,176,59,81,17,55,82,39
75574,1854,958,896,335,464,159,251,464,181
75601,13821,6942,6879,2229,3482,1231,1648,3282,1949
75602,21533,10292,11241,4380,4693,1219,4070,5434,1737
75603,5326,2559,2767,666,1356,537,704,1398,665
75604,27276,13461,13815,5001,6912,1548,4586,7143,2086
75605,24648,11750,12898,3510,6088,2152,3414,6434,3050
75630,2538,1283,1255,349,571,363,233,590,432
75631,2599,1304,1295,402,685,217,398,653,244
75633,13712,6538,7174,2242,3100,1196,2010,3307,1857
75636,153,74,79,14,36,24,15,41,23
75638,6165,3069,3096,1028,1358,683,848,1411,837
75639,3286,1585,1701,548,816,221,570,825,306
75640,3881,1908,1973,621,926,361,574,1057,342
75641,210,107,103,52,44,11,37,48,18
75643,1572,779,793,232,326,221,182,363,248
75644,19650,9624,10026,3284,4627,1713,2906,4866,2254
75647,11950,5835,6115,2061,2905,869,1856,3045,1214
75650,8067,3957,4110,1419,2126,412,1511,2111,488
75651,2001,953,1048,327,499,127,344,502,202
75652,14147,7628,6519,1924,4635,1069,1970,3149,1400
75654,11617,5554,6063,1914,2633,1007,1744,2790,1529
75656,4658,2234,2424,778,992,464,678,1133,613
75657,8637,4121,4516,1254,1880,987,1227,2113,1176
75661,2515,1218,1297,354,616,248,292,665,340
75662,22207,10845,11362,3691,5493,1661,3537,5436,2389
75667,1074,532,542,158,218,156,150,224,168
75668,2067,1008,1059,300,482,226,298,493,268
75669,751,329,422,97,153,79,170,187,65
75670,17620,8222,9398,3139,3980,1103,3482,4043,1873
75672,17071,8330,8741,2723,4071,1536,2524,4183,2034
75680,74,31,43,8,16,7,17,14,12
75681,2454,1193,1261,400,528,265,357,578,326
75683,4045,2050,1995,738,970,342,563,1047,385
75684,6713,3512,3201,977,1963,572,952,1484,765
75686,11241,5408,5833,1762,2526,1120,1797,2708,1328
75691,3566,1798,1768,645,873,280,570,885,313
75692,4958,2411,2547,796,1187,428,795,1297,455
75693,5825,2800,3025,1044,1395,361,1035,1530,460
75701,30936,13840,17096,4477,6630,2733,4985,7365,4746
75702,26407,12745,13662,5428,6049,1268,5274,6408,1980
75703,30420,14515,15905,4688,7570,2257,4407,8391,3107
75704,6953,3393,3560,1028,1801,564,1008,1769,783
75705,1818,884,934,364,405,115,287,460,187
75706,6708,3356,3352,1243,1641,472,1112,1703,537
75707,10990,5398,5592,1832,2729,837,1556,3004,1032
75708,5995,3017,2978,1191,1427,399,982,1494,502
75709,3615,1790,1825,594,923,273,493,986,346
75750,3214,1511,1703,459,801,251,525,872,306
75751,21934,10658,11276,3648,5067,1943,3265,5266,2745
75754,5334,2691,2643,789,1309,593,794,1301,548
75755,6279,3056,3223,875,1339,842,843,1377,1003
75756,3582,1739,1843,601,834,304,632,871,340
75757,7264,3520,3744,1072,1594,854,1031,1925,788
75758,7927,3879,4048,1173,1810,896,989,1917,1142
75759,149,63,86,18,29,16,35,35,16
75760,2691,1351,1340,444,660,247,362,617,361
75762,7969,4032,3937,1296,2003,733,1044,2092,801
75763,5557,2697,2860,880,1218,599,686,1447,727
75764,238,112,126,55,44,13,41,63,22
75765,4503,2082,2421,640,1014,428,766,1148,507
75766,25331,12271,13060,4504,5802,1965,4293,5903,2864
75770,2382,1236,1146,328,629,279,340,559,247
75771,13969,6667,7302,2068,3128,1471,2134,3388,1780
75773,11406,5544,5862,1816,2397,1331,1593,2651,1618
75778,2836,1421,1415,468,614,339,347,744,324
75782,224,96,128,41,42,13,45,58,25
75783,6494,3186,3308,888,1362,936,706,1437,1165
75784,736,379,357,136,159,84,125,159,73
75785,10619,5891,4728,1543,3525,823,1348,2283,1097
75788,102,43,59,15,17,11,15,26,18
75789,6040,2853,3187,930,1406,517,953,1480,754
75790,4077,1979,2098,681,960,338,639,980,479
75791,11281,5511,5770,2064,2806,641,1951,3097,722
75792,2858,1489,1369,494,754,241,401,729,239
75801,35538,19416,16122,5547,11546,2323,4979,7608,3535
75831,4915,2385,2530,796,1177,412,795,1180,555
75833,2799,1357,1442,333,640,384,295,701,446
75835,12087,5650,6437,1869,2564,1217,2006,2716,1715
75838,574,295,279,119,99,77,75,113,91
75839,4445,2108,2337,673,985,450,713,1048,576
75840,6597,3258,3339,1047,1637,574,950,1596,793
75844,5144,2516,2628,815,1091,610,712,1154,762
75845,2982,1470,1512,446,663,361,390,661,461
75846,2780,1417,1363,495,641,281,391,663,309
75847,1765,874,891,277,409,188,288,409,194
75848,357,181,176,43,98,40,51,78,47
75849,281,147,134,52,65,30,24,60,50
75850,539,254,285,84,115,55,102,111,72
75851,4731,3544,1187,348,2840,356,312,581,294
75852,4066,3308,758,283,2850,175,203,371,184
75853,875,409,466,128,196,85,176,197,93
75855,2129,1074,1055,270,514,290,246,517,292
75856,161,71,90,25,32,14,31,28,31
75858,142,69,73,9,40,20,11,29,33
75859,1204,548,656,103,262,183,156,317,183
75860,6143,3638,2505,989,2146,503,719,1150,636
75861,10451,9545,906,462,8855,228,271,469,166
75862,9230,4412,4818,1206,1849,1357,1188,2147,1483
75901,26042,12720,13322,4469,6357,1894,4223,6693,2406
75904,30899,14796,16103,5279,7434,2083,4999,7818,3286
75925,3606,1676,1930,544,762,370,577,856,497
75926,1134,546,588,159,265,122,177,287,124
75928,1296,645,651,278,257,110,198,316,137
75929,1472,717,755,133,287,297,153,300,302
75930,2158,1030,1128,323,510,197,377,528,223
75931,1817,872,945,214,398,260,279,409,257
75932,1525,723,802,150,318,255,176,339,287
75933,1556,739,817,219,355,165,257,380,180
75934,101,46,55,8,18,20,12,18,25
75935,13744,6625,7119,2326,3243,1056,2123,3310,1686
75936,805,391,414,124,188,79,121,191,102
75937,1256,627,629,204,300,123,163,320,146
75938,2783,1302,1481,405,582,315,450,679,352
75939,4105,1985,2120,782,904,299,729,964,427
75941,8810,4849,3961,1637,2650,562,1367,1897,697
75942,313,149,164,40,87,22,36,81,47
75943,883,424,459,152,203,69,139,228,92
75944,1028,528,500,164,221,143,134,237,129
75946,3503,1706,1797,596,779,331,460,792,545
75948,5536,2571,2965,438,1104,1029,602,1218,1145
75949,7573,3736,3837,1320,1773,643,1216,1889,732
75951,17234,8428,8806,2738,4138,1552,2570,4028,2208
75954,3329,1636,1693,557,795,284,491,819,383
75956,7262,3406,3856,1122,1619,665,1149,1733,974
75959,1099,576,523,132,235,209,132,206,185
75960,949,462,487,152,222,88,182,252,53
75961,32950,15367,17583,5928,7565,1874,7007,8004,2572
75964,17939,8745,9194,3260,4453,1032,3216,4418,1560
75966,6113,3242,2871,1132,1648,462,951,1393,527
75968,2053,1028,1025,343,496,189,295,467,263
75969,4535,2207,2328,777,1153,277,741,1249,338
75972,6802,3218,3584,1074,1445,699,982,1556,1046
75973,2774,1300,1474,373,620,307,400,672,402
75974,2855,1402,1453,509,653,240,458,735,260
75975,3293,1561,1732,476,751,334,501,708,523
75976,1221,602,619,185,307,110,174,264,181
75977,792,407,385,132,189,86,119,162,104
75978,105,50,55,15,26,9,21,25,9
75979,10242,5596,4646,1266,3159,1171,1144,2014,1488
75980,2533,1238,1295,325,569,344,368,563,364
76001,21316,10392,10924,3886,5965,541,3902,6481,541
76002,7132,3610,3522,1396,2080,134,1283,2051,188
76006,24324,12202,12122,2681,9040,481,3011,8607,504
76008,8478,4195,4283,1562,2114,519,1481,2224,578
76009,17221,8632,8589,3151,4493,988,2971,4446,1172
76010,53813,27892,25921,11313,14655,1924,10000,13373,2548
76011,30085,15484,14601,5136,9493,855,5068,8362,1171
76012,25280,12114,13166,3540,6664,1910,3674,7105,2387
76013,32170,15929,16241,5139,8479,2311,4404,8523,3314
76014,31064,15384,15680,6046,8316,1022,5521,9029,1130
76015,16093,7688,8405,2375,4422,891,2536,4722,1147
76016,30910,15237,15673,5300,8481,1456,4730,9253,1690
76017,41995,20862,21133,7403,11980,1479,6971,12505,1657
76018,24099,11933,12166,4775,6776,382,4487,7250,429
76020,23119,11313,11806,3750,5984,1579,3610,6215,1981
76021,33561,16318,17243,4655,9998,1665,4619,10458,2166
76022,13978,6649,7329,1873,3805,971,1758,4151,1420
76023,5380,2709,2671,948,1396,365,885,1389,397
76028,39224,19136,20088,6519,10101,2516,6284,10703,3101
76031,38588,18926,19662,6541,9601,2784,6069,9801,3792
76034,19606,9697,9909,3503,5340,854,3394,5644,871
76035,419,213,206,67,120,26,83,72,51
76036,12763,6153,6610,2262,3132,759,2213,3424,973
76039,27939,13733,14206,4015,8789,929,3686,9336,1184
76040,23195,11964,11231,3510,7600,854,3473,6654,1104
76041,267,120,147,21,89,10,25,102,20
76043,5789,2850,2939,996,1418,436,949,1408,582
76044,3270,1642,1628,636,831,175,588,866,174
76048,19417,9520,9897,2982,4712,1826,2580,4849,2468
76049,18338,9097,9241,2363,4277,2457,2353,4369,2519
76050,5052,2436,2616,832,1247,357,839,1313,464
76051,41897,21045,20852,7192,12649,1204,6788,12287,1777
76052,3074,1466,1608,492,866,108,534,947,127
76053,24301,11798,12503,4006,6090,1702,3637,6397,2469
76054,11738,5649,6089,1648,3079,922,1717,3345,1027
76055,2686,1344,1342,461,642,241,461,605,276
76058,14273,7208,7065,2893,3628,687,2409,3842,814
76059,4667,2196,2471,1008,955,233,906,1129,436
76060,5195,2599,2596,847,1512,240,877,1367,352
76061,460,207,253,50,131,26,97,116,40
76063,32998,16864,16134,6372,9191,1301,5624,8842,1668
76064,1439,721,718,269,349,103,269,335,114
76065,16629,8180,8449,3038,4373,769,2977,4577,895
76066,2685,1326,1359,404,674,248,402,726,231
76067,21967,11811,10156,3592,6457,1762,2985,4816,2355
76070,487,262,225,108,127,27,52,122,51
76071,2966,1459,1507,505,723,231,515,770,222
76073,4115,2073,2042,675,1093,305,651,1121,270
76077,471,229,242,58,129,42,65,145,32
76078,5129,2580,2549,898,1452,230,869,1434,246
76082,14792,7545,7247,2887,3834,824,2465,3902,880
76084,7258,4188,3070,1252,2663,273,1101,1712,257
76086,24243,11726,12517,4286,5658,1782,3758,6072,2687
76087,17505,8856,8649,2841,4646,1369,2563,4749,1337
76088,8959,4547,4412,1551,2339,657,1372,2388,652
76092,21076,10595,10481,4400,5654,541,4119,5867,495
76093,1793,907,886,340,459,108,284,440,162
76102,8589,4982,3607,1284,3309,389,1053,1909,645
76103,14489,7136,7353,2572,3748,816,2384,3579,1390
76104,17253,8256,8997,2934,3934,1388,2807,3976,2214
76105,21927,11002,10925,4904,5135,963,4368,5153,1404
76106,51654,27364,24290,11050,14426,1888,10633,11071,2586
76107,26572,12625,13947,3571,7246,1808,3747,7395,2805
76108,26685,12764,13921,4245,7021,1498,4474,7362,2085
76109,24064,11097,12967,3625,5787,1685,4338,5975,2654
76110,32710,17329,15381,6589,9568,1172,5821,7766,1794
76111,20620,10437,10183,3602,5691,1144,3420,5020,1743
76112,39590,18236,21354,6106,9816,2314,6472,11395,3487
76114,24522,11238,13284,3905,5657,1676,3702,6990,2592
76115,19897,9843,10054,3976,5210,657,4073,5057,924
76116,45361,22117,23244,6831,12287,2999,6554,12369,4321
76117,29347,14668,14679,4935,7790,1943,4562,7237,2880
76118,12500,5931,6569,1924,3254,753,1940,3322,1307
76119,40285,19654,20631,7594,9732,2328,7579,10129,2923
76120,10140,4865,5275,1348,3265,252,1401,3537,337
76123,11589,5553,6036,2382,2974,197,2281,3465,290
76126,15269,7421,7848,2196,4090,1135,2019,4509,1320
76127,292,251,41,79,172,0,19,22,0
76131,7067,3555,3512,1370,2020,165,1302,1973,237
76132,21390,10088,11302,2761,6209,1118,3038,6442,1822
76133,46235,21930,24305,7307,11389,3234,6888,12833,4584
76134,18710,8978,9732,3349,4343,1286,3105,4878,1749
76135,14704,7215,7489,2311,3845,1059,2112,3966,1411
76137,40038,20071,19967,7516,11924,631,7061,11880,1026
76140,18385,8863,9522,3391,4437,1035,3182,5042,1298
76148,24836,12061,12775,4429,6794,838,4529,7157,1089
76155,2586,1393,1193,171,1201,21,233,920,40
76177,21,13,8,1,10,2,2,2,4
76179,20663,10249,10414,3548,5666,1035,3406,5788,1220
76180,53858,26362,27496,8717,15035,2610,8502,15346,3648
76201,48882,24003,24879,8243,13925,1835,9303,12344,3232
76205,35707,17770,17937,5775,10540,1455,5734,10331,1872
76207,6010,2828,3182,1039,1555,234,1044,1885,253
76208,10652,5468,5184,2142,2931,395,1816,2912,456
76225,2273,1108,1165,319,607,182,323,595,247
76226,6762,3378,3384,1043,1955,380,1006,1965,413
76227,6703,3337,3366,1093,1884,360,1063,1861,442
76228,1131,553,578,163,298,92,174,293,111
76230,9384,4448,4936,1303,2105,1040,1375,2172,1389
76233,2575,1267,1308,408,650,209,352,670,286
76234,12774,6421,6353,2303,3301,817,2001,3270,1082
76238,93,52,41,23,24,5,11,22,8
76239,1108,524,584,147,258,119,182,272,130
76240,25562,12487,13075,4418,5902,2167,3939,5996,3140
76245,1370,671,699,101,361,209,155,337,207
76246,85,61,24,27,27,7,4,16,4
76247,5517,2752,2765,999,1501,252,901,1475,389
76248,27558,13673,13885,5323,7532,818,5076,7937,872
76249,4755,2335,2420,826,1303,206,843,1346,231
76250,845,416,429,168,191,57,148,207,74
76251,686,358,328,80,194,84,69,183,76
76252,2770,1365,1405,494,650,221,455,645,305
76253,274,131,143,39,82,10,65,58,20
76255,5384,2568,2816,772,1181,615,770,1227,819
76258,5828,2953,2875,1043,1525,385,891,1524,460
76259,2787,1422,1365,522,793,107,440,814,111
76261,234,108,126,42,47,19,41,62,23
76262,15695,7840,7855,2649,4408,783,2490,4608,757
76264,1370,660,710,197,317,146,219,327,164
76265,1763,855,908,246,414,195,238,425,245
76266,10400,5163,5237,1849,2752,562,1729,2833,675
76268,152,81,71,38,42,1,28,39,4
76270,1629,849,780,261,379,209,199,428,153
76271,1097,599,498,184,316,99,118,277,103
76272,3988,2002,1986,689,1011,302,618,1046,322
76273,8577,4158,4419,1347,2076,735,1315,2166,938
76301,19863,9683,10180,3285,4955,1443,3218,4797,2165
76302,11203,5399,5804,1874,2542,983,1693,2835,1276
76305,2730,1316,1414,404,660,252,354,731,329
76306,16917,8231,8686,2982,4064,1185,2839,4313,1534
76308,19774,9479,10295,3035,5026,1418,3085,5101,2109
76309,13841,6621,7220,2111,3399,1111,1962,3510,1748
76310,14603,6829,7774,2061,3761,1007,2455,4065,1254
76311,9395,6188,3207,4081,2099,8,1809,1376,22
76351,2079,977,1102,322,461,194,305,513,284
76354,11433,5530,5903,1869,2761,900,1855,2913,1135
76357,755,358,397,90,187,81,117,196,84
76360,3999,1893,2106,649,831,413,605,979,522
76363,373,186,187,64,70,52,55,69,63
76364,267,134,133,35,57,42,26,57,50
76365,5019,2386,2633,712,1110,564,715,1237,681
76366,2556,1250,1306,432,633,185,425,643,238
76367,13105,8282,4823,2379,5140,763,1522,2327,974
76370,339,172,167,41,91,40,54,68,45
76371,1897,873,1024,289,381,203,317,410,297
76372,1001,477,524,145,225,107,157,253,114
76373,216,94,122,22,43,29,55,40,27
76374,4377,2073,2304,704,931,438,625,1004,675
76377,915,417,498,134,196,87,150,241,107
76379,555,288,267,106,134,48,98,125,44
76380,4192,2035,2157,589,863,583,482,932,743
76384,13935,6784,7151,2436,3168,1180,2263,3080,1808
76388,204,111,93,29,55,27,12,52,29
76389,1367,715,652,307,313,95,249,281,122
76401,22954,11184,11770,4102,5538,1544,4084,5463,2223
76424,9120,4580,4540,1377,2361,842,1364,2125,1051
76426,9534,4956,4578,1551,2628,777,1436,2258,884
76427,770,392,378,136,178,78,98,189,91
76429,183,82,101,12,36,34,18,38,45
76430,2388,1110,1278,365,534,211,372,568,338
76431,3236,1633,1603,567,841,225,485,817,301
76432,1350,659,691,214,322,123,245,310,136
76433,865,415,450,102,235,78,113,246,91
76435,559,280,279,79,140,61,64,156,59
76436,122,70,52,21,40,9,9,23,20
76437,5527,2623,2904,902,1137,584,830,1249,825
76442,7692,3732,3960,1195,1705,832,1199,1624,1137
76443,1629,775,854,206,330,239,209,329,316
76444,3983,1925,2058,602,883,440,582,889,587
76445,345,164,181,55,57,52,66,60,55
76446,8264,4050,4214,1468,1981,601,1465,1959,790
76448,5521,2661,2860,796,1165,700,798,1275,787
76449,2227,1125,1102,305,533,287,230,573,299
76450,12469,6022,6447,1857,2813,1352,1635,3032,1780
76452,156,97,59,51,35,11,15,37,7
76453,909,427,482,109,205,113,122,224,136
76454,1650,788,862,282,309,197,217,372,273
76455,734,352,382,103,172,77,110,168,104
76457,3378,1612,1766,480,779,353,490,792,484
76458,6230,3513,2717,981,2023,509,810,1237,670
76459,195,102,93,29,52,21,31,41,21
76460,358,194,164,57,87,50,31,82,51
76462,2382,1167,1215,383,579,205,382,606,227
76463,423,205,218,54,94,57,45,96,77
76464,427,222,205,69,90,63,42,96,67
76466,344,174,170,49,107,18,40,104,26
76468,135,68,67,26,21,21,18,27,22
76469,26,8,18,2,4,2,2,8,8
76470,3303,1622,1681,589,673,360,525,695,461
76471,1699,857,842,240,381,236,192,386,264
76472,1279,673,606,222,337,114,170,334,102
76474,320,166,154,59,70,37,37,69,48
76475,1004,503,501,192,217,94,158,218,125
76476,2152,1071,1081,376,517,178,359,525,197
76481,295,149,146,57,60,32,24,98,24
76483,1205,593,612,186,253,154,154,276,182
76484,885,487,398,122,278,87,104,198,96
76486,1123,554,569,203,249,102,169,290,110
76487,1806,903,903,331,412,160,299,461,143
76490,70,36,34,17,19,0,7,27,0
76491,477,237,240,97,92,48,71,105,64
76501,14960,7055,7905,2347,3559,1149,2480,3724,1701
76502,22852,10755,12097,3397,5408,1950,3426,5948,2723
76504,22306,10958,11348,3651,5603,1704,3581,5406,2361
76511,3437,2151,1286,632,1322,197,353,575,358
76513,27873,13835,14038,5048,6995,1792,4868,6827,2343
76518,1511,738,773,279,336,123,284,346,143
76519,510,261,249,60,116,85,55,114,80
76520,8702,4205,4497,1425,1915,865,1299,1902,1296
76522,33346,16538,16808,6330,8998,1210,6415,8869,1524
76523,217,108,109,29,62,17,27,56,26
76524,2396,1143,1253,391,604,148,487,598,168
76525,1050,519,531,162,229,128,153,218,160
76527,3248,1658,1590,573,893,192,560,842,188
76528,22797,9730,13067,2411,6103,1216,2444,8892,1731
76530,2332,1135,1197,366,549,220,343,560,294
76531,4861,2349,2512,686,973,690,576,1052,884
76534,2381,1175,1206,393,579,203,381,582,243
76537,2238,1159,1079,411,591,157,343,593,143
76538,2061,1478,583,668,721,89,185,311,87
76539,5860,2820,3040,882,1601,337,1047,1595,398
76541,21105,10676,10429,3677,6147,852,4046,5123,1260
76542,24951,12481,12470,4524,7234,723,4583,7101,786
76543,29177,14424,14753,5652,7977,795,5689,7931,1133
76544,33868,21092,12776,11382,9702,8,6694,6011,71
76548,17602,8893,8709,3287,4905,701,2910,4929,870
76549,18140,9088,9052,3649,4990,449,3376,4995,681
76550,11242,5586,5656,2038,2502,1046,1597,2670,1389
76554,1986,977,1009,393,429,155,316,515,178
76556,1298,648,650,196,303,149,180,334,136
76557,3380,1727,1653,641,826,260,534,863,256
76559,2434,1225,1209,469,645,111,448,656,105
76561,783,366,417,138,183,45,135,185,97
76565,125,74,51,21,27,26,0,20,31
76566,295,130,165,25,75,30,45,88,32
76567,9165,4446,4719,1632,2053,761,1465,2171,1083
76569,2431,1187,1244,471,552,164,427,618,199
76570,2791,1356,1435,465,596,295,423,582,430
76571,5025,2500,2525,745,1226,529,659,1306,560
76574,16330,8019,8311,2751,4148,1120,2659,4069,1583
76577,2571,1290,1281,446,614,230,368,613,300
76578,1461,719,742,252,375,92,223,348,171
76579,3422,1699,1723,626,824,249,564,856,303
76621,1042,560,482,201,273,86,132,256,94
76622,946,485,461,149,222,114,137,228,96
76624,2316,1144,1172,348,574,222,360,589,223
76626,1463,712,751,238,356,118,231,353,167
76627,1300,658,642,220,324,114,225,311,106
76628,103,54,49,18,28,8,13,27,9
76629,1924,923,1001,288,431,204,254,418,329
76630,1744,855,889,333,436,86,309,484,96
76631,357,191,166,82,77,32,50,79,37
76632,1734,902,832,315,451,136,267,380,185
76633,3581,1781,1800,575,942,264,626,936,238
76634,7334,3388,3946,875,1605,908,1015,1660,1271
76635,1195,579,616,220,275,84,216,271,129
76636,1682,842,840,271,427,144,252,438,150
76637,608,331,277,124,143,64,82,125,70
76638,2366,1185,1181,440,579,166,375,581,225
76639,1719,826,893,289,373,164,254,421,218
76640,3206,1703,1503,640,826,237,425,825,253
76641,1552,798,754,248,373,177,206,391,157
76642,6452,3558,2894,1028,2007,523,890,1260,744
76643,10860,5250,5610,1788,2934,528,1730,3285,595
76645,10953,5390,5563,1861,2544,985,1629,2539,1395
76648,2641,1243,1398,399,559,285,420,571,407
76649,996,538,458,174,231,133,110,222,126
76651,3229,1575,1654,570,771,234,550,790,314
76652,944,484,460,131,240,113,131,246,83
76653,1084,546,538,120,272,154,165,239,134
76655,6444,3099,3345,1081,1616,402,1096,1792,457
76656,2120,1063,1057,431,474,158,321,522,214
76657,8732,4158,4574,1469,1970,719,1445,2032,1097
76660,569,282,287,107,129,46,91,134,62
76661,9557,4090,5467,1818,1506,766,1491,2855,1121
76664,3370,1580,1790,580,697,303,547,789,454
76665,2556,1228,1328,379,575,274,431,541,356
76666,353,181,172,50,81,50,39,82,51
76667,10743,5188,5555,1789,2582,817,1603,2645,1307
76670,1157,568,589,196,258,114,180,280,129
76671,1718,850,868,241,402,207,222,378,268
76673,954,485,469,143,240,102,164,220,85
76675,123,53,70,9,36,8,27,33,10
76676,439,215,224,65,111,39,61,110,53
76678,139,66,73,20,29,17,6,39,28
76679,1285,658,627,180,311,167,182,324,121
76680,188,95,93,22,47,26,7,48,38
76681,564,312,252,105,151,56,45,135,72
76682,2609,1337,1272,377,647,313,346,633,293
76685,149,72,77,17,45,10,22,43,12
76686,354,160,194,41,92,27,45,95,54
76687,1329,666,663,170,327,169,147,327,189
76689,2862,1370,1492,451,660,259,447,725,320
76690,1020,499,521,207,216,76,185,230,106
76691,6325,3092,3233,1112,1409,571,926,1492,815
76692,8449,4091,4358,1160,1903,1028,1109,1990,1259
76693,1643,780,863,286,371,123,253,415,195
76701,2247,1501,746,325,1012,164,146,378,222
76704,7430,3217,4213,1418,1253,546,1575,1722,916
76705,27697,14378,13319,5973,6729,1676,4607,6590,2122
76706,29358,14386,14972,6436,6473,1477,6434,6637,1901
76707,17260,8423,8837,3745,3946,732,3449,3970,1418
76708,21540,10109,11431,3719,4794,1596,3713,5114,2604
76710,22480,10441,12039,3012,5180,2249,2810,5382,3847
76711,8690,4364,4326,1625,2074,665,1578,1987,761
76712,19631,9428,10203,2922,4911,1595,2967,5205,2031
76798,3117,922,2195,884,38,0,2128,67,0
76801,25460,12450,13010,4336,6013,2101,4145,5801,3064
76802,4794,2333,2461,778,1088,467,745,1131,585
76821,5450,2630,2820,903,1226,501,704,1265,851
76823,3102,1456,1646,459,733,264,459,752,435
76824,91,49,42,13,20,16,8,22,12
76825,6958,3279,3679,1044,1546,689,1135,1517,1027
76827,481,227,254,79,116,32,87,143,24
76828,239,111,128,18,60,33,29,56,43
76831,11,5,6,5,0,0,0,6,0
76832,623,311,312,116,141,54,84,156,72
76834,6497,3074,3423,899,1418,757,904,1440,1079
76837,2798,1981,817,295,1520,166,231,344,242
76841,36,25,11,7,15,3,0,8,3
76842,161,77,84,11,32,34,15,24,45
76844,3681,1877,1804,613,783,481,465,762,577
76845,118,57,61,14,23,20,17,24,20
76848,51,22,29,0,14,8,8,21,0
76849,3888,1859,2029,579,835,445,570,880,579
76852,175,99,76,34,32,33,11,45,20
76853,1490,780,710,294,296,190,191,298,221
76854,310,135,175,31,48,56,47,71,57
76856,3529,1679,1850,490,714,475,468,816,566
76857,1633,823,810,222,389,212,191,368,251
76858,205,95,110,25,51,19,21,56,33
76859,2332,1169,1163,373,482,314,286,527,350
76861,1915,985,930,371,442,172,297,465,168
76862,162,93,69,23,47,23,10,38,21
76864,987,550,437,163,241,146,91,219,127
76865,156,60,96,10,32,18,19,38,39
76866,587,279,308,67,146,66,93,143,72
76869,168,83,85,9,49,25,23,18,44
76870,201,91,110,31,50,10,38,48,24
76871,920,471,449,139,211,121,111,202,136
76872,575,260,315,66,113,81,83,140,92
76873,59,25,34,1,11,13,4,12,18
76874,100,34,66,0,24,10,17,32,17
76875,687,335,352,73,147,115,80,128,144
76877,4461,2350,2111,1009,879,462,569,939,603
76878,1493,707,786,222,328,157,221,335,230
76882,227,116,111,40,47,29,31,47,33
76884,168,86,82,20,43,23,20,44,18
76885,21,11,10,0,6,5,0,10,0
76887,126,73,53,7,49,17,6,28,19
76888,62,32,30,5,12,15,4,18,8
76890,951,481,470,156,222,103,133,228,109
76901,25634,12307,13327,4168,6202,1937,3979,6676,2672
76903,33679,16278,17401,6261,7577,2440,5878,7824,3699
76904,29565,14052,15513,4797,7022,2233,5016,7511,2986
76905,11340,5731,5609,2298,2828,605,2062,2813,734
76930,124,55,69,16,29,10,15,41,13
76932,3205,1578,1627,615,766,197,657,737,233
76933,1606,867,739,403,288,176,203,337,199
76934,1382,686,696,186,356,144,156,378,162
76935,1128,599,529,206,290,103,134,301,94
76936,2875,1413,1462,474,670,269,457,670,335
76937,312,138,174,54,61,23,63,83,28
76940,140,74,66,35,28,11,18,34,14
76941,1560,799,761,256,388,155,214,390,157
76943,3972,1967,2005,657,1029,281,682,965,358
76945,1867,860,1007,225,362,273,266,410,331
76949,32,16,16,2,8,6,0,8,8
76950,4105,2059,2046,740,1006,313,612,1050,384
76951,1385,692,693,234,339,119,211,340,142
76953,75,34,41,6,16,12,17,10,14
76955,117,63,54,28,24,11,16,22,16
76958,260,129,131,45,65,19,34,81,16
77002,13461,11121,2340,2244,8632,245,228,1888,224
77003,9000,4710,4290,1771,2383,556,1756,1890,644
77004,30562,14726,15836,5434,7327,1965,5446,7280,3110
77005,23390,11417,11973,3484,6789,1144,3531,6863,1579
77006,18728,10648,8080,1162,8814,672,1359,6078,643
77007,22740,12270,10470,3357,7811,1102,2935,6121,1414
77008,28438,14312,14126,3666,9016,1630,3446,7770,2910
77009,42306,21825,20481,7521,12079,2225,6734,10598,3149
77010,53,29,24,0,10,19,0,16,8
77011,23152,12250,10902,4866,6207,1177,4473,5085,1344
77012,25333,13240,12093,5569,6807,864,5398,5550,1145
77013,18295,9500,8795,3752,5036,712,3609,4363,823
77014,20732,10179,10553,3746,6130,303,3870,6271,412
77015,50581,25181,25400,10150,13271,1760,9309,13696,2395
77016,29700,14002,15698,5102,6664,2236,5080,7727,2891
77017,32791,16645,16146,6796,8518,1331,6329,7809,2008
77018,26349,13147,13202,3803,7318,2026,3179,7082,2941
77019,15965,8105,7860,1472,5620,1013,1433,5320,1107
77020,28541,14390,14151,5680,7293,1417,5653,6308,2190
77021,24350,11224,13126,4111,5237,1876,4032,6133,2961
77022,31829,15993,15836,6161,8108,1724,5866,7468,2502
77023,32909,16966,15943,6783,9021,1162,6517,7717,1709
77024,32636,15303,17333,4390,7613,3300,4185,8687,4461
77025,23759,11357,12402,3025,6786,1546,2794,7210,2398
77026,27523,13246,14277,5187,6265,1794,4881,6529,2867
77027,14153,7078,7075,951,5215,912,960,4855,1260
77028,16512,7831,8681,2903,3660,1268,2957,4071,1653
77029,18424,9058,9366,3463,4295,1300,3235,4126,2005
77030,10910,5179,5731,1000,3618,561,1104,3943,684
77031,17202,8750,8452,3369,4700,681,2708,5030,714
77032,11005,5447,5558,2201,2871,375,2219,2857,482
77033,27747,12891,14856,5169,5686,2036,4728,7221,2907
77034,26377,13104,13273,4651,7282,1171,4710,6953,1610
77035,39375,18953,20422,6952,10287,1714,7237,10883,2302
77036,76146,38549,37597,13352,22381,2816,12938,21113,3546
77037,18736,9401,9335,3694,4954,753,3694,4516,1125
77038,20806,10309,10497,4475,5301,533,4403,5410,684
77039,27739,13831,13908,6011,6747,1073,5606,7107,1195
77040,39264,19500,19764,6741,11474,1285,6290,11859,1615
77041,25341,12550,12791,4703,7054,793,4644,7126,1021
77042,35923,17940,17983,4056,12401,1483,3796,12371,1816
77043,24507,12324,12183,4283,6552,1489,4117,6293,1773
77044,13411,6467,6944,2716,3350,401,2639,3787,518
77045,25605,11972,13633,5208,5636,1128,4946,7089,1598
77046,478,220,258,30,102,88,25,149,84
77047,10985,5105,5880,1877,2386,842,1882,2792,1206
77048,14322,6405,7917,2857,2743,805,3063,3914,940
77049,16478,8246,8232,3590,4184,472,3080,4547,605
77050,4327,2078,2249,755,1094,229,913,1163,173
77051,13242,6001,7241,2372,2525,1104,2231,3169,1841
77053,25585,12509,13076,5622,6095,792,5330,6981,765
77054,16391,7609,8782,1501,5861,247,1636,6725,421
77055,43607,22799,20808,8181,12702,1916,7387,10802,2619
77056,14072,6570,7502,1006,4256,1308,1183,4348,1971
77057,35346,18196,17150,3455,12784,1957,2850,11982,2318
77058,15140,7605,7535,1414,5178,1013,1596,4838,1101
77059,16644,8401,8243,3264,4506,631,2912,4711,620
77060,35891,18178,17713,7775,9504,899,7256,9376,1081
77061,25437,12664,12773,4731,6799,1134,4693,6546,1534
77062,27082,13291,13791,4436,7288,1567,4343,7826,1622
77063,27418,13796,13622,2596,9870,1330,2415,9149,2058
77064,35874,17976,17898,6856,10285,835,6113,10662,1123
77065,27059,13376,13683,4394,8154,828,4211,8407,1065
77066,27572,13739,13833,5125,7687,927,4751,7851,1231
77067,24525,11968,12557,5156,6429,383,5058,7090,409
77068,9466,4621,4845,1509,2563,549,1343,2916,586
77069,14749,7151,7598,1738,4186,1227,1685,4376,1537
77070,32371,15891,16480,5533,8977,1381,5173,9416,1891
77071,25221,11718,13503,4404,6191,1123,4353,7488,1662
77072,51910,25216,26694,10181,13167,1868,9915,14462,2317
77073,12614,6547,6067,2297,3883,367,1803,3800,464
77074,38974,19037,19937,6956,10307,1774,6587,10423,2927
77075,22536,11168,11368,4227,6197,744,4293,6069,1006
77076,30047,15240,14807,6640,7412,1188,5863,7128,1816
77077,42560,20486,22074,5250,13332,1904,4999,14366,2709
77078,14516,6780,7736,3237,3076,467,3141,3938,657
77079,30886,14751,16135,4796,7451,2504,4774,8211,3150
77080,46066,23794,22272,8471,13133,2190,7605,11337,3330
77081,49594,26895,22699,9540,16634,721,8684,13029,986
77082,35782,17697,18085,5737,11032,928,4683,12020,1382
77083,52231,25751,26480,10501,13742,1508,9534,15298,1648
77084,63566,31533,32033,11988,18130,1415,11402,18756,1875
77085,7277,3604,3673,1436,1857,311,1399,1889,385
77086,19763,9835,9928,4120,5192,523,3840,5514,574
77087,36076,18263,17813,7459,9084,1720,6943,8499,2371
77088,47713,22865,24848,9039,11760,2066,8461,13380,3007
77089,36567,18050,18517,6533,9857,1660,6024,10440,2053
77090,25780,12761,13019,3657,8006,1098,3446,8102,1471
77091,24746,11345,13401,4770,5360,1215,4824,6926,1651
77092,37910,18629,19281,6740,10284,1605,6508,10476,2297
77093,45907,23495,22412,9749,11623,2123,9577,10103,2732
77094,7816,3912,3904,1657,2062,193,1588,2133,183
77095,39275,19342,19933,7334,11214,794,7312,11599,1022
77096,34188,15901,18287,4954,8002,2945,4818,9521,3948
77098,11957,6236,5721,818,4793,625,729,4254,738
77099,43243,21126,22117,8378,11483,1265,7889,12597,1631
77301,24598,12471,12127,4937,6392,1142,4481,5853,1793
77302,12752,6242,6510,2212,3118,912,2069,3501,940
77303,11098,5542,5556,2015,2963,564,1791,3062,703
77304,15725,7694,8031,2291,4264,1139,2140,4159,1732
77306,8248,4197,4051,1640,2118,439,1497,2050,504
77316,9125,4523,4602,1585,2349,589,1457,2522,623
77318,9884,4892,4992,1442,2457,993,1302,2717,973
77320,32732,21924,10808,6072,13889,1963,3469,5421,1918
77326,156,87,69,14,55,18,17,37,15
77327,29668,14972,14696,5515,7357,2100,4746,7608,2342
77331,5881,2942,2939,844,1329,769,712,1449,778
77333,149,72,77,17,29,26,21,29,27
77334,149,51,98,15,29,7,18,37,43
77335,1904,970,934,315,458,197,291,414,229
77336,8656,4401,4255,1584,2275,542,1419,2256,580
77338,20156,9785,10371,3412,5581,792,3526,5697,1148
77339,30639,15104,15535,5109,8224,1771,4724,8928,1883
77340,24547,13237,11310,4384,7267,1586,4217,5144,1949
77341,1341,619,722,582,37,0,637,85,0
77345,22931,11436,11495,4495,6099,842,4177,6418,900
77346,27957,13886,14071,5216,7740,930,4798,8227,1046
77351,29224,15708,13516,4011,8542,3155,3479,6270,3767
77354,15942,7929,8013,2897,4306,726,2665,4532,816
77355,14466,7120,7346,2515,3961,644,2557,4045,744
77356,14471,7174,7297,1901,3459,1814,1619,3862,1816
77357,17081,8591,8490,3113,4529,949,2966,4442,1082
77358,3639,1855,1784,665,933,257,512,955,317
77359,617,317,300,107,137,73,78,152,70
77360,4047,1968,2079,477,820,671,423,960,696
77362,2856,1451,1405,539,762,150,436,727,242
77363,2104,1047,1057,337,607,103,355,570,132
77364,1924,902,1022,177,421,304,226,482,314
77365,15914,7870,8044,2869,4183,818,2666,4302,1076
77367,251,116,135,39,47,30,43,55,37
77368,779,360,419,27,240,93,120,226,73
77369,1369,670,699,210,339,121,170,344,185
77371,7227,3588,3639,1286,1752,550,1103,1805,731
77372,9977,4921,5056,1806,2489,626,1704,2580,772
77373,36434,17904,18530,6700,10025,1179,6230,10888,1412
77374,361,163,198,61,79,23,66,94,38
77375,34589,16905,17684,6175,9299,1431,5935,9552,2197
77376,542,256,286,92,141,23,118,125,43
77378,11083,5524,5559,2180,2749,595,1979,2935,645
77379,46041,23037,23004,8612,12696,1729,7959,13238,1807
77380,19291,9253,10038,2879,5387,987,2944,5808,1286
77381,36074,17275,18799,6564,9422,1289,6310,10250,2239
77382,14081,6971,7110,2717,3915,339,2647,4050,413
77384,3968,1999,1969,692,1049,258,622,1098,249
77385,9565,4712,4853,1715,2477,520,1665,2679,509
77386,13937,6893,7044,2388,3934,571,2434,3950,660
77388,26755,13224,13531,4716,7299,1209,4506,7768,1257
77389,13166,6548,6618,2524,3464,560,2292,3629,697
77396,23523,13003,10520,4971,7217,815,3734,5903,883
77401,15839,7603,8236,2539,4150,914,2244,4637,1355
77412,248,108,140,47,55,6,75,54,11
77414,24062,11734,12328,4372,5725,1637,4213,5890,2225
77415,176,88,88,21,45,22,8,35,45
77417,1790,952,838,387,432,133,269,417,152
77418,8986,4357,4629,1406,2164,787,1343,2167,1119
77419,1466,782,684,342,352,88,248,312,124
77420,2119,1093,1026,422,552,119,342,530,154
77422,13955,7511,6444,2650,3954,907,2047,3239,1158
77423,6869,3389,3480,1224,1689,476,1234,1701,545
77426,1224,611,613,212,249,150,120,305,188
77428,43,24,19,0,6,18,0,0,19
77429,42274,21016,21258,7863,11683,1470,7266,12457,1535
77430,2245,1120,1125,313,612,195,315,599,211
77432,521,280,241,86,144,50,91,114,36
77433,3674,1839,1835,802,978,59,707,1034,94
77434,5030,2487,2543,966,1080,441,849,1186,508
77435,4197,2132,2065,661,1119,352,663,1076,326
77437,16144,7893,8251,2933,3761,1199,2846,3666,1739
77440,221,132,89,37,61,34,23,37,29
77441,2078,1042,1036,301,571,170,269,576,191
77442,1199,663,536,205,293,165,151,255,130
77443,122,79,43,26,40,13,14,21,8
77444,602,286,316,91,164,31,139,134,43
77445,10119,5144,4975,1936,2562,646,1634,2519,822
77446,3953,1829,2124,1120,571,138,1429,511,184
77447,8091,4195,3896,1623,2182,390,1401,2112,383
77448,627,284,343,121,116,47,101,133,109
77449,38536,18884,19652,7651,10553,680,7411,11120,1121
77450,48051,23429,24622,9106,12979,1344,8985,14045,1592
77451,535,232,303,78,112,42,79,147,77
77454,173,98,75,52,46,0,22,37,16
77455,1943,998,945,350,483,165,329,441,175
77456,1298,621,677,153,357,111,248,349,80
77457,644,334,310,55,157,122,56,161,93
77458,205,100,105,32,51,17,32,54,19
77459,32774,16048,16726,5808,8769,1471,5291,9837,1598
77461,8270,4045,4225,1466,2075,504,1504,2093,628
77463,82,50,32,25,25,0,0,20,12
77464,477,236,241,76,127,33,79,130,32
77465,6957,3514,3443,1477,1571,466,1222,1531,690
77466,873,446,427,202,195,49,126,241,60
77467,139,65,74,19,19,27,19,22,33
77468,210,101,109,34,60,7,38,23,48
77469,44374,23280,21094,8162,13308,1810,7465,11570,2059
77470,255,131,124,30,59,42,24,63,37
77471,27945,13872,14073,5275,7060,1537,4938,6855,2280
77473,117,51,66,17,27,7,23,33,10
77474,10549,5219,5330,1793,2634,792,1726,2646,958
77475,761,376,385,85,171,120,59,213,113
77476,1133,573,560,161,313,99,120,318,122
77477,27597,13564,14033,4788,7889,887,4633,8273,1127
77478,53125,26091,27034,9603,14040,2448,8587,15319,3128
77479,55682,28445,27237,11146,15868,1431,10075,15540,1622
77480,7454,3724,3730,1329,1890,505,1214,1898,618
77481,191,83,108,27,44,12,21,54,33
77482,2068,1078,990,354,573,151,206,547,237
77483,455,225,230,76,130,19,95,87,48
77484,8567,4219,4348,1400,2301,518,1508,2259,581
77485,2498,1226,1272,462,619,145,396,673,203
77486,7363,3535,3828,1180,1733,622,1188,1888,752
77488,15030,7245,7785,2624,3464,1157,2482,3583,1720
77489,32672,15424,17248,6408,8115,901,6217,9946,1085
77493,14751,7450,7301,3016,3829,605,2545,4007,749
77494,11562,5658,5904,2153,3112,393,2239,3258,407
77502,34885,16986,17899,6311,8550,2125,6317,8577,3005
77503,23470,11634,11836,4609,5832,1193,4498,5909,1429
77504,19521,9768,9753,3382,5494,892,3060,5267,1426
77505,20349,10122,10227,3855,5554,713,3645,5797,785
77506,39424,20171,19253,8783,10174,1214,8131,9144,1978
77507,0,0,0,0,0,0,0,0,0
77510,13611,6761,6850,2357,3477,927,2229,3624,997
77511,42361,21132,21229,8054,10911,2167,7357,11277,2595
77514,5321,2624,2697,875,1316,433,871,1298,528
77515,28608,14824,13784,4855,8475,1494,4571,7133,2080
77517,4496,2256,2240,758,1260,238,685,1283,272
77518,7113,3507,3606,1194,1951,362,1282,1914,410
77519,1275,648,627,195,355,98,165,321,141
77520,46330,22644,23686,8602,11504,2538,8248,11582,3856
77521,38153,18537,19616,6867,10163,1507,6887,10416,2313
77530,27697,13868,13829,5882,6985,1001,5552,7195,1082
77531,14674,7524,7150,2945,3911,668,2598,3739,813
77532,20206,9916,10290,3527,5294,1095,3361,5586,1343
77533,1036,490,546,191,237,62,179,283,84
77534,2771,1380,1391,539,704,137,524,670,197
77535,28221,13350,14871,4562,7552,1236,4473,8902,1496
77536,28431,14050,14381,5078,7683,1289,4871,7892,1618
77538,837,401,436,153,194,54,141,231,64
77539,26621,13491,13130,4545,7283,1663,4082,7169,1879
77541,18318,9230,9088,3613,4577,1040,3459,4447,1182
77545,6768,3413,3355,1498,1676,239,1319,1739,297
77546,38701,18757,19944,6660,10360,1737,6646,11145,2153
77547,9524,4704,4820,2020,2260,424,1956,2098,766
77550,30142,14733,15409,4560,8268,1905,4193,8024,3192
77551,20986,9963,11023,3280,5122,1561,3012,5718,2293
77553,631,275,356,211,64,0,317,39,0
77554,8053,4013,4040,904,2307,802,888,2475,677
77560,1083,515,568,160,305,50,229,240,99
77561,593,297,296,103,142,52,86,153,57
77562,9877,4795,5082,1722,2526,547,1690,2685,707
77563,8832,4235,4597,1262,2194,779,1325,2345,927
77564,2398,1212,1186,471,587,154,369,614,203
77565,6388,3318,3070,922,2033,363,790,1894,386
77566,28140,13795,14345,4988,7063,1744,4866,7355,2124
77568,13443,6352,7091,2125,3093,1134,2139,3454,1498
77571,33769,16772,16997,6173,9174,1425,5666,9463,1868
77573,41821,20890,20931,7216,12085,1589,6917,11953,2061
77575,14197,6963,7234,2389,3539,1035,2306,3440,1488
77577,861,453,408,100,282,71,99,229,80
77578,5433,2730,2703,914,1478,338,756,1578,369
77581,30453,15081,15372,5168,8158,1755,4598,8584,2190
77582,721,346,375,131,144,71,119,169,87
77583,16964,11935,5029,2212,8948,775,1765,2742,522
77584,30001,14706,15295,4872,8396,1438,4833,8841,1621
77585,952,484,468,178,213,93,124,243,101
77586,18802,9691,9111,2877,5693,1121,2567,5340,1204
77587,14645,7413,7232,3068,3632,713,2980,3431,821
77590,30604,14460,16144,5156,7297,2007,5083,8282,2779
77591,9958,4550,5408,1441,2249,860,1426,2740,1242
77597,806,420,386,147,209,64,99,234,53
77598,19852,10243,9609,3074,6842,327,2801,6130,678
77611,9707,4845,4862,1654,2455,736,1557,2451,854
77612,7705,3814,3891,1192,2012,610,1179,2032,680
77613,928,449,479,150,210,89,167,207,105
77614,1241,650,591,224,317,109,180,309,102
77615,1807,904,903,323,445,136,270,490,143
77616,1367,688,679,261,318,109,259,297,123
77617,531,282,249,72,135,75,48,140,61
77619,16525,7851,8674,2425,3952,1474,2516,4028,2130
77622,1398,661,737,183,374,104,254,336,147
77623,457,254,203,66,113,75,42,92,69
77624,793,396,397,152,174,70,114,225,58
77625,7687,3872,3815,1325,2036,511,1157,1930,728
77627,21764,10592,11172,3425,5475,1692,3314,5755,2103
77629,762,393,369,156,161,76,111,183,75
77630,28661,13866,14795,4688,6785,2393,4370,7157,3268
77632,21630,10768,10862,3670,5518,1580,3445,5729,1688
77640,20200,9666,10534,3292,4409,1965,3124,4851,2559
77642,36790,17516,19274,6799,8225,2492,6471,8631,4172
77650,2865,1452,1413,297,668,487,295,678,440
77651,13537,6612,6925,2126,3338,1148,2049,3531,1345
77655,680,383,297,143,177,63,76,167,54
77656,16984,8273,8711,2877,4094,1302,2596,4303,1812
77657,15139,7475,7664,2745,3816,914,2510,4184,970
77659,4509,2249,2260,823,1091,335,690,1156,414
77660,1441,697,744,251,341,105,239,375,130
77662,27523,13525,13998,4702,6883,1940,4308,7155,2535
77663,1097,549,548,57,209,283,82,211,255
77664,2769,1343,1426,443,625,275,409,724,293
77665,6575,3334,3241,1059,1756,519,1025,1644,572
77701,16558,8356,8202,3345,3963,1048,2540,4017,1645
77702,2916,1419,1497,429,795,195,424,803,270
77703,15765,7127,8638,3004,3093,1030,3048,4060,1530
77705,39969,25358,14611,6286,17014,2058,5021,7003,2587
77706,26268,12382,13886,3465,6684,2233,3402,7172,3312
77707,16326,7617,8709,2556,3890,1171,2566,4321,1822
77708,11043,5220,5823,2009,2535,676,2055,2962,806
77713,9658,4700,4958,1492,2614,594,1438,2642,878
77801,13299,7214,6085,2622,4287,305,2517,3207,361
77802,20667,9912,10755,3474,4994,1444,3173,5168,2414
77803,28112,13791,14321,5878,6776,1137,5175,7465,1681
77807,6803,3642,3161,1565,1787,290,1060,1746,355
77808,7633,3865,3768,1413,1956,496,1200,2004,564
77830,2334,1127,1207,262,638,227,329,590,288
77831,2658,1399,1259,485,658,256,344,624,291
77833,25806,12543,13263,4399,6074,2070,4101,5999,3163
77835,1950,968,982,266,456,246,279,436,267
77836,10655,5207,5448,1660,2602,945,1594,2651,1203
77837,1797,869,928,338,340,191,241,407,280
77840,46803,24088,22715,13280,10141,667,13669,7932,1114
77845,29211,14603,14608,5286,8141,1176,5306,7850,1452
77853,1029,483,546,146,236,101,170,242,134
77855,177,88,89,10,38,40,22,34,33
77856,3860,1811,2049,505,867,439,577,920,552
77857,499,252,247,79,114,59,69,121,57
77859,6687,3120,3567,1233,1367,520,1262,1643,662
77861,1887,951,936,349,421,181,283,484,169
77864,6664,3142,3522,1081,1452,609,1091,1543,888
77865,1334,652,682,152,321,179,199,326,157
77866,98,37,61,0,22,15,41,10,10
77867,213,97,116,43,48,6,66,46,4
77868,14871,8334,6537,2100,4783,1451,2163,3041,1333
77870,263,164,99,62,75,27,12,51,36
77871,3207,1552,1655,416,600,536,335,706,614
77872,1694,837,857,244,402,191,216,403,238
77873,955,448,507,134,226,88,129,258,120
77876,494,253,241,77,137,39,80,120,41
77878,747,358,389,133,171,54,120,204,65
77879,4626,2196,2430,695,1059,442,735,1105,590
77880,1367,711,656,270,321,120,250,296,110
77882,230,134,96,24,61,49,11,42,43
77901,40449,19834,20615,7431,9887,2516,6776,10007,3832
77904,23741,11216,12525,3875,5808,1533,3924,6322,2279
77905,14169,7143,7026,2403,3633,1107,2296,3688,1042
77950,218,117,101,33,52,32,21,57,23
77951,2538,1261,1277,610,524,127,512,570,195
77954,11309,6140,5169,1605,3482,1053,1452,2402,1315
77957,8656,4270,4386,1485,2058,727,1312,2004,1070
77960,94,55,39,0,42,13,0,26,13
77961,131,67,64,11,15,41,29,15,20
77962,3269,1639,1630,577,777,285,492,756,382
77963,5617,2755,2862,902,1254,599,855,1337,670
77964,7756,3736,4020,1072,1706,958,1062,1739,1219
77968,2230,1074,1156,371,556,147,419,581,156
77969,133,73,60,18,48,7,12,31,17
77970,434,223,211,70,122,31,59,112,40
77971,816,413,403,157,208,48,142,210,51
77973,62,29,33,7,16,6,15,7,11
77974,307,142,165,41,72,29,61,70,34
77975,1868,941,927,289,408,244,220,382,325
77977,671,331,340,132,180,19,143,157,40
77978,780,380,400,126,198,56,145,194,61
77979,16822,8235,8587,2855,4124,1256,2918,4154,1515
77982,1107,594,513,144,285,165,105,259,149
77983,2106,1030,1076,372,460,198,362,515,199
77984,4315,2078,2237,588,946,544,536,963,738
77988,661,344,317,125,186,33,95,175,47
77990,878,443,435,139,216,88,141,210,84
77991,368,185,183,82,91,12,67,94,22
77994,402,201,201,55,97,49,41,71,89
77995,9094,4271,4823,1370,2038,863,1523,2035,1265
78001,22,15,7,4,5,6,0,7,0
78002,6318,3141,3177,1102,1664,375,1055,1583,539
78003,7537,3809,3728,1119,1739,951,961,1848,919
78004,977,512,465,182,258,72,130,307,28
78005,503,274,229,95,101,78,46,124,59
78006,18954,9107,9847,2978,4554,1575,2812,5050,1985
78007,160,100,60,25,56,19,12,30,18
78008,440,182,258,51,91,40,84,87,87
78009,6684,3352,3332,1251,1610,491,1035,1733,564
78010,2348,1170,1178,369,528,273,283,605,290
78011,1964,981,983,403,438,140,380,431,172
78012,533,264,269,118,117,29,120,122,27
78013,5057,2552,2505,898,1223,431,711,1254,540
78014,4811,2602,2209,861,1400,341,812,974,423
78015,5631,2768,2863,790,1361,617,789,1538,536
78016,9025,4415,4610,1538,2141,736,1541,2193,876
78017,5312,3416,1896,909,2276,231,738,862,296
78019,869,449,420,138,243,68,139,215,66
78021,117,50,67,10,19,21,14,30,23
78022,4789,2356,2433,842,993,521,764,1107,562
78023,7656,3788,3868,1257,2062,469,1131,2163,574
78024,1208,644,564,202,298,144,130,316,118
78025,4937,2404,2533,767,1060,577,625,1241,667
78026,5068,2474,2594,989,1180,305,882,1278,434
78027,320,162,158,48,79,35,14,103,41
78028,33928,15933,17995,4470,6559,4904,4213,7532,6250
78039,1663,836,827,332,398,106,307,396,124
78040,43188,20253,22935,8648,8880,2725,8619,9718,4598
78041,39404,19183,20221,7750,9515,1918,7368,10232,2621
78043,34687,16513,18174,7398,7519,1596,7272,8539,2363
78045,29712,14388,15324,6428,7280,680,6271,8129,924
78046,43841,21590,22251,11538,9071,981,10773,10241,1237
78050,670,395,275,187,154,54,111,135,29
78052,5273,2663,2610,1078,1243,342,931,1327,352
78053,81,48,33,17,20,11,0,22,11
78055,1342,654,688,203,280,171,210,296,182
78056,916,506,410,157,242,107,100,258,52
78057,813,428,385,114,226,88,89,205,91
78058,498,250,248,63,124,63,82,142,24
78059,4941,2537,2404,981,1165,391,878,1147,379
78061,9787,4982,4805,2018,2318,646,1765,2121,919
78063,7598,3765,3833,1096,1986,683,1118,2082,633
78064,12612,6077,6535,2195,3083,799,2287,3131,1117
78065,9394,4536,4858,1887,2032,617,1942,2235,681
78066,578,302,276,138,131,33,121,122,33
78067,0,0,0,0,0,0,0,0,0
78069,4581,2240,2341,948,1034,258,902,1130,309
78070,7482,3602,3880,1192,1950,460,1290,2127,463
78071,4844,3071,1773,679,2054,338,543,843,387
78072,615,296,319,67,152,77,92,142,85
78073,7019,3586,3433,1521,1667,398,1264,1810,359
78074,25,17,8,0,9,8,0,0,8
78075,125,72,53,23,21,28,0,29,24
78076,12123,6002,6121,2432,2539,1031,2348,2645,1128
78101,6393,3160,3233,1135,1645,380,1048,1687,498
78102,28768,17484,11284,4754,11131,1599,4042,5202,2040
78107,257,142,115,25,63,54,23,52,40
78108,9286,4416,4870,1427,2351,638,1623,2580,667
78109,23496,11428,12068,4475,6132,821,4258,6901,909
78112,6494,3173,3321,1328,1594,251,1372,1685,264
78113,1854,909,945,221,454,234,288,429,228
78114,16887,8334,8553,2870,4258,1206,2749,4467,1337
78116,209,120,89,29,66,25,3,39,47
78117,588,288,300,86,139,63,104,143,53
78118,4470,2465,2005,794,1310,361,583,901,521
78119,7641,5096,2545,952,3647,497,802,1146,597
78121,7089,3527,3562,1247,1757,523,1099,1892,571
78122,488,232,256,50,127,55,66,136,54
78123,2234,1104,1130,329,517,258,257,583,290
78124,4534,2185,2349,741,1078,366,760,1190,399
78125,49,23,26,3,14,6,11,12,3
78130,43908,21269,22639,7128,10657,3484,6514,11123,5002
78132,11115,5562,5553,1883,2794,885,1816,2832,905
78133,13409,6605,6804,1688,3330,1587,1664,3345,1795
78140,3282,1681,1601,666,739,276,528,672,401
78141,595,276,319,63,144,69,99,138,82
78142,228,117,111,25,56,36,30,52,29
78143,106,76,30,34,36,6,0,21,9
78144,25,14,11,3,11,0,6,5,0
78145,68,30,38,10,15,5,16,15,7
78146,663,306,357,112,133,61,150,145,62
78147,1888,947,941,390,451,106,325,471,145
78148,19002,9559,9443,3259,5150,1150,2943,5027,1473
78151,1470,718,752,250,313,155,251,311,190
78152,2330,1245,1085,397,677,171,297,614,174
78154,17378,8460,8918,2875,4620,965,2685,4901,1332
78155,39741,19380,20361,6764,9759,2857,6948,9617,3796
78159,970,451,519,122,208,121,151,201,167
78160,3696,1823,1873,605,870,348,643,835,395
78161,406,172,234,74,69,29,126,81,27
78163,7621,3906,3715,1364,2042,500,1055,2106,554
78164,3975,1916,2059,597,856,463,488,882,689
78201,47209,22756,24453,7959,11713,3084,7668,11525,5260
78202,11840,5755,6085,2221,2683,851,2198,2603,1284
78203,5962,2723,3239,1107,1260,356,1153,1449,637
78204,11943,5847,6096,2028,3013,806,2038,2791,1267
78205,1559,997,562,99,561,337,81,249,232
78207,56645,28715,27930,11229,14241,3245,10535,12478,4917
78208,5300,2730,2570,1134,1278,318,972,1177,421
78209,40635,18401,22234,5265,9632,3504,5415,10873,5946
78210,36665,17770,18895,6722,8581,2467,6368,8822,3705
78211,31180,15146,16034,6300,7004,1842,6160,7263,2611
78212,31335,15196,16139,4917,8280,1999,4680,8073,3386
78213,39568,18526,21042,5842,10024,2660,6293,10730,4019
78214,24025,11744,12281,4794,5294,1656,4317,5750,2214
78215,1247,608,639,108,452,48,152,386,101
78216,37328,18131,19197,5219,10234,2678,4825,10542,3830
78217,32546,15727,16819,4691,8825,2211,4796,9131,2892
78218,28330,13412,14918,4647,6927,1838,4653,7523,2742
78219,14162,6686,7476,2605,3066,1015,2392,3739,1345
78220,16790,7419,9371,2913,3080,1426,2806,4224,2341
78221,36591,17732,18859,6898,8540,2294,6919,9055,2885
78222,14912,7036,7876,2710,3487,839,2600,3970,1306
78223,43453,21115,22338,8240,10322,2553,7508,11076,3754
78224,14156,6839,7317,2741,3429,669,2750,3643,924
78225,13624,6611,7013,2625,3045,941,2302,3295,1416
78226,9268,4450,4818,1873,2074,503,2011,2200,607
78227,46621,24118,22503,11766,9891,2461,9092,10177,3234
78228,58129,27655,30474,10729,13089,3837,11001,14313,5160
78229,27276,13099,14177,3648,8024,1427,3686,8092,2399
78230,35585,16839,18746,4939,9168,2732,4884,10337,3525
78231,7419,3412,4007,1117,1775,520,1125,2224,658
78232,33726,16463,17263,4800,9351,2312,4342,9987,2934
78233,36020,17200,18820,5814,9447,1939,5684,10672,2464
78234,5470,3008,2462,1457,1542,9,1217,1245,0
78235,773,385,388,222,163,0,210,178,0
78236,1251,651,600,325,323,3,300,297,3
78237,36292,17515,18777,7209,8021,2285,7258,7998,3521
78238,20216,9733,10483,3465,5103,1165,3317,5613,1553
78239,24864,11720,13144,4167,5311,2242,3928,6222,2994
78240,44340,21308,23032,6860,12568,1880,5915,14105,3012
78242,28776,14028,14748,6569,6339,1120,6426,7110,1212
78244,17852,8714,9138,3767,4409,538,3418,5220,500
78245,30921,14844,16077,5852,7783,1209,6061,8528,1488
78247,39689,18611,21078,6350,10924,1337,6964,12336,1778
78248,13346,6490,6856,2101,3724,665,2104,4184,568
78249,34202,16744,17458,6057,9387,1300,5913,9986,1559
78250,66615,32201,34414,13027,17473,1701,12458,19725,2231
78251,26120,12857,13263,4618,7576,663,4450,8082,731
78252,3894,2983,911,453,2284,246,325,441,145
78253,9664,4732,4932,1675,2586,471,1638,2835,459
78254,1448,719,729,256,349,114,235,331,163
78255,3196,1612,1584,460,918,234,389,980,215
78256,3713,1790,1923,595,1053,142,844,969,110
78257,2326,1185,1141,355,642,188,289,620,232
78258,17546,8599,8947,3206,4686,707,3068,5044,835
78259,9342,4527,4815,1719,2503,305,1776,2711,328
78260,2544,1332,1212,414,827,91,328,754,130
78261,1130,600,530,213,345,42,200,278,52
78263,4076,2006,2070,626,1108,272,644,1091,335
78264,7641,3879,3762,1498,1931,450,1379,1881,502
78266,3325,1659,1666,487,764,408,432,891,343
78330,1039,537,502,219,253,65,177,235,90
78332,28366,13757,14609,5363,6467,1927,5277,6762,2570
78336,12452,6277,6175,2307,3006,964,1994,3048,1133
78338,97,68,29,33,24,11,6,19,4
78339,821,414,407,151,221,42,114,208,85
78340,368,175,193,42,96,37,59,96,38
78343,4703,2287,2416,850,1034,403,843,1139,434
78344,573,284,289,106,120,58,125,128,36
78347,85,53,32,19,19,15,13,16,3
78349,410,191,219,57,80,54,71,84,64
78351,844,414,430,175,189,50,143,216,71
78352,82,49,33,23,13,13,6,16,11
78353,640,370,270,120,147,103,106,117,47
78355,7615,3651,3964,1547,1522,582,1368,1768,828
78357,3094,1490,1604,550,702,238,673,693,238
78358,1171,622,549,127,292,203,120,257,172
78359,2368,1160,1208,475,547,138,457,575,176
78361,5281,2578,2703,947,1199,432,937,1193,573
78362,10123,5460,4663,2008,2975,477,1788,2379,496
78363,29920,14911,15009,5792,7468,1651,5279,7215,2515
78364,201,99,102,24,38,37,14,53,35
78368,10125,4898,5227,1755,2159,984,1818,2290,1119
78369,733,370,363,183,135,52,150,154,59
78370,4863,2278,2585,845,1156,277,968,1250,367
78371,434,200,234,81,86,33,101,98,35
78372,4596,2258,2338,847,1121,290,805,1170,363
78373,3452,1815,1637,432,968,415,338,921,378
78374,15535,7700,7835,3001,3859,840,2781,4087,967
78375,3566,1804,1762,671,807,326,580,782,400
78376,93,41,52,4,18,19,12,19,21
78377,3905,1850,2055,597,867,386,633,865,557
78379,1411,726,685,255,327,144,232,298,155
78380,23229,11333,11896,4559,5261,1513,4508,5607,1781
78382,18155,8878,9277,2525,3936,2417,2410,4294,2573
78383,3106,1665,1441,522,812,331,355,773,313
78384,10475,5296,5179,1842,2661,793,1780,2238,1161
78385,281,130,151,42,63,25,50,67,34
78387,9883,4997,4886,1921,2392,684,1642,2342,902
78389,1897,1002,895,398,439,165,290,433,172
78390,6371,3163,3208,1275,1443,445,1206,1453,549
78391,319,161,158,55,86,20,37,84,37
78393,2564,1277,1287,407,612,258,391,624,272
78401,4713,2268,2445,668,1268,332,700,1219,526
78402,410,226,184,33,107,86,21,100,63
78404,16934,8325,8609,2854,4428,1043,2555,4197,1857
78405,17319,8113,9206,3294,3618,1201,3281,3998,1927
78406,1871,1445,426,352,1035,58,156,227,43
78407,4157,2083,2074,940,915,228,719,982,373
78408,10782,5252,5530,1982,2571,699,2005,2591,934
78409,2667,1290,1377,505,657,128,551,661,165
78410,23782,11594,12188,4462,5968,1164,4135,6485,1568
78411,27861,13279,14582,4443,6732,2104,4212,7246,3124
78412,34104,16281,17823,5572,8439,2270,5817,8823,3183
78413,34388,17076,17312,5832,9544,1700,5374,9879,2059
78414,15336,7317,8019,2538,4169,610,2457,4453,1109
78415,38650,19013,19637,7970,8968,2075,6734,9963,2940
78416,16424,7833,8591,3144,3449,1240,2900,3783,1908
78417,3144,1500,1644,605,699,196,709,737,198
78418,26454,13613,12841,4321,7537,1755,4072,7150,1619
78501,58414,27092,31322,10209,13054,3829,10673,14897,5752
78503,17427,8377,9050,3459,3896,1022,3286,4554,1210
78504,32683,15898,16785,6211,8234,1453,5916,9262,1607
78516,25305,12334,12971,5313,5032,1989,5299,5427,2245
78520,48427,22540,25887,9407,9977,3156,9054,12027,4806
78521,84738,39800,44938,18155,17730,3915,18574,21034,5330
78526,26289,12630,13659,5876,5774,980,5761,6844,1054
78537,30913,15063,15850,6764,6062,2237,6524,6834,2492
78538,7529,3654,3875,1602,1664,388,1679,1740,456
78539,87687,44326,43361,19206,21296,3824,18194,20766,4401
78543,7447,3620,3827,1652,1528,440,1645,1671,511
78545,68,23,45,0,23,0,25,20,0
78547,1236,620,616,241,320,59,274,284,58
78548,1622,799,823,347,339,113,318,363,142
78549,839,426,413,195,177,54,163,191,59
78550,51063,24160,26903,9707,10898,3555,9388,12511,5004
78552,29914,14298,15616,5173,6120,3005,5460,6945,3211
78557,7857,3682,4175,1827,1567,288,1797,1958,420
78558,2704,1305,1399,678,504,123,669,654,76
78559,9058,4314,4744,1752,1766,796,1625,2070,1049
78560,3904,1883,2021,853,848,182,811,965,245
78562,2050,1000,1050,489,438,73,452,456,142
78563,387,173,214,72,78,23,105,94,15
78565,445,157,288,66,58,33,97,117,74
78566,12267,6255,6012,2890,2767,598,2393,2902,717
78569,5291,2543,2748,999,1136,408,1011,1269,468
78570,29351,14119,15232,6624,5957,1538,6660,6612,1960
78572,113935,55102,58833,24772,23821,6509,24441,26786,7606
78575,3597,1736,1861,619,849,268,640,923,298
78576,3622,1779,1843,828,793,158,899,804,140
78577,47445,22479,24966,9692,9533,3254,9950,11018,3998
78578,9825,4793,5032,1696,2254,843,1797,2364,871
78579,3458,1709,1749,871,681,157,843,776,130
78580,13915,7312,6603,2904,3565,843,2528,3025,1050
78582,33329,16278,17051,7629,7093,1556,7167,7760,2124
78583,5054,2457,2597,925,1049,483,930,1137,530
78584,17148,8141,9007,3858,3353,930,3729,4076,1202
78586,45999,22172,23827,9632,9593,2947,9377,10821,3629
78588,194,102,92,39,49,14,36,42,14
78589,29044,14039,15005,6495,6203,1341,6334,7114,1557
78592,1709,817,892,360,354,103,380,384,128
78593,4302,2065,2237,949,844,272,941,986,310
78594,634,297,337,136,144,17,189,110,38
78595,5270,2613,2657,1274,1171,168,1229,1230,198
78596,51504,24779,26725,10878,10629,3272,10584,11777,4364
78597,2868,1492,1376,210,806,476,212,807,357
78598,385,201,184,27,70,104,23,83,78
78602,18088,9722,8366,2831,5751,1140,2391,4647,1328
78605,3722,1869,1853,559,967,343,497,998,358
78606,4192,2056,2136,682,936,438,556,1106,474
78607,205,82,123,21,7,54,0,35,88
78608,319,157,162,56,75,26,61,68,33
78609,2209,1048,1161,92,462,494,190,469,502
78610,13335,6634,6701,2514,3569,551,2286,3772,643
78611,10745,4979,5766,1531,2350,1098,1409,2843,1514
78612,8783,4377,4406,1647,2326,404,1497,2408,501
78613,34198,16985,17213,6379,9753,853,6007,10138,1068
78614,420,206,214,73,101,32,72,104,38
78615,1272,626,646,258,295,73,224,309,113
78616,4395,2326,2069,854,1210,262,675,1120,274
78617,15372,9006,6366,3266,5105,635,2361,3502,503
78618,232,97,135,12,41,44,30,59,46
78619,1570,831,739,264,462,105,185,398,156
78620,9583,4894,4689,1793,2627,474,1406,2714,569
78621,16182,8025,8157,2970,4001,1054,2824,4221,1112
78622,424,192,232,77,76,39,86,108,38
78623,191,110,81,12,60,38,16,36,29
78624,18279,8553,9726,2267,3854,2432,2296,4157,3273
78626,19458,9636,9822,3631,4969,1036,3538,4750,1534
78628,25709,12642,13067,3760,5997,2885,3486,6296,3285
78629,11302,5432,5870,1871,2567,994,1808,2643,1419
78631,1799,917,882,254,445,218,246,426,210
78632,661,322,339,109,92,121,79,158,102
78634,3904,2000,1904,733,1156,111,684,1079,141
78635,82,48,34,5,27,16,9,16,9
78636,3230,1621,1609,512,807,302,416,764,429
78638,1783,1006,777,295,478,233,213,405,159
78639,5599,2738,2861,655,1065,1018,519,1092,1250
78640,15977,8191,7786,3231,4474,486,3019,4225,542
78641,18900,9498,9402,3353,5379,766,3252,5327,823
78642,6112,2980,3132,1091,1547,342,1056,1637,439
78643,5836,2820,3016,739,1365,716,669,1427,920
78644,15295,7495,7800,2475,4028,992,2431,4001,1368
78645,7598,3708,3890,931,2013,764,1043,1952,895
78648,7250,3390,3860,1290,1459,641,1228,1628,1004
78650,1122,550,572,187,304,59,181,313,78
78652,3217,1727,1490,522,978,227,372,934,184
78653,4617,2385,2232,840,1275,270,648,1259,325
78654,17979,8714,9265,2450,4171,2093,2440,4431,2394
78655,2195,1127,1068,362,629,136,340,585,143
78656,2258,1197,1061,491,639,67,379,577,105
78657,1076,540,536,51,223,266,55,239,242
78658,70,42,28,7,29,6,5,14,9
78659,2888,1449,1439,432,886,131,430,806,203
78660,34618,17403,17215,7033,9684,686,6085,10138,992
78661,287,155,132,52,77,26,36,66,30
78662,2021,1039,982,317,558,164,309,499,174
78663,397,209,188,45,115,49,56,95,37
78664,46099,22743,23356,8323,13303,1117,8394,13282,1680
78666,51907,26251,25656,10273,14013,1965,10719,12297,2640
78669,5526,2852,2674,728,1602,522,626,1574,474
78670,32,32,0,0,24,8,0,0,0
78671,596,334,262,79,145,110,36,142,84
78672,1090,553,537,72,216,265,45,226,266
78675,144,68,76,14,19,35,20,33,23
78676,9076,4365,4711,1147,2150,1068,1134,2285,1292
78681,32196,16132,16064,6174,8978,980,5690,9223,1151
78701,3780,2386,1394,287,1857,242,276,784,334
78702,22498,11209,11289,4212,5630,1367,4145,5004,2140
78703,19522,9743,9779,2120,6623,1000,1913,6548,1318
78704,43343,22523,20820,5832,15170,1521,5133,13433,2254
78705,26972,14171,12801,7806,6126,239,8198,4372,231
78717,8209,4094,4115,1615,2304,175,1451,2404,260
78719,1791,949,842,416,476,57,291,507,44
78721,10192,5011,5181,2047,2371,593,1852,2359,970
78722,6264,3281,2983,753,2202,326,577,1870,536
78723,30196,15463,14733,5571,8554,1338,5250,7619,1864
78724,15038,7879,7159,3371,4103,405,2951,3676,532
78725,2187,1098,1089,456,615,27,397,620,72
78726,6547,3095,3452,1130,1846,119,1299,2022,131
78727,22332,11280,11052,3001,7595,684,2863,7403,786
78728,17342,8637,8705,2219,6171,247,2320,5836,549
78729,24539,12384,12155,3632,8156,596,3677,7681,797
78730,4848,2488,2360,704,1627,157,664,1579,117
78731,24068,11754,12314,2488,7258,2008,2539,7118,2657
78732,3804,2029,1775,574,1347,108,478,1180,117
78733,9144,4596,4548,1843,2576,177,1701,2685,162
78734,12800,6603,6197,1977,3585,1041,1574,3507,1116
78735,9563,4812,4751,1060,3253,499,1205,3050,496
78736,7011,3288,3723,923,2086,279,1141,2135,447
78737,7247,3662,3585,1147,2047,468,1060,2072,453
78738,2886,1444,1442,397,714,333,326,736,380
78739,8708,4436,4272,1831,2309,296,1582,2405,285
78741,40678,22278,18400,8313,13368,597,7701,9850,849
78742,630,324,306,116,180,28,123,142,41
78744,34028,17249,16779,7355,9239,655,6973,8887,919
78745,53136,26604,26532,8212,16158,2234,8060,15196,3276
78746,25768,12966,12802,4355,7478,1133,4096,7268,1438
78747,4908,2447,2461,724,1219,504,546,1365,550
78748,25138,11977,13161,4003,7340,634,4086,8139,936
78749,28420,13966,14454,4442,8853,671,4332,9120,1002
78750,23563,11669,11894,3756,6760,1153,3532,6964,1398
78751,13829,7487,6342,1541,5588,358,1505,4345,492
78752,17978,9865,8113,3136,6111,618,2843,4305,965
78753,43788,22631,21157,8107,13230,1294,7135,12058,1964
78754,5517,2727,2790,729,1678,320,829,1629,332
78756,7253,3545,3708,570,2661,314,649,2367,692
78757,21434,10485,10949,2404,6597,1484,2257,6253,2439
78758,42977,22728,20249,6501,15002,1225,5676,12813,1760
78759,40327,20114,20213,4302,13890,1922,4407,13117,2689
78801,21764,10417,11347,4179,4635,1603,4169,5095,2083
78827,1485,724,761,309,304,111,278,331,152
78828,423,241,182,65,86,90,29,95,58
78829,1428,678,750,308,303,67,335,332,83
78830,742,342,400,105,161,76,129,177,94
78832,3313,1640,1673,479,648,513,491,665,517
78833,1537,744,793,235,287,222,235,341,217
78834,7682,3793,3889,1551,1726,516,1456,1765,668
78836,135,70,65,18,42,10,14,27,24
78837,460,231,229,77,121,33,82,105,42
78838,189,109,80,42,40,27,15,41,24
78839,8466,4184,4282,1718,1873,593,1646,1851,785
78840,44239,21723,22516,8376,10516,2831,8008,10887,3621
78850,1172,621,551,197,302,122,176,245,130
78851,57,32,25,16,9,7,7,16,2
78852,46088,22074,24014,9924,9694,2456,9805,10940,3269
78860,298,158,140,72,58,28,50,75,15
78861,11388,6135,5253,1716,3558,861,1753,2498,1002
78870,869,439,430,175,196,68,196,186,48
78872,1697,849,848,346,404,99,293,407,148
78873,1435,713,722,197,317,199,156,327,239
78877,820,442,378,180,183,79,86,227,65
78879,180,94,86,28,30,36,14,33,39
78880,1650,830,820,313,353,164,263,378,179
78881,2132,1061,1071,351,498,212,336,480,255
78883,257,138,119,33,61,44,25,59,35
78884,1313,658,655,200,281,177,152,323,180
78885,206,102,104,15,49,38,20,51,33
78886,574,300,274,106,139,55,65,110,99
78932,486,228,258,52,111,65,66,101,91
78933,847,389,458,136,188,65,180,160,118
78934,7077,3448,3629,1133,1681,634,1014,1604,1011
78935,584,295,289,123,137,35,108,134,47
78938,335,157,178,50,74,33,46,83,49
78940,1873,950,923,259,469,222,248,428,247
78941,2291,1144,1147,388,522,234,329,481,337
78942,8381,4345,4036,1789,1933,623,1350,1772,914
78943,345,184,161,86,62,36,50,63,48
78944,654,324,330,92,163,69,109,168,53
78945,10149,4799,5350,1415,2276,1108,1491,2340,1519
78946,967,461,506,128,204,129,149,217,140
78947,4015,1963,2052,634,1026,303,569,1083,400
78948,979,467,512,141,235,91,170,239,103
78949,522,265,257,41,135,89,41,121,95
78950,1559,758,801,212,360,186,160,443,198
78953,625,314,311,46,183,85,40,189,82
78954,896,433,463,95,203,135,79,217,167
78956,5125,2479,2646,779,1170,530,671,1142,833
78957,8417,4107,4310,1379,2016,712,1183,2209,918
78959,1572,824,748,267,397,160,207,345,196
78960,70,37,33,4,14,19,0,20,13
78962,4016,1869,2147,526,862,481,615,906,626
78963,465,221,244,43,124,54,78,133,33
79001,255,133,122,33,60,40,27,57,38
79002,65,27,38,0,15,12,14,15,9
79003,167,74,93,27,31,16,25,41,27
79005,1509,753,756,288,361,104,238,352,166
79007,15779,7666,8113,2763,3657,1246,2646,3724,1743
79009,2201,1144,1057,530,504,110,432,469,156
79010,801,481,320,303,169,9,147,145,28
79011,313,159,154,61,81,17,41,77,36
79012,476,233,243,97,87,49,98,112,33
79013,2756,1480,1276,759,660,61,627,591,58
79014,3272,1665,1607,627,772,266,434,809,364
79015,16587,8098,8489,3253,3971,874,3325,4041,1123
79018,515,248,267,82,124,42,77,135,55
79019,1972,961,1011,306,448,207,285,462,264
79021,162,93,69,35,41,17,18,36,15
79022,9905,5513,4392,1429,3436,648,1531,2078,783
79024,365,176,189,43,82,51,52,86,51
79025,76,44,32,10,20,14,5,27,0
79027,5346,2617,2729,981,1290,346,1008,1195,526
79029,15131,7360,7771,2682,3630,1048,2911,3524,1336
79031,1311,593,718,209,279,105,273,303,142
79032,158,78,80,24,39,15,22,45,13
79033,105,53,52,17,18,18,5,19,28
79034,549,254,295,85,113,56,61,132,102
79035,5137,2509,2628,976,1200,333,927,1215,486
79036,5494,2697,2797,884,1257,556,785,1368,644
79039,840,437,403,148,197,92,125,177,101
79040,1934,979,955,364,451,164,332,434,189
79041,3376,1650,1726,657,700,293,587,767,372
79042,1121,580,541,153,332,95,175,234,132
79043,1656,849,807,352,386,111,315,356,136
79044,569,321,248,146,134,41,68,144,36
79045,18463,9008,9455,3740,4068,1200,3584,4193,1678
79046,634,319,315,88,159,72,79,141,95
79051,23,12,11,2,8,2,0,9,2
79052,1455,736,719,263,335,138,249,333,137
79053,163,70,93,22,41,7,38,49,6
79054,728,358,370,108,179,71,113,168,89
79056,44,22,22,4,11,7,2,14,6
79057,1190,542,648,138,239,165,148,224,276
79059,700,351,349,104,177,70,91,168,90
79061,310,147,163,41,68,38,36,87,40
79062,266,150,116,55,75,20,37,59,20
79063,848,459,389,180,217,62,144,172,73
79064,2969,1430,1539,572,583,275,548,612,379
79065,20751,10633,10118,3179,5586,1868,2795,4667,2656
79068,3276,1605,1671,543,730,332,508,801,362
79070,8649,4252,4397,1512,2198,542,1592,2097,708
79072,28687,14553,14134,5472,7093,1988,5269,6241,2624
79078,357,192,165,46,100,46,41,95,29
79079,2813,1368,1445,440,591,337,341,618,486
79080,810,402,408,122,199,81,108,204,96
79081,3524,1662,1862,541,815,306,577,796,489
79082,213,112,101,37,50,25,25,57,19
79083,2647,1329,1318,470,653,206,382,665,271
79084,2350,1175,1175,419,570,186,375,561,239
79086,2119,1019,1100,405,491,123,411,505,184
79087,761,372,389,120,206,46,132,216,41
79088,6226,3230,2996,1120,1530,580,993,1250,753
79091,146,81,65,30,45,6,14,37,14
79092,1207,564,643,188,273,103,215,295,133
79093,36,20,16,0,12,8,4,12,0
79095,2824,1351,1473,474,571,306,434,603,436
79096,1952,943,1009,318,428,197,299,452,258
79097,1266,619,647,208,308,103,203,301,143
79098,495,237,258,75,104,58,95,102,61
79101,2930,1447,1483,407,865,175,421,595,467
79102,9639,4555,5084,1578,2309,668,1592,2520,972
79103,9953,4744,5209,1820,2314,610,1865,2587,757
79104,7560,3674,3886,1581,1755,338,1524,1848,514
79106,27964,13035,14929,4158,6531,2346,4090,6899,3940
79107,34290,17814,16476,6933,9230,1651,6373,7749,2354
79108,13789,7726,6063,2011,4832,883,1808,3281,974
79109,45994,21939,24055,6858,11661,3420,7130,12185,4740
79110,17876,8723,9153,3216,4558,949,2904,4884,1365
79111,1758,908,850,443,442,23,419,389,42
79118,12713,6403,6310,2340,3313,750,2077,3455,778
79119,3878,1876,2002,563,959,354,645,1011,346
79121,6362,3123,3239,975,1575,573,793,1735,711
79124,5150,2497,2653,690,1310,497,725,1366,562
79201,7730,4677,3053,1330,2616,731,762,1449,842
79220,168,84,84,18,38,28,19,41,24
79223,30,17,13,4,6,7,2,5,6
79225,1118,539,579,189,232,118,180,251,148
79226,3207,1537,1670,494,599,444,472,689,509
79227,1704,794,910,240,353,201,246,373,291
79229,469,220,249,67,106,47,58,110,81
79230,159,81,78,12,42,27,11,35,32
79231,127,59,68,38,13,8,29,32,7
79232,47,22,25,4,10,8,3,12,10
79233,159,75,84,21,39,15,27,38,19
79234,170,78,92,23,23,32,31,28,33
79235,4599,2266,2333,890,959,417,724,1030,579
79236,220,106,114,50,43,13,40,67,7
79237,571,280,291,103,124,53,96,115,80
79239,266,148,118,55,64,29,34,59,25
79240,89,43,46,17,20,6,7,16,23
79241,2949,1393,1556,533,621,239,555,668,333
79243,94,57,37,7,18,32,5,18,14
79244,853,427,426,150,166,111,113,187,126
79245,2646,1218,1428,417,499,302,401,624,403
79247,97,36,61,8,20,8,17,21,23
79248,1814,842,972,264,351,227,238,390,344
79250,1618,794,824,296,361,137,280,379,165
79251,62,31,31,5,10,16,0,12,19
79252,3653,1732,1921,565,789,378,517,812,592
79255,590,270,320,82,128,60,105,136,79
79256,342,159,183,38,79,42,40,68,75
79257,1185,598,587,206,254,138,178,227,182
79259,28,10,18,0,5,5,0,5,13
79261,636,286,350,88,133,65,119,114,117
79311,3531,1710,1821,636,753,321,558,850,413
79312,984,461,523,198,184,79,176,233,114
79313,1727,849,878,314,402,133,310,392,176
79314,151,81,70,33,24,24,25,27,18
79316,11363,5991,5372,2042,3058,891,1739,2372,1261
79320,104,62,42,35,21,6,19,16,7
79322,2218,1010,1208,366,467,177,402,510,296
79323,5800,2788,3012,1065,1378,345,1105,1464,443
79324,92,50,42,13,22,15,15,20,7
79325,2294,1128,1166,411,529,188,406,489,271
79326,39,20,19,0,0,20,3,0,16
79329,3072,1475,1597,543,730,202,515,781,301
79330,19,10,9,0,0,10,0,0,9
79331,14277,8016,6261,2270,4700,1046,1946,2805,1510
79336,16689,8046,8643,3151,3805,1090,3058,3966,1619
79339,7355,3590,3765,1293,1628,669,1174,1684,907
79342,428,197,231,81,84,32,98,104,29
79343,1889,960,929,373,444,143,338,451,140
79344,158,87,71,33,39,15,23,36,12
79345,1058,552,506,246,228,78,197,221,88
79346,2779,1343,1436,512,558,273,489,616,331
79347,6521,3123,3398,1092,1453,578,1227,1480,691
79350,542,298,244,138,125,35,71,138,35
79351,1591,790,801,283,335,172,272,345,184
79353,37,14,23,6,6,2,7,8,8
79355,1986,986,1000,384,463,139,391,449,160
79356,4947,2609,2338,912,1351,346,706,1098,534
79357,2808,1319,1489,517,573,229,543,630,316
79358,1317,665,652,242,315,108,210,296,146
79359,2985,1436,1549,572,622,242,545,689,315
79360,10570,5313,5257,2329,2366,618,2081,2389,787
79363,4931,2492,2439,987,1191,314,842,1238,359
79364,8208,3914,4294,1490,1752,672,1500,1899,895
79366,1453,702,751,144,399,159,176,421,154
79367,730,334,396,137,153,44,143,172,81
79369,124,60,64,28,27,5,24,34,6
79370,2192,1279,913,314,732,233,207,418,288
79371,1172,531,641,193,239,99,196,283,162
79372,1401,681,720,252,330,99,268,331,121
79373,3659,1814,1845,720,793,301,576,856,413
79376,68,36,32,9,16,11,6,18,8
79377,424,201,223,75,106,20,86,96,41
79378,229,108,121,31,57,20,44,51,26
79379,583,290,293,116,127,47,112,119,62
79380,183,85,98,33,34,18,26,52,20
79381,818,417,401,151,189,77,158,176,67
79382,4823,2368,2455,912,1203,253,837,1294,324
79383,356,173,183,78,78,17,80,90,13
79401,11254,6224,5030,2025,3739,460,1945,2698,387
79403,15101,7272,7829,3119,3154,999,2915,3599,1315
79404,10241,5584,4657,1929,3178,477,1836,2231,590
79405,3133,1529,1604,675,750,104,664,688,252
79406,4486,2336,2150,1959,377,0,1988,162,0
79407,17371,8422,8949,3091,4547,784,3119,4683,1147
79410,9566,4719,4847,1499,2505,715,1368,2465,1014
79411,5311,2663,2648,962,1452,249,849,1433,366
79412,14977,6963,8014,2840,3091,1032,2777,3667,1570
79413,20516,9552,10964,3022,4651,1879,2987,4981,2996
79414,16758,7896,8862,2676,4271,949,2939,4351,1572
79415,16279,8282,7997,3363,4132,787,2911,4003,1083
79416,23556,11069,12487,4134,5704,1231,4296,6204,1987
79423,24054,11679,12375,3853,6378,1448,3691,6954,1730
79424,26908,13099,13809,4227,7208,1664,3942,7699,2168
79501,3636,1758,1878,635,767,356,531,814,533
79502,1500,707,793,194,329,184,205,330,258
79503,275,124,151,46,59,19,67,62,22
79504,2912,1440,1472,430,673,337,359,684,429
79505,350,164,186,79,65,20,71,82,33
79506,782,369,413,74,130,165,98,179,136
79508,1125,548,577,188,282,78,183,304,90
79510,7652,3702,3950,1270,1756,676,1203,1891,856
79511,1438,732,706,257,308,167,188,344,174
79512,8463,5301,3162,1360,3292,649,857,1534,771
79517,196,99,97,38,42,19,27,44,26
79518,156,74,82,27,31,16,33,30,19
79519,22,4,18,0,2,2,2,4,12
79520,2630,1302,1328,473,540,289,366,571,391
79521,3847,1819,2028,548,775,496,496,832,700
79525,2906,1478,1428,498,717,263,440,752,236
79526,2330,1785,545,458,1166,161,142,242,161
79527,251,120,131,45,60,15,45,58,28
79528,611,287,324,64,138,85,66,132,126
79529,1444,680,764,210,290,180,218,307,239
79530,490,241,249,82,116,43,70,111,68
79532,966,442,524,157,196,89,148,203,173
79533,417,186,231,45,102,39,79,98,54
79534,216,107,109,25,49,33,35,44,30
79535,160,85,75,22,41,22,15,34,26
79536,5001,2414,2587,862,1196,356,757,1271,559
79537,86,49,37,18,20,11,3,17,17
79538,238,121,117,34,57,30,40,46,31
79539,256,120,136,35,56,29,38,55,43
79540,90,49,41,11,15,23,12,10,19
79541,775,367,408,142,173,52,119,209,80
79543,1232,563,669,147,251,165,189,259,221
79544,654,310,344,89,139,82,99,154,91
79545,1825,892,933,271,394,227,275,426,232
79546,2171,1027,1144,313,457,257,297,466,381
79547,817,403,414,130,166,107,103,180,131
79548,221,105,116,27,37,41,24,32,60
79549,13718,6411,7307,2278,2952,1181,2326,3238,1743
79553,4006,1906,2100,630,847,429,581,890,629
79556,13526,6551,6975,2327,3063,1161,2140,3245,1590
79560,183,78,105,23,35,20,32,34,39
79561,678,324,354,89,161,74,93,168,93
79562,2599,1318,1281,475,679,164,389,703,189
79563,1194,551,643,205,302,44,239,310,94
79565,276,128,148,38,69,21,46,66,36
79566,297,126,171,18,70,38,38,78,55
79567,3915,1896,2019,671,809,416,640,867,512
79601,24285,13892,10393,4346,8127,1419,4203,4197,1993
79602,19183,9671,9512,3270,5192,1209,2936,5018,1558
79603,23700,11270,12430,4216,5314,1740,4312,5631,2487
79605,32638,15276,17362,5459,7559,2258,5589,8256,3517
79606,18149,8847,9302,2808,4875,1164,2888,4918,1496
79607,4969,2753,2216,1375,1378,0,1154,1041,21
79701,25037,11707,13330,4666,5459,1582,5102,5665,2563
79703,18556,9028,9528,3594,4429,1005,3280,4931,1317
79705,28357,13602,14755,4726,6512,2364,4560,7127,3068
79706,15712,7579,8133,2891,3868,820,3146,4038,949
79707,26558,12911,13647,4512,6961,1438,4408,7209,2030
79713,603,304,299,110,132,62,82,138,79
79714,12971,6256,6715,2485,2846,925,2372,3184,1159
79718,711,344,367,114,169,61,120,165,82
79719,590,353,237,135,147,71,46,114,77
79720,32170,17564,14606,4943,9995,2626,4492,6763,3351
79730,329,166,163,60,93,13,68,74,21
79731,3836,1888,1948,791,842,255,702,953,293
79733,225,126,99,46,61,19,25,50,24
79734,1929,966,963,271,480,215,269,486,208
79735,14019,7866,6153,2733,4139,994,2184,2868,1101
79738,212,87,125,17,54,16,51,51,23
79739,1063,542,521,214,275,53,234,230,57
79740,36,21,15,7,6,8,0,12,3
79741,266,139,127,44,61,34,29,58,40
79742,527,227,300,77,112,38,100,127,73
79743,541,293,248,105,125,63,84,130,34
79744,1512,741,771,275,377,89,306,346,119
79745,6147,3007,3140,1062,1381,564,1059,1394,687
79748,224,119,105,43,57,19,40,46,19
79749,229,96,133,30,48,18,79,42,12
79752,2169,1043,1126,377,482,184,381,502,243
79754,67,29,38,6,20,3,10,21,7
79755,252,130,122,51,63,16,58,55,9
79756,8784,4313,4471,1519,2075,719,1426,2188,857
79758,1762,888,874,266,502,120,294,463,117
79759,27,27,0,6,11,10,0,0,0
79761,28889,13847,15042,4971,6792,2084,5295,6907,2840
79762,35928,17240,18688,6300,8590,2350,5971,9489,3228
79763,31883,15440,16443,6668,7025,1747,6231,8046,2166
79764,17366,8367,8999,3094,4281,992,3325,4477,1197
79765,4432,2188,2244,840,1020,328,748,1172,324
79766,2331,1310,1021,429,778,103,371,557,93
79772,11770,6270,5500,2415,2952,903,1996,2508,996
79776,56,17,39,8,5,4,24,15,0
79777,439,324,115,269,41,14,26,68,21
79778,903,438,465,141,203,94,139,221,105
79780,484,242,242,51,81,110,77,77,88
79781,372,241,131,70,139,32,38,65,28
79782,3585,1729,1856,711,743,275,650,839,367
79783,198,113,85,50,53,10,31,48,6
79785,104,62,42,10,41,11,11,24,7
79788,440,207,233,76,95,36,87,114,32
79789,974,444,530,175,217,52,190,270,70
79821,6472,3944,2528,1223,2475,246,1067,1208,253
79830,7204,3530,3674,1114,1791,625,1217,1684,773
79831,293,140,153,25,78,37,55,61,37
79834,88,46,42,10,36,0,9,23,10
79835,10643,5252,5391,2408,2274,570,2275,2625,491
79836,5174,2485,2689,1032,1163,290,1062,1347,280
79837,611,314,297,119,134,61,87,148,62
79838,8298,3977,4321,2021,1547,409,1808,2027,486
79839,1870,946,924,425,424,97,375,444,105
79842,500,258,242,59,148,51,53,132,57
79843,2656,1292,1364,399,625,268,429,581,354
79845,4500,2133,2367,929,878,326,980,1069,318
79846,148,66,82,27,10,29,37,27,18
79847,31,16,15,6,10,0,0,12,3
79848,948,474,474,153,200,121,129,217,128
79849,10748,5389,5359,2837,2151,401,2593,2443,323
79851,717,364,353,142,162,60,140,174,39
79852,703,385,318,121,202,62,96,185,37
79853,3086,1502,1584,793,623,86,794,696,94
79854,254,136,118,31,55,50,29,60,29
79855,2808,1397,1411,568,611,218,488,694,229
79901,13948,6636,7312,2829,2662,1145,2587,3000,1725
79902,22979,11001,11978,3597,5517,1887,3397,5925,2656
79903,19391,8792,10599,3040,4084,1668,3195,4774,2630
79904,33351,15888,17463,6585,7340,1963,6342,8316,2805
79905,28702,13453,15249,5465,5666,2322,5115,6617,3517
79906,6976,4476,2500,2224,2240,12,1293,1207,0
79907,55133,25781,29352,10971,11975,2835,10894,14394,4064
79908,1498,969,529,380,584,5,236,293,0
79912,64878,31283,33595,11217,16682,3384,10444,18316,4835
79915,42178,19607,22571,7369,8704,3534,7567,10051,4953
79922,8829,4139,4690,1533,2027,579,1501,2470,719
79924,57066,26652,30414,10534,12345,3773,10592,14652,5170
79925,41063,19573,21490,6444,10006,3123,6594,10403,4493
79927,54529,26675,27854,12332,12442,1901,11911,13730,2213
79930,27963,13123,14840,4897,6108,2118,4670,6853,3317
79932,16656,7930,8726,3197,3778,955,3276,4430,1020
79934,10061,4920,5141,2152,2572,196,2038,2879,224
79935,19457,8955,10502,3326,4601,1028,3678,5371,1453
79936,92136,44312,47824,19386,22447,2479,18622,25806,3396
79938,18379,10396,7983,4577,5262,557,3476,3942,565
80002,15997,7960,8037,2479,4714,767,2479,4469,1089
80003,36594,18241,18353,5983,10373,1885,5641,10513,2199
80004,36965,17867,19098,5747,9328,2792,5333,9631,4134
80005,24866,12048,12818,3790,6881,1377,3898,7257,1663
80007,5886,2964,2922,1052,1665,247,891,1775,256
80010,43364,22937,20427,8512,12748,1677,7670,10483,2274
80011,44951,22444,22507,8236,11693,2515,7567,11750,3190
80012,43504,21007,22497,6505,12010,2492,6497,12933,3067
80013,57347,28880,28467,10481,17145,1254,9769,17127,1571
80014,33343,15690,17653,4116,8924,2650,3425,9947,4281
80015,53839,26624,27215,10280,15261,1083,9678,16119,1418
80016,7713,3908,3805,1477,2111,320,1399,2159,247
80017,30246,14887,15359,4873,9268,746,5073,9443,843
80018,2788,1346,1442,549,712,85,595,778,69
80019,74,52,22,30,22,0,4,18,0
80020,47570,24244,23326,8528,13795,1921,7709,13291,2326
80021,27945,14034,13911,4673,8631,730,4474,8462,975
80022,27898,14255,13643,5280,7468,1507,5153,6594,1896
80024,221,126,95,27,69,30,17,47,31
80025,132,72,60,0,72,0,0,60,0
80026,25167,12266,12901,3823,7472,971,4085,7541,1275
80027,28382,14297,14085,4634,8944,719,4444,8780,861
80030,16709,8472,8237,2699,4765,1008,2481,4091,1665
80031,29668,14533,15135,4439,8621,1473,4417,8725,1993
80033,25052,11848,13204,3314,6251,2283,3111,6466,3627
80101,361,197,164,64,100,33,54,85,25
80102,4405,2230,2175,785,1244,201,750,1177,248
80103,2023,1023,1000,370,534,119,358,526,116
80104,30270,15413,14857,5444,8781,1188,4798,8772,1287
80105,1169,601,568,207,302,92,194,274,100
80106,3324,1690,1634,619,944,127,499,1037,98
80107,10749,5431,5318,1960,3081,390,1818,3193,307
80110,43507,21985,21522,6186,12674,3125,5741,11460,4321
80111,26135,13210,12925,4540,7454,1216,4154,7600,1171
80112,21574,10893,10681,3588,6147,1158,3072,6453,1156
80116,3574,1761,1813,488,1061,212,506,1110,197
80117,2174,1116,1058,362,621,133,326,602,130
80118,4152,2123,2029,642,1176,305,590,1203,236
80120,28918,13850,15068,4071,7608,2171,3833,7675,3560
80121,18283,8853,9430,2643,4708,1502,2638,4981,1811
80122,31868,15204,16664,4866,8157,2181,4951,9041,2672
80123,41963,20916,21047,6098,12420,2398,5880,12107,3060
80124,12606,6251,6355,2178,3729,344,1917,4032,406
80125,5550,2826,2724,883,1771,172,795,1756,173
80126,68449,33847,34602,11945,20362,1540,11788,20985,1829
80127,38595,19532,19063,7220,11229,1083,6530,11322,1211
80128,33954,16872,17082,5727,9552,1593,5364,10109,1609
80132,13584,6829,6755,2426,3631,772,2181,3840,734
80133,1613,822,791,291,499,32,239,473,79
80134,30540,15237,15303,5766,8747,724,5524,9057,722
80135,3614,1867,1747,528,1049,290,523,970,254
80136,2555,1301,1254,481,694,126,421,677,156
80137,834,431,403,120,249,62,94,251,58
80138,20174,9918,10256,3482,5684,752,3300,6075,881
80202,4348,2415,1933,111,1844,460,110,1172,651
80203,17165,9924,7241,879,8094,951,914,5477,850
80204,32820,16656,16164,6226,9147,1283,6460,7792,1912
80205,29518,15272,14246,5411,8415,1446,4754,7424,2068
80206,20133,9988,10145,1229,7674,1085,1315,7139,1691
80207,21308,9790,11518,3488,4999,1303,3494,5977,2047
80209,20692,10469,10223,1466,7623,1380,1324,7075,1824
80210,32074,15796,16278,3542,10342,1912,3248,9822,3208
80211,37941,19342,18599,6294,11088,1960,5610,10020,2969
80212,18769,8918,9851,2344,5379,1195,2103,5463,2285
80214,16145,8438,7707,2558,4963,917,2088,4402,1217
80215,29911,14604,15307,3961,8058,2585,3646,7782,3879
80216,10815,5784,5031,2417,2923,444,2110,2407,514
80218,18251,9719,8532,1193,7558,968,1134,6050,1348
80219,59693,30094,29599,11273,15580,3241,10254,14743,4602
80220,36314,19109,17205,4698,12740,1671,4289,10775,2141
80221,38197,19648,18549,6827,10469,2352,6301,9219,3029
80222,19837,9503,10334,2075,5796,1632,1916,5604,2814
80223,18890,10079,8811,3299,5747,1033,2897,4606,1308
80224,17927,8682,9245,2049,4892,1741,1805,4849,2591
80226,29770,14415,15355,4262,7901,2252,4303,7820,3232
80227,32301,15787,16514,4519,8970,2298,4197,9564,2753
80228,30482,15050,15432,4139,9129,1782,4205,9170,2057
80229,40631,20375,20256,7386,11287,1702,6964,11076,2216
80230,2115,1041,1074,351,625,65,337,622,115
80231,51891,24673,27218,5312,16135,3226,5273,16494,5451
80232,21734,10498,11236,2888,5782,1828,2887,6087,2262
80233,36777,18385,18392,6411,10362,1612,5761,10331,2300
80234,23371,11599,11772,3494,6935,1170,3410,7032,1330
80235,7252,3653,3599,1002,2148,503,999,2044,556
80236,15856,7937,7919,2346,4412,1179,2084,4132,1703
80237,16365,7810,8555,1466,4826,1518,1506,5009,2040
80239,28842,14505,14337,6199,7380,926,5757,7577,1003
80241,26677,13318,13359,4727,7912,679,4593,7829,937
80246,13217,6830,6387,1596,4610,624,1362,4142,883
80249,7898,3979,3919,1496,2391,92,1392,2418,109
80260,30417,15020,15397,5074,8114,1832,4842,8143,2412
80264,0,0,0,0,0,0,0,0,0
80290,0,0,0,0,0,0,0,0,0
80293,0,0,0,0,0,0,0,0,0
80294,0,0,0,0,0,0,0,0,0
80301,22618,11251,11367,3068,7084,1099,2729,7287,1351
80302,29753,15382,14371,6043,8326,1013,5857,7156,1358
80303,42096,21879,20217,5837,13510,2532,5692,11270,3255
80304,24338,12315,12023,3145,7899,1271,2988,7580,1455
80401,38780,20297,18483,6300,11469,2528,4930,10733,2820
80403,17107,9069,8038,2349,5855,865,2079,5124,835
80420,610,324,286,36,277,11,61,213,12
80421,8235,4110,4125,1218,2538,354,1274,2524,327
80422,365,184,181,38,137,9,50,111,20
80423,78,51,27,0,41,10,12,15,0
80424,7449,4416,3033,873,3358,185,633,2229,171
80425,142,78,64,24,47,7,32,32,0
80426,108,43,65,17,18,8,30,35,0
80427,457,247,210,53,159,35,31,141,38
80428,376,181,195,49,120,12,62,107,26
80430,21,13,8,5,8,0,0,8,0
80432,256,136,120,16,77,43,31,81,8
80433,8382,4219,4163,1200,2655,364,1135,2707,321
80434,78,37,41,5,27,5,8,25,8
80435,6527,3780,2747,879,2696,205,737,1833,177
80436,326,166,160,18,120,28,26,97,37
80438,532,300,232,53,213,34,70,131,31
80439,23556,11918,11638,3443,6988,1487,3164,6959,1515
80440,1702,954,748,261,631,62,206,467,75
80442,1475,851,624,238,549,64,98,468,58
80443,3263,1854,1409,414,1262,178,273,1029,107
80444,1272,645,627,168,414,63,143,401,83
80446,3372,1805,1567,615,989,201,485,930,152
80447,1787,946,841,184,589,173,164,511,166
80448,212,94,118,26,60,8,45,47,26
80449,727,402,325,89,226,87,51,205,69
80451,599,304,295,45,225,34,89,177,29
80452,2904,1519,1385,444,882,193,398,801,186
80454,962,452,510,104,261,87,136,304,70
80455,412,221,191,45,152,24,23,136,32
80456,484,255,229,28,164,63,42,127,60
80457,449,206,243,81,110,15,97,140,6
80459,2296,1184,1112,385,692,107,405,573,134
80461,7623,4089,3534,1393,2343,353,1191,1956,387
80463,226,109,117,35,65,9,27,65,25
80465,15236,7876,7360,2530,4669,677,2115,4624,621
80466,3089,1649,1440,375,1170,104,261,1060,119
80467,1825,883,942,193,606,84,307,570,65
80468,571,307,264,97,177,33,80,154,30
80469,304,159,145,37,84,38,26,89,30
80470,3355,1818,1537,608,970,240,338,987,212
80473,63,30,33,10,11,9,10,16,7
80474,301,159,142,19,140,0,9,113,20
80476,153,83,70,21,60,2,23,45,2
80478,708,347,361,57,252,38,68,264,29
80479,75,48,27,11,30,7,10,17,0
80480,1415,708,707,185,397,126,223,357,127
80481,708,372,336,96,257,19,77,224,35
80482,1629,860,769,129,652,79,154,531,84
80483,603,339,264,132,157,50,82,152,30
80487,14122,7719,6403,1969,5252,498,1626,4259,518
80498,6309,3601,2708,940,2495,166,751,1813,144
80501,55563,27661,27902,9475,15373,2813,8856,15019,4027
80503,25456,12514,12942,3973,7067,1474,3873,7230,1839
80504,8881,4414,4467,1412,2562,440,1458,2565,444
80510,401,252,149,9,208,35,15,86,48
80512,1994,1060,934,213,677,170,176,631,127
80513,10865,5402,5463,1722,3085,595,1740,3106,617
80514,3008,1484,1524,482,817,185,520,805,199
80515,847,432,415,104,245,83,121,224,70
80516,8514,4293,4221,1427,2553,313,1355,2609,257
80517,9129,4415,4714,862,2336,1217,999,2284,1431
80520,1304,648,656,213,387,48,242,368,46
80521,32761,16784,15977,7115,8732,937,7358,7171,1448
80524,26544,13450,13094,3854,7871,1725,3659,7268,2167
80525,42653,21233,21420,6670,12347,2216,6209,12122,3089
80526,42403,21134,21269,7191,12588,1355,7132,12209,1928
80528,5669,2873,2796,969,1710,194,816,1750,230
80530,2376,1205,1171,457,653,95,418,628,125
80532,136,68,68,17,27,24,6,45,17
80534,4842,2447,2395,860,1350,237,778,1383,234
80535,3208,1665,1543,483,1005,177,464,908,171
80536,1411,710,701,120,439,151,110,475,116
80537,34031,16684,17347,5428,8982,2274,5135,9183,3029
80538,35042,17365,17677,5812,9001,2552,5043,9404,3230
80540,3865,2003,1862,492,1262,249,437,1183,242
80542,870,445,425,190,230,25,159,234,32
80543,3192,1583,1609,615,840,128,650,817,142
80545,726,354,372,51,204,99,51,197,124
80547,184,100,84,33,60,7,23,49,12
80549,4853,2394,2459,773,1390,231,834,1425,200
80550,11451,5549,5902,1853,3177,519,2009,3247,646
80601,34300,17725,16575,6085,9788,1852,5489,8949,2137
80610,2373,1232,1141,487,600,145,357,600,184
80611,528,280,248,74,172,34,74,143,31
80612,155,77,78,20,50,7,13,45,20
80615,5532,2780,2752,984,1423,373,903,1350,499
80620,9863,4978,4885,2043,2651,284,1885,2532,468
80621,11655,6241,5414,2416,3193,632,1853,2859,702
80623,1163,644,519,294,310,40,210,267,42
80624,1071,530,541,183,275,72,201,237,103
80631,45870,22922,22948,9635,11131,2156,10003,9896,3049
80634,40455,19718,20737,6580,10526,2612,6312,10813,3612
80640,2294,1301,993,477,693,131,319,568,106
80642,3038,1598,1440,616,828,154,534,770,136
80643,1823,886,937,324,463,99,357,461,119
80644,2702,1335,1367,489,692,154,497,709,161
80645,3823,1918,1905,661,985,272,613,991,301
80648,724,371,353,144,171,56,113,181,59
80649,344,166,178,41,91,34,68,94,16
80650,1305,653,652,199,356,98,206,335,111
80651,4238,2115,2123,799,1105,211,772,1133,218
80652,609,345,264,107,201,37,64,139,61
80653,734,392,342,125,230,37,109,188,45
80654,2170,1106,1064,426,564,116,385,553,126
80701,15173,7555,7618,2662,3788,1105,2670,3510,1438
80705,1076,520,556,198,279,43,248,261,47
80720,2699,1303,1396,395,644,264,407,620,369
80721,203,84,119,27,43,14,45,50,24
80722,513,244,269,83,134,27,105,133,31
80723,7037,3451,3586,1202,1686,563,1236,1470,880
80726,371,197,174,56,97,44,61,67,46
80727,583,266,317,97,102,67,135,124,58
80728,926,456,470,164,176,116,161,206,103
80729,529,269,260,86,126,57,80,123,57
80731,1579,761,818,217,351,193,220,354,244
80733,398,198,200,72,90,36,94,88,18
80734,2955,1448,1507,503,652,293,461,680,366
80735,347,183,164,70,79,34,39,79,46
80736,702,332,370,112,164,56,135,169,66
80737,1824,874,950,245,395,234,250,388,312
80740,127,63,64,16,23,24,19,36,9
80741,875,427,448,145,180,102,141,210,97
80742,353,180,173,74,68,38,69,70,34
80743,1082,561,521,187,278,96,160,236,125
80744,482,237,245,51,111,75,53,109,83
80745,167,85,82,32,47,6,20,37,25
80747,526,272,254,87,141,44,67,136,51
80749,441,257,184,93,120,44,39,106,39
80750,445,201,244,70,118,13,101,114,29
80751,16461,8834,7627,2797,4748,1289,2441,3501,1685
80754,147,83,64,21,39,23,21,32,11
80755,162,88,74,32,29,27,21,20,33
80757,276,161,115,52,87,22,29,60,26
80758,3644,1756,1888,564,849,343,581,870,437
80759,4411,2156,2255,734,1070,352,713,1074,468
80801,168,82,86,28,39,15,29,39,18
80802,286,142,144,50,72,20,58,58,28
80804,414,211,203,63,99,49,62,96,45
80805,447,243,204,100,102,41,76,99,29
80807,4896,2687,2209,822,1491,374,661,1084,464
80808,6029,3009,3020,1109,1590,310,1109,1582,329
80809,1381,723,658,196,427,100,150,408,100
80810,1363,701,662,236,361,104,210,310,142
80812,243,123,120,27,67,29,43,45,32
80813,1954,990,964,281,574,135,262,584,118
80814,3531,1854,1677,486,1113,255,469,1017,191
80815,1022,517,505,176,230,111,131,226,148
80816,3410,1713,1697,495,948,270,407,1031,259
80817,16236,7932,8304,3144,4141,647,3214,4368,722
80818,369,186,183,61,83,42,54,82,47
80819,964,501,463,144,302,55,115,295,53
80820,722,369,353,61,188,120,57,220,76
80821,1230,600,630,201,295,104,173,319,138
80822,276,136,140,42,60,34,46,69,25
80823,308,153,155,62,68,23,58,69,28
80824,266,137,129,46,74,17,29,74,26
80825,533,249,284,89,98,62,86,108,90
80827,511,284,227,84,153,47,36,147,44
80828,3669,2224,1445,512,1486,226,496,637,312
80829,5605,2708,2897,640,1730,338,661,1821,415
80830,225,103,122,16,57,30,35,58,29
80831,10507,5440,5067,1966,3058,416,1726,2959,382
80832,681,329,352,98,167,64,110,176,66
80833,699,357,342,98,167,92,110,154,78
80834,359,188,171,44,96,48,41,84,46
80835,852,440,412,171,191,78,122,185,105
80836,1203,613,590,208,296,109,182,294,114
80840,7536,4947,2589,3248,1689,10,1393,1186,10
80860,592,284,308,72,172,40,87,179,42
80861,236,111,125,39,44,28,44,42,39
80862,49,28,21,5,18,5,2,16,3
80863,11288,5671,5617,1865,3293,513,1657,3365,595
80864,1169,619,550,236,310,73,199,297,54
80866,99,46,53,16,19,11,19,34,0
80903,15212,7628,7584,2362,4579,687,2547,3934,1103
80904,19506,9380,10126,2404,5390,1586,2199,5573,2354
80905,3394,1588,1806,387,1010,191,512,988,306
80906,48895,24228,24667,7662,13291,3275,7236,13126,4305
80907,27403,13482,13921,3542,7967,1973,3702,7343,2876
80908,9283,4646,4637,1554,2576,516,1472,2679,486
80909,37851,18235,19616,5610,9576,3049,5559,9428,4629
80910,26075,12730,13345,4784,6495,1451,4521,6472,2352
80911,29432,14338,15094,5390,7236,1712,5193,7672,2229
80913,10582,7099,3483,3475,3619,5,1695,1762,26
80915,20208,9948,10260,3325,5373,1250,3252,5610,1398
80916,33847,17087,16760,6927,9281,879,6507,9153,1100
80917,30300,14921,15379,4828,8531,1562,4665,8582,2132
80918,49626,24711,24915,8490,14132,2089,7837,14349,2729
80919,28298,14046,14252,4757,8104,1185,4398,8466,1388
80920,31888,16043,15845,6522,8566,955,5865,8822,1158
80921,8395,4190,4205,1440,2170,580,1335,2284,586
80922,13006,6551,6455,2521,3852,178,2452,3759,244
80925,2662,1422,1240,584,766,72,426,755,59
80926,1632,834,798,221,517,96,255,455,88
80928,1107,536,571,198,291,47,217,314,40
80929,231,123,108,56,50,17,38,58,12
80930,656,345,311,165,156,24,108,167,36
81001,30734,14626,16108,5279,7088,2259,5332,7393,3383
81003,14640,7613,7027,2152,4382,1079,1918,3663,1446
81004,26837,13049,13788,4438,6316,2295,3926,6580,3282
81005,27096,12739,14357,3968,5954,2817,3965,6684,3708
81006,11791,5881,5910,1880,2951,1050,1769,2958,1183
81007,17207,8657,8550,2913,4580,1164,2668,4811,1071
81008,6736,3261,3475,1114,1590,557,965,1738,772
81020,1007,506,501,128,231,147,127,228,146
81021,22,8,14,2,6,0,2,12,0
81022,1697,892,805,327,427,138,276,390,139
81023,1163,604,559,156,289,159,135,307,117
81024,128,66,62,3,42,21,15,30,17
81025,1077,538,539,139,266,133,142,312,85
81027,186,82,104,23,46,13,46,39,19
81029,452,234,218,86,110,38,52,108,58
81030,144,71,73,13,46,12,13,47,13
81033,168,86,82,33,33,20,26,39,17
81036,1082,533,549,168,258,107,145,245,159
81039,2002,955,1047,290,463,202,250,476,321
81040,542,311,231,94,186,31,55,134,42
81041,928,505,423,220,216,69,192,169,62
81043,90,41,49,12,20,9,14,22,13
81044,256,142,114,45,67,30,34,61,19
81045,137,77,60,25,37,15,22,27,11
81047,1970,1014,956,398,438,178,296,440,220
81049,277,151,126,41,69,41,17,65,44
81050,10854,5231,5623,1838,2499,894,1767,2581,1275
81052,10929,5441,5488,2013,2714,714,1968,2481,1039
81054,4888,2682,2206,624,1592,466,674,976,556
81055,1516,744,772,208,383,153,178,421,173
81057,486,252,234,97,120,35,84,127,23
81058,1111,539,572,181,246,112,190,256,126
81059,159,63,96,14,35,14,48,35,13
81062,1848,1426,422,201,1136,89,139,191,92
81063,2871,1923,948,355,1382,186,294,440,214
81064,377,188,189,51,82,55,48,75,66
81066,50,23,27,0,14,9,6,15,6
81067,6190,3147,3043,1033,1463,651,921,1435,687
81069,2547,1310,1237,404,609,297,305,698,234
81071,387,200,187,71,93,36,61,90,36
81073,2112,1029,1083,318,458,253,265,484,334
81076,499,238,261,74,122,42,67,135,59
81077,420,228,192,68,120,40,60,89,43
81081,77,31,46,7,14,10,14,21,11
81082,12636,6091,6545,1988,2895,1208,1879,2949,1717
81084,144,80,64,19,44,17,13,32,19
81087,178,79,99,18,34,27,38,33,28
81089,5600,3134,2466,757,1753,624,640,1134,692
81090,1315,680,635,209,325,146,179,278,178
81091,691,362,329,71,197,94,79,158,92
81092,863,439,424,168,222,49,129,231,64
81101,14033,6909,7124,2690,3352,867,2547,3521,1056
81120,2569,1295,1274,447,598,250,449,544,281
81121,257,144,113,44,73,27,23,79,11
81122,5464,2721,2743,832,1492,397,764,1601,378
81123,825,436,389,152,210,74,127,207,55
81124,205,117,88,35,77,5,42,46,0
81125,3619,1831,1788,748,841,242,710,859,219
81126,112,50,62,11,21,18,16,37,9
81127,34,21,13,0,7,14,0,8,5
81128,85,27,58,0,19,8,20,33,5
81130,788,398,390,93,226,79,82,203,105
81131,838,429,409,110,241,78,73,266,70
81132,3394,1710,1684,628,832,250,530,827,327
81133,815,390,425,124,178,88,124,190,111
81136,294,138,156,53,68,17,63,72,21
81137,4885,2496,2389,876,1330,290,840,1270,279
81140,2519,1218,1301,492,482,244,489,530,282
81141,1341,674,667,268,272,134,251,280,136
81143,581,294,287,78,172,44,85,158,44
81144,7898,3906,3992,1354,1858,694,1236,1922,834
81146,560,277,283,95,148,34,108,146,29
81147,9482,4855,4627,1529,2564,762,1243,2593,791
81148,443,229,214,113,89,27,77,108,29
81149,891,431,460,121,213,97,100,248,112
81151,1434,720,714,281,332,107,263,318,133
81152,1334,673,661,186,325,162,169,313,179
81153,356,167,189,57,67,43,55,92,42
81154,1136,578,558,113,275,190,123,275,160
81155,120,65,55,11,34,20,10,36,9
81201,8745,4338,4407,1204,2205,929,981,2194,1232
81210,227,127,100,56,60,11,39,49,12
81211,6489,3817,2672,828,2391,598,707,1354,611
81212,29144,16390,12754,3698,10106,2586,3554,5853,3347
81220,142,67,75,0,33,34,0,42,33
81221,185,91,94,37,38,16,27,53,14
81222,357,185,172,58,84,43,32,89,51
81223,1463,746,717,191,383,172,169,391,157
81224,2953,1634,1319,353,1222,59,304,979,36
81225,612,386,226,70,292,24,29,178,19
81226,9265,6142,3123,995,4514,633,924,1554,645
81230,9243,5004,4239,1865,2640,499,1497,2210,532
81233,905,456,449,95,210,151,83,247,119
81235,732,386,346,82,224,80,82,210,54
81236,1033,543,490,106,301,136,71,279,140
81239,164,95,69,18,57,20,4,45,20
81240,4524,2243,2281,740,1133,370,763,1160,358
81241,93,38,55,7,24,7,19,19,17
81243,46,21,25,0,10,11,0,25,0
81244,159,79,80,21,46,12,17,42,21
81248,39,39,0,0,39,0,0,0,0
81251,189,103,86,20,60,23,3,62,21
81252,3172,1639,1533,458,806,375,345,854,334
81253,349,165,184,36,103,26,52,96,36
81301,31614,16102,15512,5050,9079,1973,4670,8697,2145
81320,326,185,141,42,92,51,23,65,53
81321,13579,6598,6981,2244,3289,1065,2164,3426,1391
81323,4325,2199,2126,689,1123,387,630,1061,435
81324,1276,644,632,181,325,138,157,317,158
81325,128,65,63,18,33,14,13,34,16
81326,2014,1044,970,348,587,109,283,564,123
81327,558,277,281,102,103,72,76,147,58
81328,3528,1750,1778,515,858,377,438,934,406
81330,40,17,23,0,14,3,0,23,0
81331,239,134,105,41,73,20,21,64,20
81332,244,136,108,35,91,10,19,83,6
81334,1402,705,697,318,343,44,289,363,45
81335,226,97,129,24,62,11,58,52,19
81401,25899,12635,13264,4068,6206,2361,3869,6398,2997
81410,1560,769,791,220,363,186,199,385,207
81411,232,125,107,24,63,38,12,79,16
81413,4487,2265,2222,647,814,804,425,1001,796
81415,1397,700,697,220,322,158,205,347,145
81416,12133,6085,6048,1746,3198,1141,1888,2683,1477
81418,1515,713,802,123,277,313,166,304,332
81419,3925,1971,1954,566,990,415,512,1003,439
81422,803,409,394,119,210,80,97,192,105
81423,1305,681,624,223,386,72,162,388,74
81424,1289,621,668,211,287,123,236,281,151
81425,4591,2293,2298,802,1096,395,815,1101,382
81426,250,147,103,14,133,0,17,86,0
81427,992,498,494,128,268,102,123,255,116
81428,3600,1846,1754,572,921,353,466,877,411
81430,84,42,42,8,32,2,9,31,2
81431,347,169,178,37,97,35,60,87,31
81432,2133,1037,1096,258,612,167,280,640,176
81433,540,288,252,69,172,47,51,177,24
81434,183,106,77,22,53,31,7,34,36
81435,4923,2725,2198,524,2065,136,492,1609,97
81501,20842,10280,10562,3303,5449,1528,3172,4800,2590
81503,23376,11692,11684,3524,5975,2193,3192,6088,2404
81504,22177,10628,11549,3571,5225,1832,3661,5748,2140
81505,6993,3574,3419,1108,1906,560,907,1786,726
81506,9220,4161,5059,1042,1911,1208,1102,2198,1759
81520,12076,5714,6362,2086,2978,650,2333,3138,891
81521,9062,4489,4573,1630,2106,753,1355,2191,1027
81522,50,28,22,0,20,8,0,14,8
81523,646,298,348,80,187,31,134,188,26
81524,1443,735,708,209,410,116,218,396,94
81525,542,289,253,83,147,59,75,124,54
81526,5328,2704,2624,872,1269,563,703,1334,587
81527,1376,694,682,189,408,97,162,409,111
81601,12575,6335,6240,1975,3781,579,1862,3591,787
81610,511,251,260,106,115,30,108,128,24
81611,8872,4656,4216,770,3285,601,737,2964,515
81615,1832,992,840,205,691,96,188,606,46
81620,9952,5667,4285,1343,4180,144,1257,2918,110
81621,5087,2689,2398,839,1708,142,676,1559,163
81623,13381,6954,6427,1982,4427,545,2023,3815,589
81624,1404,722,682,291,310,121,242,315,125
81625,12150,6241,5909,2136,3356,749,1909,3216,784
81630,956,502,454,185,228,89,145,241,68
81631,4409,2253,2156,765,1341,147,723,1271,162
81632,8137,4418,3719,1260,2917,241,1125,2464,130
81635,4998,2468,2530,787,1131,550,741,1157,632
81637,4939,2629,2310,956,1568,105,895,1313,102
81638,223,130,93,27,81,22,38,52,3
81639,2209,1148,1061,410,638,100,384,576,101
81640,285,148,137,45,81,22,31,55,51
81641,3382,1697,1685,533,856,308,462,872,351
81642,102,83,19,7,62,14,0,19,0
81643,681,342,339,96,170,76,96,174,69
81645,934,490,444,123,327,40,136,275,33
81646,168,89,79,20,44,25,20,31,28
81647,4578,2350,2228,847,1348,155,765,1282,181
81648,2543,1310,1233,516,648,146,453,645,135
81649,285,158,127,23,121,14,32,73,22
81650,10398,5349,5049,1885,2946,518,1797,2681,571
81652,2936,1519,1417,465,898,156,449,807,161
81653,36,30,6,7,23,0,0,6,0
81654,1209,651,558,175,416,60,155,370,33
81655,56,38,18,0,29,9,0,10,8
81656,331,199,132,19,167,13,8,98,26
81657,5240,3070,2170,408,2447,215,301,1672,197
82001,34733,18066,16667,5427,10281,2358,4597,8786,3284
82007,15894,7732,8162,2708,4092,932,2809,4262,1091
82009,26975,13228,13747,4069,7311,1848,4029,7333,2385
82050,234,109,125,42,62,5,57,62,6
82051,38,12,26,0,0,12,0,8,18
82052,35,20,15,0,20,0,0,15,0
82053,978,474,504,164,238,72,161,254,89
82054,793,386,407,143,213,30,163,215,29
82055,123,62,61,10,46,6,5,42,14
82058,6,6,0,6,0,0,0,0,0
82059,77,42,35,17,6,19,19,7,9
82060,139,85,54,13,41,31,16,17,21
82061,24,7,17,0,7,0,11,6,0
82063,153,78,75,14,49,15,19,38,18
82070,16650,8416,8234,2934,4501,981,2848,4193,1193
82072,14608,7785,6823,3163,4104,518,2531,3688,604
82081,54,28,26,6,17,5,5,14,7
82082,1725,858,867,301,392,165,281,377,209
82083,378,217,161,82,99,36,24,97,40
82084,14,7,7,0,0,7,0,0,7
82190,60,33,27,9,22,2,9,16,2
82201,6540,3227,3313,955,1605,667,908,1606,799
82210,575,318,257,154,121,43,107,104,46
82212,490,243,247,57,112,74,55,124,68
82213,524,269,255,53,129,87,64,123,68
82214,1276,607,669,199,291,117,195,340,134
82215,180,83,97,27,33,23,27,44,26
82217,84,52,32,15,16,21,0,21,11
82218,361,176,185,51,92,33,77,78,30
82219,62,31,31,8,9,14,4,12,15
82221,468,223,245,83,100,40,101,110,34
82222,119,56,63,11,36,9,25,32,6
82223,1097,569,528,143,309,117,136,270,122
82224,73,33,40,3,12,18,9,25,6
82225,2012,981,1031,290,452,239,234,518,279
82227,209,109,100,23,48,38,25,36,39
82240,9288,4515,4773,1412,2198,905,1305,2257,1211
82242,50,21,29,6,13,2,10,14,5
82243,157,57,100,0,41,16,58,30,12
82244,366,187,179,51,98,38,42,93,44
82301,9893,5313,4580,1523,3230,560,1486,2378,716
82310,110,66,44,14,36,16,0,21,23
82321,637,342,295,109,150,83,77,164,54
82322,113,60,53,23,26,11,8,35,10
82323,101,57,44,13,35,9,10,15,19
82324,312,163,149,37,91,35,32,78,39
82325,822,428,394,93,217,118,76,212,106
82327,948,480,468,176,223,81,153,252,63
82329,376,205,171,67,94,44,40,87,44
82331,2335,1212,1123,293,684,235,309,588,226
82332,113,52,61,26,19,7,7,22,32
82335,37,37,0,0,19,18,0,0,0
82336,336,182,154,65,87,30,40,86,28
82401,7535,3700,3835,1249,1811,640,1157,1877,801
82410,1717,844,873,220,368,256,201,384,288
82411,668,347,321,182,121,44,149,129,43
82412,611,309,302,135,129,45,95,151,56
82414,14505,7108,7397,2076,3784,1248,1983,3909,1505
82420,730,346,384,123,167,56,136,174,74
82421,653,332,321,110,156,66,103,145,73
82422,146,70,76,22,41,7,35,33,8
82423,24,14,10,1,9,4,2,6,2
82426,2592,1312,1280,410,616,286,401,590,289
82428,130,65,65,9,35,21,15,35,15
82430,66,28,38,0,22,6,2,27,9
82431,3426,1704,1722,648,734,322,590,703,429
82432,358,191,167,76,85,30,48,86,33
82433,812,405,407,133,216,56,115,205,87
82434,216,102,114,48,38,16,42,53,19
82435,10214,4990,5224,1676,2440,874,1745,2313,1166
82440,75,24,51,5,13,6,25,16,10
82441,197,107,90,27,58,22,13,51,26
82442,771,403,368,125,159,119,86,186,96
82443,4816,2328,2488,622,1134,572,619,1137,732
82501,16368,8105,8263,2782,3959,1364,2593,4162,1508
82510,950,502,448,242,205,55,213,176,59
82512,273,141,132,41,62,38,35,74,23
82513,1764,897,867,208,470,219,213,449,205
82514,1823,910,913,413,409,88,392,409,112
82515,509,231,278,62,112,57,65,135,78
82516,568,287,281,97,138,52,85,144,52
82520,11421,5644,5777,1945,2780,919,1659,2999,1119
82523,875,469,406,142,238,89,134,198,74
82601,23228,11581,11647,3864,6141,1576,3379,5951,2317
82604,24095,11953,12142,3865,6326,1762,3842,6205,2095
82609,16107,7652,8455,2698,3858,1096,2717,4225,1513
82620,211,105,106,34,44,27,38,35,33
82633,8207,4109,4098,1388,2180,541,1301,2089,708
82635,159,85,74,30,42,13,23,40,11
82636,1211,585,626,135,363,87,202,372,52
82637,3789,1917,1872,660,957,300,576,990,306
82639,752,341,411,95,173,73,115,194,102
82640,28,12,16,0,7,5,0,16,0
82642,69,37,32,14,13,10,6,14,12
82643,463,244,219,101,116,27,81,97,41
82644,1047,553,494,171,287,95,96,253,145
82649,1074,518,556,176,240,102,184,258,114
82701,5029,2567,2462,756,1353,458,676,1202,584
82710,385,230,155,45,138,47,25,96,34
82711,226,128,98,70,44,14,28,52,18
82712,106,55,51,0,35,20,0,22,29
82714,59,17,42,0,17,0,7,16,19
82716,14849,7509,7340,2624,4200,685,2480,3990,870
82717,77,47,30,25,22,0,19,11,0
82718,15731,8067,7664,3087,4617,363,2837,4440,387
82720,966,484,482,150,220,114,155,217,110
82721,2229,1163,1066,408,596,159,343,572,151
82723,352,182,170,20,107,55,44,88,38
82725,120,60,60,18,30,12,9,30,21
82727,1121,579,542,206,327,46,202,317,23
82729,1949,942,1007,316,434,192,296,476,235
82730,1355,681,674,226,322,133,228,296,150
82731,150,100,50,27,52,21,0,50,0
82732,1467,771,696,276,456,39,272,404,20
82801,22064,10731,11333,3236,5569,1926,3194,5616,2523
82831,127,73,54,14,49,10,11,39,4
82832,361,166,195,24,100,42,61,95,39
82833,420,212,208,49,129,34,45,122,41
82834,6261,3054,3207,888,1513,653,878,1523,806
82835,332,171,161,60,93,18,56,91,14
82836,946,451,495,141,220,90,157,232,106
82837,26,12,14,4,8,0,5,9,0
82838,297,150,147,37,86,27,39,88,20
82839,1074,518,556,173,264,81,177,282,97
82842,962,535,427,176,246,113,77,222,128
82844,22,12,10,0,7,5,2,6,2
82845,33,15,18,3,6,6,4,5,9
82901,23000,11625,11375,3904,6534,1187,3953,5918,1504
82922,180,95,85,15,58,22,18,48,19
82923,470,272,198,92,148,32,67,107,24
82925,202,101,101,7,50,44,17,65,19
82929,54,18,36,10,8,0,36,0,0
82930,13722,6999,6723,2765,3620,614,2470,3550,703
82932,668,361,307,119,212,30,109,169,29
82933,886,443,443,135,256,52,145,243,55
82934,208,101,107,37,44,20,33,56,18
82935,12486,6219,6267,2336,3301,582,2386,3257,624
82936,90,50,40,29,19,2,22,15,3
82937,3011,1568,1443,685,762,121,563,740,140
82938,169,86,83,20,27,39,24,45,14
82939,1815,959,856,368,497,94,310,460,86
82941,2610,1325,1285,352,721,252,342,680,263
82942,49,29,20,0,8,21,0,10,10
82943,264,133,131,58,58,17,64,53,14
82944,218,95,123,26,48,21,57,55,11
82945,266,153,113,57,79,17,38,59,16
83001,13645,7377,6268,1784,4998,595,1569,4052,647
83011,186,83,103,14,55,14,12,66,25
83012,484,236,248,75,155,6,89,153,6
83013,475,225,250,45,141,39,57,172,21
83014,3193,1600,1593,279,1042,279,329,1027,237
83101,2787,1435,1352,507,781,147,445,711,196
83110,4002,1962,2040,808,854,300,829,889,322
83111,691,354,337,151,143,60,143,142,52
83112,435,236,199,65,111,60,58,104,37
83113,1954,1006,948,347,531,128,310,516,122
83114,835,407,428,153,183,71,186,164,78
83115,477,225,252,73,113,39,75,125,52
83116,837,404,433,109,209,86,119,227,87
83118,648,334,314,125,168,41,116,164,34
83119,73,36,37,18,14,4,14,16,7
83120,411,178,233,75,55,48,108,74,51
83121,31,19,12,3,5,11,2,5,5
83122,370,206,164,81,92,33,51,89,24
83123,591,314,277,115,155,44,99,147,31
83124,118,66,52,21,37,8,16,30,6
83126,190,95,95,28,54,13,27,54,14
83127,1780,922,858,315,353,254,252,364,242
83128,933,472,461,128,279,65,99,269,93
83201,36222,17588,18634,6488,8935,2165,6658,9124,2852
83202,17339,8571,8768,3570,3976,1025,3255,4366,1147
83203,434,209,225,73,122,14,97,97,31
83204,17595,8803,8792,3153,4617,1033,2970,4707,1115
83210,3512,1823,1689,829,794,200,739,685,265
83211,5921,2845,3076,1090,1327,428,1277,1326,473
83212,172,97,75,34,60,3,27,42,6
83213,1692,837,855,281,371,185,253,410,192
83214,707,325,382,163,133,29,176,149,57
83215,21,11,10,0,3,8,0,2,8
83217,832,411,421,174,174,63,139,197,85
83218,176,94,82,31,38,25,34,30,18
83220,117,70,47,18,19,33,9,24,14
83221,24355,12124,12231,4830,5656,1638,4751,5556,1924
83223,298,152,146,71,55,26,67,60,19
83226,2294,1201,1093,387,586,228,284,566,243
83227,293,141,152,36,86,19,34,92,26
83228,601,307,294,137,118,52,129,124,41
83232,228,108,120,49,46,13,56,51,13
83234,1110,544,566,205,230,109,196,219,151
83235,90,42,48,12,23,7,26,22,0
83236,2135,1094,1041,471,441,182,409,427,205
83237,926,453,473,225,198,30,221,190,62
83238,87,58,29,32,12,14,7,16,6
83239,596,265,331,109,120,36,149,139,43
83241,2020,1020,1000,375,455,190,376,416,208
83243,132,73,59,42,20,11,13,29,17
83244,342,173,169,53,89,31,54,92,23
83245,1510,785,725,285,404,96,235,378,112
83246,887,454,433,141,220,93,110,215,108
83250,2112,1084,1028,397,505,182,362,497,169
83251,1019,504,515,134,244,126,141,250,124
83252,3934,2001,1933,763,871,367,687,812,434
83253,206,115,91,41,64,10,44,47,0
83254,4184,2101,2083,836,874,391,728,893,462
83255,1102,574,528,207,260,107,186,241,101
83261,580,283,297,106,124,53,111,120,66
83262,1348,674,674,277,308,89,278,302,94
83263,8332,4144,4188,1765,1743,636,1701,1739,748
83271,543,284,259,117,109,58,92,119,48
83272,237,115,122,36,42,37,50,32,40
83274,8352,4197,4155,1877,1787,533,1702,1892,561
83276,4398,2179,2219,807,1067,305,797,1011,411
83277,120,59,61,22,37,0,19,35,7
83278,290,159,131,41,108,10,32,93,6
83281,167,79,88,18,49,12,41,36,11
83283,112,64,48,24,34,6,22,19,7
83285,107,63,44,25,35,3,7,25,12
83286,1125,561,564,257,243,61,254,243,67
83287,129,50,79,2,28,20,6,42,31
83301,41783,20161,21622,7198,9702,3261,7281,9910,4431
83302,217,117,100,35,60,22,41,47,12
83311,435,225,210,75,80,70,69,88,53
83312,52,27,25,6,11,10,6,6,13
83313,3102,1618,1484,491,961,166,431,909,144
83314,925,489,436,178,241,70,166,213,57
83316,9136,4631,4505,1643,2134,854,1368,2111,1026
83318,15941,7976,7965,3286,3497,1193,3026,3506,1433
83320,828,465,363,202,188,75,145,157,61
83321,552,254,298,96,113,45,102,137,59
83322,38,22,16,8,9,5,2,11,3
83323,2321,1241,1080,611,541,89,479,503,98
83324,585,303,282,141,127,35,117,135,30
83325,1048,561,487,195,289,77,154,238,95
83327,888,466,422,145,238,83,127,214,81
83328,4602,2385,2217,850,1157,378,746,1034,437
83330,5956,2949,3007,1036,1287,626,979,1265,763
83332,2474,1366,1108,427,646,293,291,504,313
83333,8304,4242,4062,1470,2399,373,1278,2393,391
83334,2021,976,1045,341,514,121,385,512,148
83335,1783,939,844,390,404,145,350,357,137
83336,4831,2457,2374,941,1160,356,934,1059,381
83337,25,11,14,4,7,0,5,7,2
83338,15717,8010,7707,2977,3847,1186,2777,3603,1327
83340,5496,2960,2536,638,1848,474,420,1762,354
83341,4808,2485,2323,1042,1118,325,806,1091,426
83342,1052,542,510,185,240,117,153,220,137
83344,1228,629,599,235,319,75,229,299,71
83346,1271,642,629,267,246,129,261,233,135
83347,3057,1567,1490,570,775,222,452,724,314
83348,146,80,66,22,46,12,11,50,5
83349,853,441,412,155,221,65,154,194,64
83350,12653,6273,6380,2467,2820,986,2399,2795,1186
83352,2486,1254,1232,417,613,224,391,571,270
83353,983,508,475,79,311,118,84,290,101
83354,122,67,55,11,35,21,11,32,12
83355,4761,2470,2291,972,1145,353,773,1115,403
83401,29646,14741,14905,5964,7013,1764,5514,7276,2115
83402,24656,12562,12094,4631,6501,1430,4288,6219,1587
83404,18386,8960,9426,3208,4360,1392,3119,4582,1725
83406,8324,4159,4165,1866,1838,455,1640,1974,551
83420,2400,1240,1160,474,552,214,375,515,270
83421,191,87,104,0,33,54,32,45,27
83422,2102,1102,1000,389,618,95,368,524,108
83423,930,485,445,206,233,46,172,214,59
83424,191,95,96,45,43,7,36,53,7
83425,618,318,300,123,163,32,127,142,31
83427,632,307,325,115,129,63,125,122,78
83428,264,121,143,22,62,37,32,66,45
83429,737,388,349,79,190,119,63,163,123
83431,823,446,377,195,215,36,158,178,41
83433,31,15,16,4,11,0,10,6,0
83434,1623,780,843,329,336,115,369,344,130
83435,616,339,277,176,122,41,141,103,33
83436,752,393,359,209,118,66,173,129,57
83440,25564,12176,13388,6199,5131,846,8492,3834,1062
83442,12661,6339,6322,2739,2838,762,2558,2896,868
83443,846,408,438,166,182,60,167,182,89
83444,1226,646,580,284,268,94,243,265,72
83445,6855,3542,3313,1530,1581,431,1351,1447,515
83446,29,12,17,4,4,4,6,7,4
83448,2110,1017,1093,455,452,110,500,461,132
83449,336,171,165,30,94,47,32,85,48
83450,1038,560,478,252,256,52,201,230,47
83451,704,361,343,165,156,40,160,138,45
83452,929,496,433,163,263,70,158,231,44
83455,2545,1352,1193,429,817,106,426,649,118
83462,618,331,287,86,162,83,61,166,60
83463,64,29,35,0,16,13,9,26,0
83464,374,203,171,87,84,32,55,91,25
83465,120,65,55,30,24,11,14,30,11
83466,211,124,87,24,82,18,24,44,19
83467,6042,2957,3085,878,1435,644,875,1482,728
83468,213,105,108,36,53,16,38,54,16
83469,25,12,13,0,0,12,0,13,0
83501,32578,16012,16566,4985,8067,2960,4591,8118,3857
83520,122,66,56,23,39,4,24,27,5
83522,2105,1153,952,359,631,163,346,411,195
83523,849,471,378,142,218,111,82,194,102
83524,816,404,412,129,200,75,117,217,78
83525,333,185,148,23,123,39,38,89,21
83526,226,119,107,35,56,28,30,61,16
83530,5271,2616,2655,850,1266,500,814,1161,680
83533,214,109,105,41,55,13,37,49,19
83535,1072,545,527,142,280,123,144,240,143
83536,3736,1870,1866,594,867,409,546,854,466
83537,1166,588,578,173,287,128,166,281,131
83539,2852,1438,1414,379,656,403,337,703,374
83540,2219,1087,1132,396,509,182,418,553,161
83541,1075,555,520,118,285,152,115,272,133
83542,228,107,121,22,51,34,27,49,45
83543,723,353,370,122,166,65,119,177,74
83544,6060,3288,2772,818,1834,636,691,1340,741
83545,521,262,259,69,123,70,59,129,71
83546,786,402,384,121,201,80,119,204,61
83547,280,152,128,13,80,59,20,40,68
83548,142,87,55,50,31,6,12,30,13
83549,780,401,379,110,212,79,66,196,117
83552,306,152,154,64,59,29,43,86,25
83553,1143,570,573,172,265,133,189,261,123
83554,441,233,208,50,88,95,17,111,80
83555,420,218,202,56,111,51,45,106,51
83601,84,43,41,0,17,26,0,20,21
83602,34,13,21,0,11,2,4,5,12
83604,876,482,394,165,244,73,144,193,57
83605,26069,12716,13353,5012,6126,1578,4765,6222,2366
83607,16429,8419,8010,3151,3990,1278,2910,3901,1199
83610,1000,538,462,174,239,125,135,201,126
83611,2131,1072,1059,276,511,285,290,500,269
83612,1675,861,814,241,392,228,203,386,225
83615,612,350,262,92,150,108,13,137,112
83616,15182,7651,7531,2908,3934,809,2664,3997,870
83617,14226,7082,7144,2407,3379,1296,2357,3243,1544
83619,5908,2965,2943,1092,1391,482,949,1412,582
83620,215,116,99,25,55,36,20,52,27
83622,1802,951,851,278,449,224,240,431,180
83623,1996,1003,993,412,415,176,359,448,186
83624,1100,544,556,198,243,103,219,243,94
83626,1149,538,611,214,281,43,237,302,72
83627,561,291,270,96,141,54,100,133,37
83628,4290,2130,2160,877,944,309,802,913,445
83629,1653,825,828,267,431,127,265,413,150
83631,1220,619,601,213,316,90,190,341,70
83632,211,100,111,25,51,24,25,54,32
83633,351,180,171,50,79,51,37,96,38
83634,12664,7554,5110,2195,4869,490,2033,2668,409
83637,173,88,85,16,41,31,14,44,27
83638,4869,2542,2327,767,1347,428,553,1325,449
83639,2589,1398,1191,507,689,202,450,540,201
83641,2687,1482,1205,564,706,212,385,606,214
83642,45858,22618,23240,8419,12229,1970,8244,12418,2578
83643,117,64,53,20,25,19,9,33,11
83644,6376,3234,3142,1259,1650,325,1091,1657,394
83645,606,284,322,64,133,87,95,141,86
83647,16849,8638,8211,3007,4634,997,2785,4229,1197
83648,8894,5652,3242,1577,4070,5,1464,1778,0
83650,561,305,256,57,186,62,83,132,41
83651,20841,9930,10911,3555,4758,1617,3532,4931,2448
83654,1281,639,642,177,338,124,204,325,113
83655,3739,1839,1900,673,845,321,639,930,331
83656,292,157,135,59,69,29,53,62,20
83657,114,56,58,4,12,40,0,16,42
83660,5252,2641,2611,960,1268,413,880,1235,496
83661,9732,4851,4881,1757,2290,804,1617,2326,938
83666,47,27,20,2,17,8,0,14,6
83669,2921,1448,1473,525,786,137,466,850,157
83670,358,191,167,75,93,23,66,74,27
83671,16,8,8,0,0,8,0,0,8
83672,8345,4044,4301,1368,1880,796,1320,1949,1032
83676,3895,1915,1980,733,927,255,758,909,313
83677,51,26,25,0,14,12,0,4,21
83686,31231,15482,15749,6187,7582,1713,5877,7721,2151
83687,19057,9686,9371,3759,5123,804,3493,4837,1041
83702,21897,11178,10719,2639,7240,1299,2694,6375,1650
83703,25600,12619,12981,4071,7165,1383,3883,7207,1891
83704,38742,18972,19770,6549,10056,2367,6047,10120,3603
83705,26915,13161,13754,4208,7380,1573,4030,7188,2536
83706,30759,15363,15396,4758,9189,1416,4896,8252,2248
83709,33380,16791,16589,5988,8841,1962,5452,9070,2067
83712,8247,3921,4326,1011,2361,549,1080,2430,816
83713,22505,11046,11459,4338,5840,868,4134,6152,1173
83714,7986,4100,3886,1321,2328,451,1234,2067,585
83716,10602,5412,5190,1866,3280,266,1814,3102,274
83788,0,0,0,0,0,0,0,0,0
83801,4886,2548,2338,889,1287,372,663,1323,352
83802,120,61,59,17,32,12,18,30,11
83803,227,102,125,15,22,65,0,21,104
83804,1124,578,546,163,309,106,163,243,140
83805,6475,3250,3225,1251,1417,582,992,1572,661
83806,390,196,194,63,110,23,73,108,13
83808,108,50,58,10,25,15,17,26,15
83809,499,241,258,77,121,43,57,150,51
83810,1191,600,591,158,314,128,190,306,95
83811,1198,607,591,194,302,111,147,307,137
83812,95,57,38,17,33,7,6,24,8
83813,966,503,463,112,240,151,114,257,92
83814,22296,10940,11356,3400,5845,1695,3179,5887,2290
83815,22246,10617,11629,3633,5130,1854,3510,5661,2458
83821,209,86,123,8,34,44,27,42,54
83822,1881,937,944,281,475,181,262,527,155
83823,1225,639,586,202,329,108,171,300,115
83824,326,168,158,72,79,17,64,74,20
83826,135,68,67,13,27,28,18,33,16
83827,150,83,67,18,37,28,2,33,32
83830,623,349,274,151,158,40,79,134,61
83832,1518,784,734,242,422,120,222,406,106
83833,1364,735,629,182,346,207,146,331,152
83834,164,73,91,8,41,24,26,34,31
83835,14959,7523,7436,2491,3774,1258,2191,3844,1401
83836,989,496,493,106,233,157,128,210,155
83837,3107,1493,1614,481,744,268,459,754,401
83839,1583,795,788,245,398,152,223,412,153
83841,317,149,168,43,63,43,35,94,39
83842,134,68,66,15,36,17,11,36,19
83843,24943,13043,11900,4781,7161,1101,4377,6153,1370
83845,1579,798,781,277,407,114,282,424,75
83846,701,354,347,92,180,82,88,165,94
83847,1484,822,662,239,430,153,196,390,76
83848,226,128,98,12,75,41,24,61,13
83849,2177,1090,1087,290,533,267,240,528,319
83850,2307,1125,1182,296,562,267,278,577,327
83851,1592,803,789,312,349,142,269,390,130
83852,252,139,113,51,64,24,22,75,16
83853,173,66,107,6,31,29,48,33,26
83854,27258,13523,13735,4816,7004,1703,4540,7188,2007
83855,2039,1043,996,345,509,189,322,451,223
83856,6277,3263,3014,1115,1627,521,883,1583,548
83857,792,369,423,102,209,58,132,228,63
83858,10273,5152,5121,1968,2631,553,1826,2802,493
83860,5244,2653,2591,822,1312,519,745,1433,413
83861,6331,3177,3154,946,1565,666,926,1538,690
83864,16095,7945,8150,2545,4170,1230,2314,4372,1464
83866,279,178,101,29,68,81,26,41,34
83867,264,133,131,34,70,29,40,71,20
83868,677,372,305,99,212,61,96,142,67
83869,3663,1862,1801,630,955,277,626,930,245
83870,415,206,209,77,94,35,56,116,37
83871,1782,894,888,274,460,160,269,464,155
83872,573,310,263,83,195,32,42,187,34
83873,2471,1202,1269,311,639,252,337,610,322
83874,48,26,22,0,10,16,4,13,5
83876,1323,685,638,248,326,111,184,347,107
84001,828,427,401,200,174,53,164,174,63
84002,130,59,71,24,21,14,28,26,17
84003,30228,15183,15045,7406,6479,1298,6840,6712,1493
84004,7619,3880,3739,1955,1582,343,1840,1550,349
84006,725,356,369,144,155,57,149,161,59
84007,486,236,250,99,109,28,102,105,43
84010,43702,21227,22475,7942,9748,3537,7898,9974,4603
84013,915,430,485,186,208,36,233,221,31
84014,14411,7199,7212,3374,3245,580,3031,3438,743
84015,44709,22871,21838,10269,10819,1783,9007,10756,2075
84017,3023,1567,1456,640,768,159,554,684,218
84018,83,36,47,13,23,0,21,26,0
84020,25981,14641,11340,5134,8773,734,4508,6147,685
84021,2571,1380,1191,486,664,230,456,542,193
84022,2311,739,1572,268,433,38,1179,375,18
84023,245,135,110,43,79,13,26,70,14
84024,81,44,37,10,24,10,10,21,6
84025,12465,6583,5882,2930,3173,480,2566,2818,498
84026,1155,569,586,276,251,42,253,262,71
84027,305,142,163,37,52,53,48,69,46
84028,460,216,244,71,96,49,79,109,56
84029,6640,3324,3316,1479,1468,377,1387,1531,398
84031,224,133,91,65,40,28,36,44,11
84032,11425,5864,5561,2471,2843,550,2178,2745,638
84033,964,474,490,235,190,49,193,229,68
84034,41,16,25,3,13,0,0,9,16
84035,667,334,333,107,191,36,133,146,54
84036,3858,1937,1921,762,940,235,717,956,248
84037,25550,12659,12891,6131,5402,1126,5729,5751,1411
84038,341,181,160,67,81,33,53,84,23
84039,754,380,374,168,165,47,153,173,48
84040,23127,11799,11328,5248,5644,907,4773,5657,898
84041,37417,18819,18598,8032,9462,1325,7674,9258,1666
84042,8353,4285,4068,2150,1825,310,1949,1858,261
84043,23643,11978,11665,5808,5471,699,5289,5534,842
84044,22863,11543,11320,5097,5534,912,4654,5678,988
84046,676,376,300,79,204,93,104,137,59
84047,28244,14371,13873,5008,7870,1493,4556,7378,1939
84049,2890,1481,1409,591,689,201,477,701,231
84050,7046,3584,3462,1648,1495,441,1456,1557,449
84051,262,135,127,55,70,10,58,52,17
84052,1239,630,609,286,268,76,250,274,85
84053,629,340,289,147,155,38,110,137,42
84054,8828,4425,4403,1694,2279,452,1806,2082,515
84055,507,264,243,111,126,27,99,118,26
84056,4785,2703,2082,1389,1304,10,942,1135,5
84057,35482,17437,18045,7779,8381,1277,8005,8286,1754
84058,28070,14011,14059,6107,6944,960,6174,6572,1313
84060,7319,4003,3316,1076,2667,260,945,2120,251
84061,618,321,297,143,152,26,115,165,17
84062,27260,13634,13626,6672,6042,920,6435,6063,1128
84063,518,258,260,97,137,24,92,130,38
84064,778,408,370,185,163,60,154,159,57
84065,33145,16722,16423,7996,7754,972,7616,7855,952
84066,8690,4321,4369,1942,1908,471,1882,1967,520
84067,34668,17096,17572,6825,8569,1702,6860,8670,2042
84069,488,254,234,116,102,36,95,99,40
84070,23251,11529,11722,4443,5945,1141,4221,5828,1673
84071,532,267,265,102,143,22,116,119,30
84072,417,219,198,96,94,29,83,89,26
84073,219,111,108,37,53,21,34,48,26
84074,28800,14498,14302,5969,7158,1371,5626,7032,1644
84075,10339,5273,5066,2386,2521,366,2318,2398,350
84076,343,156,187,74,66,16,88,73,26
84078,19672,9761,9911,4216,4323,1222,3879,4627,1405
84080,295,138,157,53,61,24,63,75,19
84082,789,406,383,174,182,50,149,195,39
84083,1628,821,807,370,408,43,378,387,42
84084,43912,22210,21702,9874,11505,831,9406,11268,1028
84085,497,245,252,113,109,23,116,107,29
84086,371,194,177,88,69,37,82,65,30
84087,9795,4882,4913,2219,2359,304,2081,2509,323
84088,38996,19415,19581,9245,9346,824,8786,9730,1065
84092,30180,15351,14829,6801,7541,1009,6261,7589,979
84093,25335,12962,12373,5422,6482,1058,4749,6539,1085
84094,28063,14106,13957,5949,7121,1036,5534,7285,1138
84095,29892,15234,14658,7265,7055,914,6562,7072,1024
84097,21073,10478,10595,4794,4586,1098,4849,4464,1282
84098,13340,6762,6578,2238,4152,372,2310,3996,272
84101,3387,2064,1323,434,1408,222,383,721,219
84102,17603,9040,8563,2084,6300,656,2336,4932,1295
84103,21893,10803,11090,2633,6855,1315,2722,6474,1894
84104,22555,11574,10981,4646,5796,1132,4474,5095,1412
84105,22314,10872,11442,3141,6732,999,3081,6832,1529
84106,33217,16021,17196,4974,8666,2381,4635,8667,3894
84107,30727,15094,15633,4821,7969,2304,4729,7754,3150
84108,21437,10587,10850,3365,5428,1794,3052,5651,2147
84109,23785,11616,12169,3901,5639,2076,3678,5631,2860
84111,10386,5347,5039,1274,3497,576,1341,2767,931
84112,1542,815,727,552,263,0,592,135,0
84113,0,0,0,0,0,0,0,0,0
84115,24367,12431,11936,3926,7255,1250,3830,6354,1752
84116,31609,16391,15218,6317,8520,1554,6008,7290,1920
84117,23844,11203,12641,3361,5655,2187,3266,6354,3021
84118,64545,32790,31755,14405,16341,2044,13220,16128,2407
84119,47760,25230,22530,9585,13636,2009,8034,11823,2673
84120,45018,22632,22386,9731,11178,1723,9202,11334,1850
84121,43187,21692,21495,7511,11155,3026,6746,11509,3240
84123,37202,18273,18929,6712,9798,1763,6790,9765,2374
84124,20822,10304,10518,3454,4736,2114,2912,4885,2721
84128,20600,10375,10225,4698,5214,463,4637,5096,492
84180,0,0,0,0,0,0,0,0,0
84301,477,261,216,96,120,45,76,108,32
84302,20964,10519,10445,4441,4625,1453,4170,4557,1718
84304,18,10,8,0,10,0,0,8,0
84305,717,377,340,179,150,48,133,157,50
84306,171,89,82,36,32,21,32,37,13
84307,1301,665,636,301,289,75,280,273,83
84309,569,277,292,118,123,36,136,99,57
84310,3108,1586,1522,602,800,184,552,819,151
84311,656,336,320,151,141,44,134,139,47
84312,3464,1730,1734,800,769,161,780,736,218
84313,96,66,30,14,25,27,0,6,24
84314,1154,603,551,258,258,87,239,224,88
84315,6213,3188,3025,1421,1534,233,1216,1543,266
84316,197,111,86,54,47,10,33,40,13
84317,2231,1190,1041,547,489,154,433,472,136
84318,2764,1386,1378,709,575,102,625,645,108
84319,6696,3426,3270,1650,1534,242,1470,1524,276
84320,2478,1208,1270,579,501,128,628,494,148
84321,38269,18338,19931,6692,10162,1484,9009,8891,2031
84324,796,417,379,204,157,56,159,178,42
84325,1251,651,600,313,292,46,238,285,77
84326,1100,578,522,290,261,27,232,248,42
84327,903,467,436,210,215,42,219,159,58
84328,1200,591,609,270,273,48,272,271,66
84329,219,133,86,62,64,7,28,43,15
84330,445,208,237,95,95,18,116,101,20
84331,296,147,149,68,56,23,67,69,13
84332,4518,2213,2305,974,981,258,961,1045,299
84333,2049,1034,1015,459,460,115,421,454,140
84334,170,77,93,38,26,13,36,38,19
84335,8300,4111,4189,1926,1773,412,1889,1794,506
84336,361,185,176,68,96,21,90,65,21
84337,9102,4555,4547,2135,1962,458,1998,1980,569
84338,480,254,226,126,110,18,89,103,34
84339,4560,2290,2270,1065,989,236,1033,997,240
84340,2307,1162,1145,432,578,152,451,535,159
84341,16088,8034,8054,3292,4179,563,3529,3828,697
84401,28043,14960,13083,5616,7835,1509,5097,6180,1806
84403,34849,17343,17506,6213,8659,2471,6116,8156,3234
84404,45083,22335,22748,8667,10895,2773,8057,11028,3663
84405,25305,12543,12762,4888,5885,1770,4704,5837,2221
84414,20899,10549,10350,4589,4756,1204,4266,4788,1296
84501,12668,6195,6473,2348,3003,844,2525,2860,1088
84510,872,403,469,222,170,11,200,232,37
84511,4295,2077,2218,960,874,243,1002,939,277
84512,1165,564,601,210,241,113,254,237,110
84513,1842,970,872,469,412,89,360,414,98
84516,339,174,165,67,75,32,65,80,20
84518,643,317,326,136,149,32,138,151,37
84520,1381,660,721,199,320,141,206,321,194
84521,928,452,476,190,209,53,194,217,65
84522,357,181,176,54,80,47,55,82,39
84523,1690,848,842,369,355,124,330,355,157
84525,1158,565,593,214,255,96,216,269,108
84526,3916,1913,2003,657,926,330,607,941,455
84528,2709,1367,1342,597,624,146,523,626,193
84529,136,62,74,17,33,12,12,38,24
84530,132,82,50,20,49,13,7,36,7
84531,750,344,406,220,110,14,181,179,46
84532,8554,4227,4327,1413,2221,593,1306,2248,773
84533,108,64,44,29,35,0,17,27,0
84534,1985,985,1000,517,385,83,541,406,53
84535,2701,1358,1343,566,594,198,591,549,203
84536,1398,774,624,435,290,49,243,332,49
84537,1352,646,706,261,313,72,300,314,92
84539,423,207,216,71,98,38,65,99,52
84540,70,36,34,4,32,0,11,23,0
84542,1898,952,946,401,446,105,385,457,104
84601,27212,13679,13533,5396,7515,768,5670,6741,1122
84604,48426,23013,25413,10047,10834,2132,13551,9224,2638
84606,28916,13634,15282,3911,9305,418,7899,6729,654
84620,958,472,486,185,209,78,174,233,79
84621,162,83,79,36,23,24,28,30,21
84622,1236,631,605,290,291,50,264,272,69
84623,128,70,58,27,36,7,16,25,17
84624,5702,2922,2780,1394,1212,316,1193,1199,388
84626,180,84,96,38,27,19,47,35,14
84627,4718,2102,2616,1112,824,166,1661,721,234
84628,832,429,403,162,202,65,144,192,67
84629,2139,1086,1053,461,439,186,401,460,192
84630,214,103,111,56,35,12,40,55,16
84631,3508,1801,1707,763,785,253,681,700,326
84632,1032,511,521,223,211,77,213,218,90
84633,1012,491,521,238,203,50,237,213,71
84634,2521,1664,857,488,993,183,344,338,175
84635,862,435,427,169,214,52,146,217,64
84636,449,211,238,81,88,42,81,105,52
84637,94,47,47,15,4,28,12,15,20
84638,231,113,118,50,44,19,62,41,15
84639,770,388,382,165,162,61,147,175,60
84640,149,80,69,30,36,14,26,33,10
84642,3527,1731,1796,795,670,266,761,715,320
84643,610,311,299,114,126,71,92,120,87
84645,1412,690,722,392,255,43,396,286,40
84646,1566,803,763,399,309,95,318,317,128
84647,3347,1659,1688,716,691,252,728,663,297
84648,4994,2533,2461,1089,1069,375,1014,1056,391
84649,759,438,321,245,141,52,122,155,44
84650,95,29,66,10,12,7,44,4,18
84651,17735,8781,8954,4106,3791,884,4065,3848,1041
84652,942,470,472,233,206,31,212,210,50
84653,5577,2856,2721,1441,1143,272,1249,1174,298
84654,2727,1370,1357,578,574,218,547,569,241
84655,6323,3356,2967,1656,1467,233,1386,1316,265
84656,302,155,147,46,60,49,48,56,43
84657,503,255,248,103,122,30,97,113,38
84660,23003,11673,11330,5403,5377,893,5127,5100,1103
84662,1260,625,635,243,298,84,255,304,76
84663,21491,10625,10866,4706,4908,1011,4785,4872,1209
84664,5951,2976,2975,1393,1218,365,1381,1241,353
84667,351,167,184,86,61,20,86,80,18
84701,7513,3738,3775,1578,1555,605,1444,1529,802
84710,215,111,104,65,42,4,60,38,6
84711,471,227,244,81,108,38,101,110,33
84712,142,82,60,35,24,23,20,32,8
84713,3565,1858,1707,674,832,352,604,718,385
84714,1065,525,540,244,218,63,254,209,77
84715,407,210,197,88,80,42,75,79,43
84716,324,168,156,66,92,10,45,101,10
84717,84,43,41,17,26,0,23,18,0
84718,142,70,72,23,21,26,16,25,31
84719,92,46,46,6,26,14,16,21,9
84720,29006,14362,14644,6126,6885,1351,6761,6344,1539
84722,550,319,231,107,112,100,54,104,73
84723,520,254,266,94,99,61,106,102,58
84724,787,378,409,179,142,57,153,178,78
84725,1459,706,753,321,281,104,332,296,125
84726,1001,505,496,177,230,98,170,238,88
84728,205,115,90,56,29,30,43,29,18
84729,346,181,165,65,76,40,47,83,35
84730,496,260,236,122,98,40,73,118,45
84731,150,102,48,51,42,9,10,38,0
84732,63,32,31,10,14,8,13,13,5
84733,213,90,123,29,36,25,45,43,35
84734,235,118,117,46,50,22,51,47,19
84735,184,94,90,41,41,12,25,48,17
84736,195,96,99,31,40,25,36,36,27
84737,12429,6224,6205,2752,2245,1227,2459,2481,1265
84738,4442,2226,2216,893,904,429,773,1056,387
84739,508,260,248,117,117,26,108,110,30
84740,103,49,54,14,26,9,19,23,12
84741,4743,2353,2390,816,1006,531,717,1053,620
84743,211,123,88,40,51,32,20,44,24
84744,286,143,143,55,55,33,50,61,32
84745,3395,1692,1703,745,669,278,667,700,336
84747,920,468,452,208,195,65,193,184,75
84749,246,127,119,53,55,19,50,54,15
84750,510,255,255,94,103,58,74,113,68
84751,1494,721,773,285,348,88,344,303,126
84752,845,431,414,200,174,57,172,174,68
84753,64,44,20,22,11,11,0,7,13
84754,3464,1730,1734,631,756,343,668,735,331
84755,115,54,61,13,22,19,14,30,17
84757,872,449,423,146,200,103,132,208,83
84758,524,268,256,118,100,50,92,110,54
84759,2041,1032,1009,380,482,170,380,395,234
84760,679,344,335,120,157,67,132,142,61
84761,2754,1389,1365,542,568,279,445,582,338
84762,103,44,59,19,20,5,25,27,7
84764,77,52,25,28,18,6,8,11,6
84765,4489,2256,2233,1101,886,269,1002,932,299
84766,187,98,89,43,44,11,47,36,6
84770,30732,14752,15980,5723,6134,2895,5976,6167,3837
84772,119,63,56,19,30,14,14,36,6
84773,290,140,150,40,70,30,39,77,34
84774,295,146,149,59,63,24,54,66,29
84775,411,223,188,48,114,61,34,105,49
84776,545,268,277,126,108,34,117,119,41
84779,690,366,324,120,186,60,76,185,63
84780,8715,4404,4311,1580,1933,891,1555,1678,1078
84781,31,17,14,0,0,17,0,0,14
84782,700,375,325,164,144,67,128,151,46
84783,558,259,299,61,108,90,93,119,87
84790,20784,10136,10648,3750,3918,2468,3847,4071,2730
85003,9425,5831,3594,1446,3882,503,1139,1893,562
85004,4526,2417,2109,660,1395,362,626,994,489
85006,31906,16986,14920,7377,8666,943,6480,7152,1288
85007,15894,8585,7309,3033,4771,781,2781,3584,944
85008,56368,29809,26559,11476,16534,1799,10231,13821,2507
85009,55943,31276,24667,12772,16597,1907,10690,11432,2545
85012,6337,3260,3077,727,1727,806,667,1638,772
85013,20923,10728,10195,2961,6456,1311,2602,5565,2028
85014,28344,14816,13528,4353,8979,1484,3899,7638,1991
85015,42337,21398,20939,7805,11776,1817,7383,10736,2820
85016,36327,18234,18093,4636,11202,2396,4694,9931,3468
85017,40784,21188,19596,8843,10696,1649,8065,9568,1963
85018,38665,19176,19489,4870,11057,3249,4671,10333,4485
85019,25545,12855,12690,5195,6472,1188,4922,6167,1601
85020,34688,17300,17388,4896,9810,2594,4265,9541,3582
85021,38111,19407,18704,6694,10439,2274,5961,9506,3237
85022,44410,22041,22369,6692,12784,2565,5986,13032,3351
85023,33490,16480,17010,5461,9315,1704,5321,9766,1923
85024,19584,9684,9900,2990,5606,1088,2628,5834,1438
85027,38694,19493,19201,6655,11148,1690,6129,11000,2072
85028,20748,10066,10682,2930,5355,1781,2607,5930,2145
85029,46323,23072,23251,7756,12821,2495,7236,12502,3513
85031,28799,14406,14393,6016,7042,1348,6089,6568,1736
85032,69280,34473,34807,11562,19494,3417,10448,19331,5028
85033,53673,26673,27000,12265,12681,1727,11578,13211,2211
85034,8589,4678,3911,2002,2260,416,1743,1685,483
85035,44782,22524,22258,10137,11141,1246,9985,10826,1447
85037,33208,16644,16564,6887,8992,765,6584,9066,914
85040,63103,31962,31141,13474,15824,2664,13189,14814,3138
85041,32232,16364,15868,7052,7901,1411,6683,7452,1733
85043,10832,5491,5341,2370,2691,430,2328,2588,425
85044,39665,19726,19939,5625,12030,2071,5228,12174,2537
85045,4543,2345,2198,835,1431,79,696,1409,93
85048,33636,16792,16844,5999,9951,842,6014,9956,874
85050,19043,9210,9833,2979,5421,810,2903,5827,1103
85051,41075,20599,20476,7313,10731,2555,6691,10610,3175
85053,27974,14242,13732,4981,7844,1417,4468,7705,1559
85054,2315,1071,1244,263,714,94,420,735,89
85085,447,179,268,10,121,48,51,156,61
85086,8354,4545,3809,1161,2903,481,1058,2272,479
85087,3789,1995,1794,485,1158,352,496,1041,257
85201,49917,25032,24885,8796,13956,2280,8323,12811,3751
85202,41290,20784,20506,6857,12193,1734,6431,11807,2268
85203,36840,18341,18499,6748,9612,1981,6715,9364,2420
85204,63873,32326,31547,12713,16540,3073,11895,15635,4017
85205,40980,19489,21491,5926,8151,5412,5310,8824,7357
85206,30413,14193,16220,3867,5594,4732,3441,5805,6974
85207,26075,12800,13275,4143,6626,2031,4323,6724,2228
85208,42476,20615,21861,5656,8511,6448,5188,8767,7906
85210,38242,19694,18548,7093,11409,1192,6896,10165,1487
85212,10330,5158,5172,1859,2672,627,1686,2826,660
85213,31906,15747,16159,6084,7313,2350,5267,7787,3105
85215,16197,7690,8507,1947,3371,2372,1839,3745,2923
85219,24104,11808,12296,2553,5297,3958,2305,5669,4322
85220,32005,15753,16252,4042,6975,4736,3842,6962,5448
85221,2602,1210,1392,680,469,61,764,540,88
85222,37668,18659,19009,7157,8387,3115,6344,9100,3565
85223,4064,2072,1992,555,876,641,447,934,611
85224,43571,21662,21909,7590,12388,1684,6964,12696,2249
85225,66102,32870,33232,12486,18094,2290,11878,18318,3036
85226,39387,19654,19733,7259,11439,956,6657,12006,1070
85228,11429,5723,5706,2456,2447,820,2138,2608,960
85230,128,58,70,29,29,0,29,26,15
85231,11724,6740,4984,2490,3814,436,2259,2220,505
85232,19104,15132,3972,2246,11540,1346,1051,1785,1136
85233,38114,18715,19399,6836,10829,1050,6796,11290,1313
85234,36855,18381,18474,7590,9664,1127,6947,10201,1326
85235,1359,665,694,268,281,116,260,303,131
85236,8658,4345,4313,1797,2284,264,1852,2203,258
85237,2802,1371,1431,466,622,283,442,682,307
85239,7831,4092,3739,1528,2035,529,1349,1933,457
85241,565,299,266,145,117,37,99,116,51
85242,13396,6904,6492,2706,3554,644,2520,3387,585
85245,291,130,161,41,73,16,75,63,23
85247,4418,2170,2248,973,1063,134,1050,1097,101
85248,34706,16786,17920,3902,7653,5231,3587,8467,5866
85249,9258,4571,4687,1230,2160,1181,1148,2278,1261
85250,16696,7680,9016,1667,3980,2033,1512,4613,2891
85251,38092,18364,19728,4018,10668,3678,3801,10129,5798
85253,17796,8980,8816,2540,4372,2068,2259,4568,1989
85254,49714,24119,25595,7599,13527,2993,7436,14791,3368
85255,21098,10252,10846,2279,5745,2228,2371,6418,2057
85256,4858,2300,2558,1180,955,165,1210,1101,247
85257,27958,13454,14504,3219,7538,2697,3292,7172,4040
85258,25065,11950,13115,2318,6120,3512,2036,7105,3974
85259,26772,13064,13708,4071,7386,1607,4015,8041,1652
85260,35508,16842,18666,4547,9758,2537,4560,10898,3208
85262,9154,4463,4691,564,2171,1728,622,2578,1491
85263,1503,700,803,0,107,593,16,196,591
85264,868,441,427,219,198,24,206,198,23
85268,20225,9814,10411,2217,4886,2711,2077,5601,2733
85272,1470,800,670,338,417,45,276,334,60
85273,3359,1686,1673,514,762,410,548,676,449
85281,50977,27994,22983,10096,16603,1295,9327,11878,1778
85282,51335,25938,25397,7743,14968,3227,7245,13915,4237
85283,43938,22177,21761,6765,13436,1976,6604,12719,2438
85284,17426,8558,8868,2982,4864,712,2833,5338,697
85292,2141,1129,1012,339,624,166,369,456,187
85296,33084,16585,16499,6748,9126,711,6282,9440,777
85301,62188,30793,31395,12395,15416,2982,12142,14933,4320
85302,36372,17776,18596,6141,9640,1995,5459,9910,3227
85303,22659,11516,11143,4930,5937,649,4405,5884,854
85304,27646,13697,13949,5089,7375,1233,4736,7743,1470
85305,5520,2759,2761,984,1596,179,1042,1544,175
85306,26422,13162,13260,4448,7416,1298,4007,7418,1835
85307,10750,5499,5251,2230,3058,211,2191,2796,264
85308,65712,32703,33009,10922,19122,2659,10573,19459,2977
85309,680,545,135,423,122,0,101,34,0
85310,22771,11261,11510,4157,6500,604,4105,6695,710
85320,1023,497,526,160,224,113,197,194,135
85321,5028,2425,2603,730,924,771,722,1015,866
85322,474,258,216,106,116,36,57,124,35
85323,32801,16630,16171,6696,8850,1084,6106,8783,1282
85324,2743,1400,1343,230,743,427,279,639,425
85325,1053,533,520,68,167,298,62,191,267
85326,22019,12103,9916,3683,7301,1119,3312,5455,1149
85328,179,84,95,13,40,31,27,60,8
85329,2911,1487,1424,659,654,174,650,607,167
85331,23731,11812,11919,3253,6964,1595,3185,7231,1503
85332,1944,981,963,169,325,487,135,368,460
85333,857,471,386,207,188,76,173,180,33
85334,1026,546,480,174,277,95,171,227,82
85335,7518,3814,3704,1716,1786,312,1724,1629,351
85336,1401,707,694,365,304,38,318,347,29
85337,2733,1389,1344,560,660,169,541,644,159
85338,16068,8280,7788,2646,4320,1314,2164,4360,1264
85339,6206,3073,3133,1284,1458,331,1153,1628,352
85340,6865,3362,3503,1101,1595,666,970,1822,711
85342,1660,803,857,205,350,248,219,394,244
85344,10787,5533,5254,1762,2728,1043,1664,2475,1115
85345,53111,25643,27468,9332,13245,3066,8996,13941,4531
85346,3895,1994,1901,191,492,1311,165,488,1248
85347,1253,679,574,255,321,103,191,300,83
85348,1733,884,849,148,298,438,159,300,390
85349,12601,6032,6569,2962,2556,514,3112,2997,460
85350,14668,8353,6315,3061,4649,643,2794,2914,607
85351,28704,11789,16915,89,1175,10525,114,1799,15002
85353,7201,3596,3605,1335,1822,439,1370,1728,507
85354,2923,1463,1460,518,736,209,551,714,195
85355,3593,1805,1788,642,1016,147,697,919,172
85356,3924,2024,1900,653,743,628,575,776,549
85357,654,331,323,110,122,99,90,140,93
85360,369,160,209,59,60,41,71,103,35
85361,4034,2020,2014,805,934,281,746,995,273
85362,1063,545,518,96,208,241,72,232,214
85363,3039,1300,1739,204,434,662,155,478,1106
85364,71539,34850,36689,13728,16334,4788,13573,17122,5994
85365,35626,18458,17168,6312,7792,4354,5332,7584,4252
85367,18141,9024,9117,1242,2320,5462,851,3024,5242
85373,12577,5581,6996,572,906,4103,429,1322,5245
85374,28130,13809,14321,3272,5540,4997,3071,6158,5092
85375,27304,12328,14976,130,841,11357,155,1618,13203
85379,1207,557,650,180,347,30,216,400,34
85381,22355,10557,11798,3956,5405,1196,3851,5994,1953
85382,37839,18058,19781,5438,8589,4031,5154,9426,5201
85390,7815,3851,3964,942,1670,1239,801,1730,1433
85501,13615,6753,6862,2164,3236,1353,1979,3213,1670
85530,1862,920,942,501,356,63,476,387,79
85531,477,220,257,109,96,15,144,96,17
85533,1776,909,867,305,438,166,305,407,155
85534,3426,1720,1706,591,817,312,576,789,341
85535,163,90,73,42,36,12,32,32,9
85536,371,210,161,92,82,36,42,80,39
85539,5268,2562,2706,790,1273,499,832,1238,636
85540,3779,1991,1788,787,1076,128,697,950,141
85541,19838,9583,10255,2512,3964,3107,2377,4369,3509
85542,1311,619,692,280,269,70,313,304,75
85543,3181,1577,1604,640,667,270,607,712,285
85544,2983,1484,1499,272,688,524,241,726,532
85545,627,307,320,60,111,136,55,136,129
85546,17869,9519,8350,2968,5130,1421,2981,3507,1862
85550,6212,3070,3142,1560,1324,186,1605,1328,209
85552,5698,2643,3055,1203,1061,379,1364,1247,444
85553,872,446,426,69,167,210,39,192,195
85554,621,349,272,89,167,93,41,116,115
85601,856,453,403,85,215,153,58,209,136
85602,8622,4414,4208,1260,1875,1279,987,1812,1409
85603,8602,4179,4423,1261,2015,903,1087,2183,1153
85605,756,359,397,122,111,126,136,147,114
85606,1404,728,676,190,333,205,165,322,189
85607,21217,11319,9898,4175,5673,1471,3965,4307,1626
85608,41,25,16,2,12,11,0,5,11
85609,399,206,193,50,68,88,26,82,85
85610,1439,712,727,263,280,169,271,313,143
85611,470,244,226,71,114,59,40,124,62
85613,8382,4843,3539,2405,2438,0,1776,1763,0
85614,18166,8242,9924,362,1235,6645,316,1907,7701
85615,6590,3297,3293,1118,1549,630,849,1889,555
85616,4922,2401,2521,732,1244,425,755,1271,495
85617,1300,657,643,185,281,191,151,315,177
85618,1967,956,1011,377,435,144,383,506,122
85619,49,32,17,9,12,11,0,17,0
85621,22933,10781,12152,4634,4756,1391,4540,5741,1871
85623,4333,2058,2275,651,1038,369,688,1193,394
85624,1326,615,711,140,298,177,177,354,180
85625,2309,1115,1194,233,408,474,210,517,467
85627,289,144,145,68,60,16,56,69,20
85629,8074,3922,4152,1328,1833,761,1279,1962,911
85630,2408,1155,1253,332,510,313,384,547,322
85631,4450,2282,2168,873,1060,349,783,1046,339
85632,683,357,326,88,147,122,94,140,92
85633,124,55,69,13,35,7,20,40,9
85634,6011,2835,3176,1312,1269,254,1397,1440,339
85635,29060,13903,15157,4480,7097,2326,4526,7633,2998
85637,1336,652,684,124,288,240,105,364,215
85638,1979,966,1013,228,416,322,218,485,310
85639,477,248,229,145,81,22,62,114,53
85640,516,255,261,37,143,75,62,130,69
85641,6512,3365,3147,1089,1801,475,962,1796,389
85643,8628,4592,4036,1188,2646,758,1476,1814,746
85645,2408,1209,1199,387,623,199,347,666,186
85646,1008,466,542,89,171,206,103,209,230
85648,10854,5292,5562,2381,2486,425,2255,2860,447
85650,10410,5073,5337,1392,2447,1234,1475,2653,1209
85653,10887,5671,5216,1904,2911,856,1619,2854,743
85654,170,71,99,12,59,0,27,58,14
85701,4506,2359,2147,418,1612,329,510,1247,390
85704,27028,12316,14712,2818,6402,3096,2979,6980,4753
85705,55083,26952,28131,8735,14478,3739,8470,14283,5378
85706,70601,36221,34380,14187,18451,3583,13185,16624,4571
85708,6425,3443,2982,1792,1611,40,1478,1463,41
85710,54422,25245,29177,7236,12373,5636,6997,13800,8380
85711,42949,20465,22484,6262,11549,2654,7083,11238,4163
85712,32601,15722,16879,4017,8986,2719,3489,9007,4383
85713,47697,22640,25057,8049,10851,3740,8098,12163,4796
85714,14347,7002,7345,2941,3209,852,2771,3531,1043
85715,16036,7484,8552,2005,3768,1711,2058,4229,2265
85716,33291,16556,16735,4553,10266,1737,4137,9653,2945
85718,26358,12665,13693,3035,6339,3291,2832,6670,4191
85719,44181,21897,22284,8756,11609,1532,9739,10179,2366
85730,39004,19181,19823,6532,10335,2314,6356,10711,2756
85735,8233,4127,4106,1403,2041,683,1294,2188,624
85736,4699,2417,2282,907,1225,285,810,1246,226
85737,30198,15012,15186,4059,6881,4072,3333,7507,4346
85739,12344,6185,6159,1438,2198,2549,1064,2596,2499
85741,31686,15709,15977,5531,8575,1603,4995,8858,2124
85742,22172,10661,11511,3648,5823,1190,3772,6275,1464
85743,18744,9414,9330,3142,5194,1078,2881,5305,1144
85745,30988,14988,16000,4744,8099,2145,4565,8814,2621
85746,44808,21926,22882,8986,10670,2270,8720,11236,2926
85747,12846,6526,6320,2366,3630,530,2110,3658,552
85748,15381,7511,7870,2142,4115,1254,2059,4460,1351
85749,18468,9235,9233,2795,4947,1493,2567,5170,1496
85750,24677,11891,12786,2916,6351,2624,3008,6859,2919
85901,11714,5711,6003,1965,2663,1083,1992,2873,1138
85911,1422,679,743,315,295,69,385,296,62
85920,212,115,97,13,52,50,13,54,30
85922,8,5,3,0,5,0,0,3,0
85923,658,295,363,140,82,73,152,124,87
85924,2093,1114,979,303,468,343,240,470,269
85925,2105,1047,1058,452,455,140,389,519,150
85926,80,63,17,19,44,0,0,17,0
85927,162,95,67,19,39,37,16,35,16
85928,941,490,451,181,235,74,157,227,67
85929,5668,2797,2871,937,1367,493,883,1475,513
85930,370,173,197,98,62,13,103,92,2
85931,273,137,136,14,56,67,12,49,75
85932,272,142,130,24,86,32,5,78,47
85933,2773,1385,1388,289,552,544,263,632,493
85934,317,169,148,46,100,23,18,99,31
85935,5369,2713,2656,824,1275,614,721,1332,603
85936,4060,2242,1818,792,1146,304,676,849,293
85937,6011,3066,2945,1293,1313,460,1104,1375,466
85938,4455,2170,2285,860,990,320,796,1090,399
85939,3446,1727,1719,835,688,204,719,750,250
85940,639,287,352,100,121,66,119,172,61
85941,10185,4792,5393,2472,2045,275,2706,2344,343
85942,177,54,123,7,34,13,54,55,14
86001,34059,17145,16914,5854,10123,1168,6380,9237,1297
86004,35287,17523,17764,6383,9692,1448,6239,9988,1537
86015,228,125,103,39,60,26,28,59,16
86016,102,48,54,36,12,0,24,26,4
86017,1423,705,718,155,319,231,161,407,150
86018,1048,532,516,139,317,76,126,319,71
86020,2512,1282,1230,632,526,124,513,528,189
86021,4122,2040,2082,1440,558,42,1336,698,48
86022,1757,867,890,358,384,125,323,450,117
86023,2316,1321,995,472,797,52,244,701,50
86024,616,294,322,20,143,131,49,155,118
86025,7060,3346,3714,1403,1498,445,1549,1675,490
86030,709,322,387,167,105,50,198,153,36
86031,2494,1206,1288,560,452,194,570,506,212
86032,125,67,58,29,27,11,22,22,14
86033,8427,4159,4268,2160,1706,293,1962,1879,427
86034,2072,984,1088,449,415,120,495,423,170
86035,1598,753,845,320,317,116,315,409,121
86036,252,137,115,56,79,2,64,49,2
86039,2023,985,1038,429,415,141,374,478,186
86040,10034,5038,4996,2111,2512,415,2041,2439,516
86042,1590,772,818,347,355,70,362,355,101
86043,1607,797,810,416,313,68,337,391,82
86044,4996,2449,2547,1219,950,280,1134,1086,327
86045,10122,5042,5080,2595,2060,387,2209,2323,548
86046,5008,2569,2439,839,1345,385,716,1346,377
86047,14051,7449,6602,2888,3846,715,2646,2970,986
86052,36,19,17,2,17,0,0,17,0
86053,2491,1194,1297,633,467,94,668,542,87
86054,1473,697,776,326,273,98,368,325,83
86301,19825,10075,9750,2918,4176,2981,2096,4313,3341
86303,15889,7627,8262,1462,3604,2561,1501,3941,2820
86305,11412,5562,5850,1370,2486,1706,1125,2774,1951
86314,26793,13122,13671,4311,6217,2594,4193,6399,3079
86320,877,507,370,171,247,89,127,181,62
86321,1965,1005,960,338,563,104,327,516,117
86322,10347,5215,5132,1557,2342,1316,1361,2372,1399
86323,12520,6136,6384,1986,2975,1175,1885,3212,1287
86324,3526,1718,1808,468,787,463,501,779,528
86325,3814,1801,2013,516,963,322,605,1094,314
86326,20375,9589,10786,2866,4232,2491,2723,4681,3382
86327,6862,3258,3604,670,1289,1299,709,1470,1425
86331,281,130,151,23,86,21,29,104,18
86332,950,492,458,88,202,202,94,191,173
86333,4966,2500,2466,626,1055,819,624,1183,659
86334,2767,1358,1409,487,687,184,597,671,141
86335,2986,1442,1544,305,753,384,362,778,404
86336,11355,5316,6039,896,2713,1707,949,2978,2112
86337,962,469,493,121,226,122,114,276,103
86338,372,168,204,41,83,44,40,115,49
86343,143,85,58,21,52,12,7,41,10
86351,5552,2514,3038,384,1124,1006,396,1406,1236
86401,38587,19003,19584,5446,9179,4378,5457,9308,4819
86403,13078,6321,6757,1576,2772,1973,1668,2842,2247
86404,13146,6699,6447,1524,2878,2297,1332,2912,2203
86406,18506,8937,9569,2130,3727,3080,1897,4433,3239
86413,7860,4025,3835,1058,1978,989,885,1973,977
86426,8876,4413,4463,1209,2118,1086,1274,2104,1085
86429,4528,2372,2156,490,1241,641,440,1049,667
86430,54,32,22,0,18,14,0,7,15
86431,353,199,154,44,70,85,10,69,75
86432,1144,589,555,168,316,105,174,259,122
86433,75,28,47,0,9,19,0,23,24
86434,1613,785,828,370,348,67,371,367,90
86435,444,229,215,109,117,3,101,96,18
86436,1808,941,867,143,325,473,86,355,426
86437,27,12,15,2,5,5,0,8,7
86438,310,159,151,26,74,59,45,57,49
86440,6736,3352,3384,947,1603,802,954,1652,778
86441,2326,1212,1114,214,488,510,186,446,482
86442,29488,14467,15021,4014,6876,3577,3894,7176,3951
86444,913,472,441,66,173,233,82,184,175
86502,1392,728,664,323,327,78,321,263,80
86503,11408,5607,5801,2891,2263,453,2731,2521,549
86504,5197,2467,2730,1146,1189,132,1157,1288,285
86505,9472,4712,4760,2208,1987,517,2070,2056,634
86506,1463,692,771,351,271,70,392,312,67
86507,2085,1014,1071,465,457,92,542,415,114
86508,1019,500,519,229,208,63,210,224,85
86510,5688,2900,2788,1518,1118,264,1246,1254,288
86511,3232,1535,1697,705,697,133,710,853,134
86512,2306,1120,1186,555,477,88,542,513,131
86514,3682,1812,1870,838,762,212,810,775,285
86515,4496,2285,2211,1139,1067,79,921,1155,135
86520,2476,1190,1286,657,432,101,652,453,181
86535,1341,666,675,343,253,70,353,237,85
86538,2537,1206,1331,607,490,109,663,582,86
86540,638,350,288,179,135,36,132,112,44
86544,1326,699,627,336,287,76,216,277,134
86545,1855,899,956,446,368,85,423,413,120
86547,884,452,432,276,121,55,191,169,72
86549,942,481,461,240,161,80,201,216,44
86556,1849,916,933,401,438,77,436,430,67
87001,3516,1725,1791,733,866,126,703,938,150
87002,20746,10003,10743,3407,4803,1793,3377,5098,2268
87004,8035,3798,4237,1364,2033,401,1528,2186,523
87005,1029,594,435,290,258,46,177,219,39
87006,647,392,255,140,191,61,74,128,53
87007,996,475,521,231,182,62,194,240,87
87008,3048,1580,1468,459,866,255,357,889,222
87010,811,372,439,65,251,56,101,257,81
87011,19,7,12,0,7,0,6,6,0
87012,408,200,208,79,88,33,76,93,39
87013,5419,2742,2677,1238,1108,396,1060,1248,369
87014,1608,826,782,310,411,105,290,420,72
87015,10737,5388,5349,1994,2903,491,1949,2932,468
87016,4467,2452,2015,698,1410,344,773,951,291
87017,477,247,230,73,117,57,78,101,51
87018,1158,538,620,246,221,71,296,243,81
87020,14122,6798,7324,2343,3429,1026,2495,3662,1167
87022,741,356,385,130,187,39,108,180,97
87023,712,335,377,93,185,57,128,161,88
87024,2235,1079,1156,473,543,63,433,578,145
87025,1571,725,846,172,427,126,234,467,145
87026,3303,1594,1709,663,797,134,706,817,186
87027,160,83,77,33,32,18,18,42,17
87028,193,102,91,41,55,6,35,42,14
87029,362,190,172,44,68,78,33,72,67
87031,36056,18384,17672,6807,9771,1806,6314,9258,2100
87032,333,157,176,59,84,14,78,86,12
87034,2721,1287,1434,560,585,142,573,651,210
87035,7206,3835,3371,1604,1725,506,999,1850,522
87036,1804,868,936,294,407,167,273,438,225
87037,919,459,460,155,239,65,208,150,102
87038,397,196,201,88,96,12,76,97,28
87040,492,207,285,63,107,37,89,124,72
87041,637,272,365,83,150,39,114,193,58
87042,3005,1465,1540,488,713,264,536,814,190
87043,3779,1780,1999,365,1076,339,433,1246,320
87044,452,222,230,74,127,21,79,118,33
87045,2246,1127,1119,612,418,97,589,431,99
87047,3259,1650,1609,465,964,221,442,992,175
87048,7823,3845,3978,1118,2130,597,1058,2192,728
87049,236,113,123,34,62,17,33,49,41
87052,3145,1628,1517,773,746,109,654,738,125
87053,804,380,424,139,171,70,145,206,73
87056,937,504,433,176,273,55,149,238,46
87059,10206,5137,5069,1568,3067,502,1624,2971,474
87060,105,58,47,35,23,0,25,22,0
87061,311,159,152,38,82,39,40,88,24
87062,1996,972,1024,379,460,133,434,490,100
87063,144,77,67,20,35,22,11,35,21
87064,100,49,51,10,32,7,9,30,12
87068,4597,2217,2380,714,1130,373,774,1201,405
87070,223,105,118,52,43,10,55,50,13
87072,728,324,404,134,133,57,180,155,69
87083,417,234,183,43,121,70,39,93,51
87102,22497,11514,10983,3432,6687,1395,3531,5402,2050
87104,11365,5362,6003,1607,2832,923,1628,3122,1253
87105,54073,26909,27164,10058,13506,3345,9309,13745,4110
87106,25645,12671,12974,3684,7722,1265,4304,6946,1724
87107,30699,14772,15927,4868,7589,2315,4602,8351,2974
87108,37660,18341,19319,5689,10325,2327,5597,10050,3672
87109,40986,19470,21516,6184,10355,2931,5916,11654,3946
87110,38514,18419,20095,4857,9692,3870,4689,9818,5588
87111,54511,26196,28315,7067,14081,5048,6744,15136,6435
87112,43671,20691,22980,6390,10866,3435,6284,11992,4704
87113,7427,3509,3918,1229,1940,340,1340,2097,481
87114,31520,15200,16320,4859,8655,1686,4935,9130,2255
87116,4167,2323,1844,1166,1157,0,947,895,2
87118,1081,532,549,267,265,0,269,280,0
87120,44414,21760,22654,8025,12159,1576,7341,13615,1698
87121,39176,18784,20392,7928,9796,1060,8402,10465,1525
87122,12816,6260,6556,1936,3401,923,1953,3659,944
87123,36618,17654,18964,5434,9499,2721,5385,9996,3583
87124,52731,25369,27362,9082,13007,3280,8728,14194,4440
87301,22632,10786,11846,4386,5278,1122,4523,5817,1506
87305,4936,2370,2566,1082,1129,159,1268,1009,289
87310,906,484,422,212,222,50,183,168,71
87311,3854,1876,1978,984,787,105,871,901,206
87312,810,390,420,204,137,49,136,227,57
87313,6346,2943,3403,1431,1279,233,1582,1455,366
87315,279,148,131,52,57,39,26,74,31
87316,1493,691,802,359,306,26,342,410,50
87317,1935,965,970,466,408,91,415,491,64
87319,1666,837,829,372,375,90,373,345,111
87320,728,338,390,102,188,48,142,191,57
87321,2720,1351,1369,611,573,167,583,594,192
87322,485,202,283,81,109,12,148,100,35
87323,4279,2184,2095,1099,887,198,957,899,239
87325,2375,1092,1283,448,534,110,560,583,140
87326,1200,624,576,259,304,61,177,337,62
87327,7756,3726,4030,1589,1864,273,1618,2042,370
87328,3139,1414,1725,744,549,121,944,678,103
87347,430,220,210,85,116,19,85,109,16
87357,0,0,0,0,0,0,0,0,0
87364,2755,1358,1397,629,558,171,555,607,235
87375,4316,2107,2209,1005,900,202,923,1093,193
87401,39344,19588,19756,7737,9518,2333,7079,9625,3052
87402,8516,4267,4249,1532,2243,492,1286,2414,549
87410,15733,8011,7722,2924,4119,968,2735,3844,1143
87412,718,419,299,171,197,51,89,183,27
87413,13481,6535,6946,2605,3160,770,2565,3434,947
87415,1600,760,840,242,387,131,272,416,152
87416,5180,2556,2624,1257,1139,160,1165,1222,237
87417,6365,3289,3076,1569,1442,278,1304,1490,282
87418,1123,578,545,247,311,20,152,345,48
87419,492,282,210,41,164,77,16,132,62
87420,10841,5244,5597,2506,2381,357,2417,2654,526
87421,1253,593,660,189,317,87,244,328,88
87455,1705,836,869,357,387,92,349,388,132
87461,1924,972,952,403,426,143,350,389,213
87501,40277,19243,21034,4507,11202,3534,4630,11843,4561
87505,69700,34156,35544,11055,19106,3995,10303,20061,5180
87510,1211,590,621,173,355,62,188,357,76
87511,2266,1139,1127,492,539,108,442,575,110
87512,198,92,106,33,49,10,37,44,25
87513,744,394,350,130,216,48,108,199,43
87514,1278,660,618,175,419,66,158,410,50
87515,315,169,146,73,73,23,47,73,26
87516,110,61,49,18,31,12,22,19,8
87517,227,146,81,35,92,19,20,52,9
87518,101,50,51,7,28,15,11,18,22
87519,446,198,248,57,94,47,80,100,68
87520,1708,861,847,245,435,181,204,458,185
87521,833,378,455,111,209,58,151,205,99
87522,3874,1967,1907,717,1038,212,570,1085,252
87524,251,123,128,31,66,26,50,47,31
87525,324,164,160,29,121,14,45,115,0
87527,1131,556,575,129,309,118,154,322,99
87528,2951,1428,1523,666,681,81,689,727,107
87529,2866,1494,1372,475,831,188,256,887,229
87530,1078,497,581,163,263,71,208,275,98
87531,466,218,248,55,117,46,35,133,80
87532,17231,8465,8766,2880,4402,1183,2803,4517,1446
87533,16,6,10,0,3,3,4,4,2
87535,1733,842,891,250,506,86,320,498,73
87537,2223,1168,1055,472,576,120,367,579,109
87539,297,162,135,40,103,19,26,77,32
87540,686,350,336,95,228,27,45,252,39
87543,277,146,131,42,80,24,68,52,11
87544,18352,9347,9005,2829,5043,1475,2409,4959,1637
87548,804,421,383,160,230,31,145,201,37
87549,1137,567,570,190,270,107,166,304,100
87551,391,209,182,48,100,61,41,86,55
87552,3210,1680,1530,576,892,212,446,908,176
87553,1453,713,740,223,364,126,218,381,141
87556,2487,1178,1309,365,637,176,407,666,236
87557,5691,2803,2888,908,1454,441,744,1691,453
87558,631,278,353,49,153,76,74,174,105
87560,1179,573,606,187,285,101,181,322,103
87562,479,284,195,144,110,30,61,113,21
87564,413,217,196,61,142,14,66,93,37
87565,993,514,479,162,285,67,127,253,99
87566,3371,1638,1733,614,868,156,636,862,235
87567,2333,1228,1105,467,645,116,362,575,168
87569,420,211,209,86,121,4,103,93,13
87571,10397,4976,5421,1512,2677,787,1536,2833,1052
87573,7,0,7,0,0,0,0,0,7
87575,654,360,294,119,175,66,69,155,70
87577,318,145,173,37,82,26,44,102,27
87578,1310,664,646,206,315,143,189,310,147
87579,649,319,330,122,124,73,128,135,67
87580,268,158,110,53,85,20,18,64,28
87581,109,56,53,22,30,4,9,27,17
87582,1823,879,944,296,463,120,306,440,198
87583,217,113,104,34,42,37,26,59,19
87701,20318,9729,10589,3363,4979,1387,3693,5040,1856
87710,1499,749,750,200,389,160,179,429,142
87711,880,437,443,141,202,94,187,150,106
87712,479,243,236,77,94,72,100,78,58
87713,148,78,70,8,53,17,6,37,27
87714,1230,641,589,200,307,134,165,278,146
87715,461,242,219,70,87,85,51,106,62
87718,554,303,251,79,165,59,64,141,46
87722,419,211,208,43,126,42,83,103,22
87723,654,341,313,114,167,60,114,133,66
87724,145,90,55,59,24,7,0,55,0
87728,454,231,223,72,100,59,60,110,53
87729,118,62,56,12,37,13,14,30,12
87730,34,13,21,0,8,5,5,6,10
87731,524,164,360,134,24,6,247,101,12
87732,1387,664,723,253,306,105,245,306,172
87733,294,163,131,40,85,38,16,66,49
87734,226,129,97,45,46,38,8,54,35
87735,92,50,42,15,22,13,9,13,20
87736,228,92,136,31,47,14,31,92,13
87740,8404,4121,4283,1290,1927,904,1242,1972,1069
87742,647,361,286,76,188,97,82,114,90
87743,444,210,234,55,68,87,55,87,92
87745,943,511,432,192,256,63,125,244,63
87747,1930,1098,832,500,392,206,207,376,249
87750,77,52,25,46,3,3,18,7,0
87752,508,290,218,96,128,66,48,104,66
87753,216,98,118,31,54,13,26,66,26
87801,10169,5193,4976,2019,2528,646,1665,2436,875
87820,164,75,89,25,39,11,28,41,20
87821,490,260,230,64,122,74,39,145,46
87823,1131,575,556,133,322,120,143,305,108
87824,208,94,114,22,33,39,32,46,36
87825,2835,1376,1459,575,635,166,588,668,203
87827,106,58,48,10,25,23,7,24,17
87828,388,196,192,74,90,32,70,103,19
87829,996,512,484,156,234,122,125,245,114
87830,991,511,480,123,233,155,94,239,147
87831,229,120,109,24,76,20,17,55,37
87832,728,382,346,112,190,80,89,175,82
87901,7832,3852,3980,1002,1519,1331,946,1648,1386
87930,704,388,316,183,152,53,153,119,44
87931,649,323,326,72,162,89,48,187,91
87933,158,89,69,19,49,21,25,27,17
87935,1793,905,888,108,349,448,63,393,432
87936,480,234,246,78,120,36,101,108,37
87937,3513,1706,1807,756,725,225,802,770,235
87939,211,112,99,47,46,19,21,58,20
87940,524,262,262,102,112,48,102,126,34
87941,1096,581,515,307,200,74,245,203,67
87942,1421,674,747,174,319,181,204,333,210
87943,148,100,48,22,23,55,0,6,42
88001,35571,17105,18466,7013,7870,2222,6876,8594,2996
88002,1438,757,681,308,444,5,323,353,5
88003,1620,781,839,692,89,0,800,39,0
88004,801,801,0,85,711,5,0,0,0
88005,45940,22518,23422,7382,11778,3358,7595,11703,4124
88008,5677,2680,2997,938,1422,320,1247,1426,324
88009,228,135,93,54,77,4,35,57,1
88011,17559,8517,9042,2654,4213,1650,2410,4648,1984
88012,15519,7503,8016,2864,3790,849,3032,4106,878
88020,1098,552,546,208,247,97,225,246,75
88021,25884,12790,13094,5918,5581,1291,5652,6085,1357
88022,116,68,48,43,20,5,20,24,4
88023,2636,1245,1391,477,511,257,445,618,328
88024,951,471,480,216,188,67,250,136,94
88025,502,242,260,75,98,69,78,141,41
88026,1822,851,971,355,351,145,339,451,181
88027,243,138,105,63,65,10,57,38,10
88029,2084,1058,1026,467,393,198,432,449,145
88030,22932,11012,11920,3693,4577,2742,3970,5153,2797
88033,45,23,22,0,19,4,10,7,5
88036,208,102,106,38,64,0,40,66,0
88038,196,119,77,58,51,10,8,63,6
88039,588,314,274,75,157,82,49,149,76
88040,66,27,39,0,17,10,22,0,17
88041,1593,797,796,154,392,251,196,376,224
88042,311,167,144,15,65,87,23,69,52
88043,2185,1076,1109,351,417,308,304,496,309
88044,3305,1592,1713,525,766,301,573,824,316
88045,3914,1922,1992,749,851,322,690,917,385
88047,1546,753,793,268,403,82,279,426,88
88048,5329,2631,2698,1258,1167,206,1215,1274,209
88049,609,335,274,58,180,97,71,124,79
88051,56,30,26,0,13,17,0,18,8
88052,167,109,58,15,62,32,9,44,5
88053,301,138,163,25,78,35,35,102,26
88055,110,51,59,12,27,12,26,19,14
88056,241,138,103,37,70,31,15,64,24
88061,20244,9881,10363,3291,4786,1804,3062,5207,2094
88063,10274,4782,5492,2330,1895,557,2209,2551,732
88065,351,194,157,55,69,70,33,72,52
88072,986,553,433,309,200,44,176,206,51
88101,41998,20800,21198,7932,10284,2584,7430,10293,3475
88112,138,76,62,18,41,17,13,24,25
88113,66,33,33,9,13,11,9,15,9
88114,63,25,38,7,8,10,6,16,16
88115,98,51,47,19,19,13,19,16,12
88116,548,259,289,70,111,78,69,134,86
88118,234,128,106,46,51,31,28,53,25
88119,2163,1036,1127,308,439,289,288,446,393
88120,311,153,158,41,91,21,39,87,32
88121,139,79,60,20,31,28,5,27,28
88124,1252,638,614,210,298,130,175,289,150
88125,91,54,37,28,26,0,15,22,0
88126,26,12,14,0,9,3,3,9,2
88130,16708,8151,8557,3272,3758,1121,3131,3938,1488
88132,274,142,132,55,51,36,45,61,26
88134,56,37,19,14,12,11,4,13,2
88135,1597,781,816,305,364,112,294,374,148
88136,34,21,13,0,9,12,0,8,5
88201,53166,25889,27277,9642,11724,4523,8780,12669,5828
88210,15770,7832,7938,3029,3670,1133,2712,3811,1415
88213,12,6,6,3,3,0,0,4,2
88220,33185,16034,17151,5537,7650,2847,5216,8242,3693
88230,5218,2568,2650,1025,1221,322,1026,1274,350
88231,2920,1435,1485,490,741,204,532,676,277
88232,2758,1427,1331,555,667,205,519,591,221
88240,31315,15464,15851,5817,7471,2176,5678,7218,2955
88242,5145,2735,2410,1000,1371,364,794,1339,277
88250,264,155,109,37,82,36,14,80,15
88252,2102,1020,1082,348,462,210,357,468,257
88253,281,162,119,86,68,8,52,60,7
88254,92,53,39,0,16,37,0,13,26
88255,84,48,36,9,39,0,6,30,0
88256,1921,942,979,373,436,133,396,414,169
88260,12379,6220,6159,2419,2863,938,2187,2841,1131
88262,91,43,48,8,19,16,18,19,11
88263,75,47,28,11,23,13,0,23,5
88264,0,0,0,0,0,0,0,0,0
88265,312,155,157,59,58,38,57,65,35
88267,1172,562,610,216,227,119,239,256,115
88268,55,36,19,21,15,0,4,15,0
88301,1484,775,709,192,386,197,164,346,199
88310,41005,20169,20836,6787,10339,3043,6939,10192,3705
88312,1223,616,607,164,265,187,104,400,103
88314,233,113,120,32,73,8,32,81,7
88316,2258,1136,1122,373,558,205,305,560,257
88317,1940,983,957,267,420,296,201,495,261
88318,359,156,203,30,83,43,61,82,60
88321,300,171,129,33,87,51,28,70,31
88323,55,50,5,43,7,0,0,5,0
88324,104,45,59,3,22,20,23,21,15
88325,1064,531,533,124,279,128,131,307,95
88330,2154,1265,889,551,704,10,489,391,9
88336,249,129,120,38,65,26,46,58,16
88337,2429,1156,1273,358,565,233,395,640,238
88338,76,29,47,4,11,14,10,17,20
88339,326,166,160,28,93,45,25,77,58
88340,3091,1478,1613,771,645,62,759,759,95
88341,540,293,247,88,146,59,41,164,42
88343,60,33,27,8,19,6,7,15,5
88344,228,101,127,13,33,55,34,75,18
88345,9525,4538,4987,1072,2229,1237,1154,2365,1468
88346,2751,1307,1444,487,664,156,493,729,222
88347,119,44,75,12,22,10,13,34,28
88348,604,299,305,85,152,62,105,147,53
88350,244,129,115,44,36,49,16,42,57
88351,123,56,67,12,34,10,16,26,25
88352,4944,2383,2561,734,1089,560,786,1262,513
88353,629,269,360,88,128,53,133,159,68
88354,202,107,95,42,49,16,35,45,15
88401,7807,3740,4067,1145,1792,803,1115,1881,1071
88410,171,113,58,34,54,25,3,34,21
88411,83,47,36,10,32,5,12,13,11
88414,82,42,40,7,22,13,7,21,12
88415,2978,1506,1472,493,686,327,429,678,365
88416,358,196,162,27,48,121,0,76,86
88417,15,6,9,0,0,6,0,0,9
88418,404,160,244,47,81,32,80,121,43
88419,147,79,68,39,32,8,22,30,16
88421,31,13,18,0,0,13,0,0,18
88422,8,4,4,0,4,0,0,4,0
88424,47,25,22,6,15,4,5,9,8
88426,1242,611,631,184,254,173,158,281,192
88427,135,68,67,13,42,13,27,23,17
88430,104,61,43,21,28,12,10,26,7
88431,42,28,14,0,15,13,0,14,0
88434,452,198,254,68,97,33,91,110,53
88435,3400,1946,1454,549,1129,268,480,693,281
88436,286,143,143,64,58,21,59,61,23
88437,51,22,29,2,8,12,10,7,12
89001,1072,520,552,169,209,142,203,261,88
89003,1090,580,510,200,239,141,145,294,71
89004,307,147,160,19,97,31,33,92,35
89005,15002,7426,7576,1729,3479,2218,1710,3541,2325
89007,1086,562,524,263,244,55,228,229,67
89008,1335,676,659,286,252,138,246,301,112
89010,345,203,142,69,85,49,27,79,36
89011,206,108,98,12,63,33,11,69,18
89012,16201,7918,8283,1656,4352,1910,1845,4590,1848
89013,403,217,186,40,92,85,32,102,52
89014,81895,40466,41429,12449,22819,5198,11911,23807,5711
89015,64709,32139,32570,10440,17173,4526,10086,17425,5059
89017,22,7,15,0,0,7,0,7,8
89018,1337,667,670,226,308,133,248,325,97
89019,2891,1713,1178,282,1063,368,278,639,261
89020,1142,588,554,179,325,84,188,281,85
89021,2202,1136,1066,536,484,116,450,491,125
89022,1973,1110,863,418,620,72,296,500,67
89024,395,189,206,50,116,23,72,105,29
89025,1493,755,738,333,360,62,348,350,40
89027,9504,4765,4739,1403,2091,1271,1410,2211,1118
89028,16,12,4,0,4,8,0,2,2
89029,6820,3383,3437,769,1730,884,719,1903,815
89030,53794,28186,25608,12068,13958,2160,11070,12104,2434
89031,34635,17487,17148,6244,9872,1371,5705,9998,1445
89032,27146,13265,13881,4843,7179,1243,5125,7496,1260
89039,366,180,186,9,63,108,26,71,89
89040,4366,2255,2111,762,965,528,654,925,532
89042,785,374,411,138,124,112,104,171,136
89043,939,577,362,155,339,83,104,170,88
89046,1021,537,484,14,310,213,44,218,222
89047,177,99,78,35,54,10,39,29,10
89048,24794,12514,12280,3055,5667,3792,2907,5785,3588
89049,2981,1573,1408,394,948,231,437,717,254
89052,14490,7241,7249,1846,4438,957,1581,4820,848
89101,52628,30795,21833,9730,18008,3057,8314,11043,2476
89102,37522,19493,18029,5712,10811,2970,5232,9230,3567
89103,46308,23723,22585,6024,14152,3547,5532,12564,4489
89104,39433,20421,19012,6225,10691,3505,5475,9308,4229
89106,25772,13372,12400,4946,6764,1662,4240,6342,1818
89107,36511,18213,18298,5763,9655,2795,5631,9255,3412
89108,66215,32673,33542,10977,18070,3626,10804,18188,4550
89109,40626,22742,17884,5201,13987,3554,4486,9852,3546
89110,62159,30660,31499,11624,15719,3317,11588,16423,3488
89113,8222,4078,4144,979,2437,662,910,2575,659
89115,51485,26347,25138,11153,13610,1584,10209,13238,1691
89117,51855,25554,26301,6854,14641,4059,6588,15434,4279
89118,16702,8545,8157,2234,5377,934,2077,4925,1155
89119,49105,26256,22849,7235,15737,3284,6793,12525,3531
89120,21576,10810,10766,2898,6147,1765,2712,6125,1929
89121,62149,30851,31298,8168,16546,6137,7637,16492,7169
89122,24926,12380,12546,3386,6148,2846,3177,6102,3267
89123,46736,23662,23074,6907,14150,2605,6117,14116,2841
89124,1534,824,710,274,426,124,155,434,121
89128,40443,19698,20745,6013,11244,2441,6005,11918,2822
89129,32351,15760,16591,5310,8734,1716,5133,9512,1946
89130,24702,12191,12511,3607,6559,2025,3352,6961,2198
89131,10966,5641,5325,1755,3360,526,1684,3092,549
89134,25148,11899,13249,2078,3864,5957,1938,4920,6391
89135,3483,1738,1745,444,1066,228,262,1272,211
89139,1897,971,926,181,605,185,227,557,142
89141,318,178,140,65,105,8,45,81,14
89142,22670,11109,11561,4162,5922,1025,4184,6107,1270
89143,2437,1193,1244,411,702,80,377,804,63
89144,11689,5709,5980,1538,3479,692,1609,3643,728
89145,19651,9768,9883,3220,5173,1375,2853,5421,1609
89146,18066,8955,9111,2397,5114,1444,2305,5274,1532
89147,39320,19359,19961,5301,11613,2445,5446,11798,2717
89148,914,486,428,143,296,47,104,278,46
89149,11346,5643,5703,1571,3143,929,1545,3281,877
89156,22565,11198,11367,3808,6206,1184,3592,6411,1364
89191,3801,2506,1295,764,1697,45,610,677,8
89301,7358,4247,3111,1163,2548,536,995,1430,686
89310,427,203,224,26,133,44,43,110,71
89311,139,41,98,0,14,27,9,56,33
89314,148,71,77,32,30,9,30,33,14
89316,1123,569,554,194,304,71,193,276,85
89317,367,205,162,89,82,34,55,81,26
89318,1302,649,653,160,288,201,162,309,182
89403,8346,4239,4107,1367,2193,679,1227,2178,702
89404,76,47,29,37,10,0,0,17,12
89405,404,241,163,89,133,19,62,86,15
89406,23946,11862,12084,3912,6122,1828,4118,5931,2035
89408,8651,4309,4342,1472,2219,618,1447,2257,638
89409,408,207,201,83,79,45,51,100,50
89410,20193,10077,10116,3253,4936,1888,2902,5232,1982
89411,566,288,278,86,122,80,87,120,71
89413,366,193,173,22,94,77,0,100,73
89414,422,202,220,48,135,19,82,103,35
89415,3965,1968,1997,490,956,522,506,962,529
89418,450,246,204,91,111,44,36,105,63
89419,5074,3294,1780,829,2148,317,598,892,290
89420,44,25,19,0,16,9,0,19,0
89421,543,302,241,129,122,51,78,124,39
89422,212,122,90,16,73,33,4,60,26
89423,8273,4117,4156,1092,2127,898,1088,2226,842
89424,495,226,269,117,86,23,102,115,52
89425,448,266,182,92,142,32,48,95,39
89426,386,209,177,68,109,32,65,81,31
89427,850,447,403,224,167,56,137,190,76
89428,213,116,97,39,65,12,22,67,8
89429,6725,3363,3362,907,1757,699,918,1873,571
89430,450,232,218,92,117,23,86,96,36
89431,36181,18080,18101,5807,9960,2313,5941,9077,3083
89433,19812,9902,9910,3559,5375,968,3476,5289,1145
89434,21574,10429,11145,3358,5711,1360,3391,5801,1953
89436,21482,10791,10691,3613,6181,997,3536,6266,889
89439,1161,610,551,121,321,168,124,296,131
89440,1030,512,518,127,283,102,134,283,101
89442,1017,538,479,193,233,112,172,224,83
89444,2658,1443,1215,366,616,461,291,643,281
89445,15376,8036,7340,2902,4425,709,2661,3939,740
89447,7920,4055,3865,1380,1650,1025,1073,1636,1156
89448,2566,1394,1172,258,782,354,239,687,246
89449,3759,1998,1761,420,1339,239,417,1031,313
89451,9639,5067,4572,1323,2769,975,1119,2689,764
89501,2935,1841,1094,244,1257,340,230,672,192
89502,45896,23739,22157,7148,13967,2624,6970,11940,3247
89503,30470,15742,14728,4546,8979,2217,4442,7869,2417
89506,33125,17268,15857,6081,9495,1692,5172,9242,1443
89509,41422,20172,21250,4756,11193,4223,4929,11274,5047
89510,1417,694,723,200,384,110,251,353,119
89511,28726,14197,14529,4154,7919,2124,3746,8567,2216
89512,23610,12060,11550,4359,6103,1598,4027,5539,1984
89523,17242,8573,8669,2800,4981,792,2658,5122,889
89701,26685,14447,12238,3896,8635,1916,3714,6266,2258
89703,9254,4411,4843,1094,2136,1181,1133,2283,1427
89704,4240,2157,2083,530,1299,328,606,1258,219
89705,4073,1948,2125,561,993,394,598,1095,432
89706,18235,9021,9214,2776,4657,1588,2549,4670,1995
89801,20711,10699,10012,3902,5769,1028,3559,5244,1209
89803,162,83,79,37,40,6,19,45,15
89815,11640,5881,5759,2199,3322,360,2274,3184,301
89820,5367,2749,2618,1040,1471,238,990,1351,277
89821,487,271,216,62,136,73,53,100,63
89822,2347,1268,1079,359,785,124,407,528,144
89823,195,116,79,43,44,29,33,37,9
89824,22,13,9,0,0,13,0,9,0
89825,1326,667,659,247,354,66,282,326,51
89826,48,35,13,16,9,10,0,13,0
89828,220,110,110,34,61,15,10,76,24
89830,287,183,104,49,107,27,39,52,13
89831,65,34,31,8,17,9,8,16,7
89832,1044,623,421,341,212,70,147,228,46
89833,170,77,93,25,48,4,28,55,10
89834,269,175,94,42,110,23,14,71,9
89835,1835,1037,798,315,573,149,243,422,133
89883,4829,2511,2318,1140,1264,107,1037,1175,106
90001,54587,27327,27260,13263,12491,1573,12392,12566,2302
90002,44342,21355,22987,10659,9230,1466,10408,10245,2334
90003,59003,29087,29916,13923,13410,1754,13431,13908,2577
90004,67859,34099,33760,11374,19971,2754,10429,19274,4057
90005,43032,22093,20939,7325,12914,1854,6251,11985,2703
90006,62535,31755,30780,11750,17739,2266,10968,16542,3270
90007,44689,22460,22229,10663,10661,1136,10430,9753,2046
90008,30996,13325,17671,4541,6342,2442,4728,9114,3829
90010,1876,982,894,195,597,190,152,508,234
90011,101770,51659,50111,24511,24691,2457,23063,23582,3466
90012,30332,18266,12066,3362,13010,1894,2543,6912,2611
90013,9504,6435,3069,487,4999,949,412,1849,808
90014,3690,2302,1388,123,1421,758,60,631,697
90015,15367,8028,7339,2932,4584,512,2733,3733,873
90016,47019,21711,25308,8499,10849,2363,8515,12803,3990
90017,20699,11597,9102,4668,6144,785,3453,4700,949
90018,46890,22047,24843,8874,10920,2253,8659,12315,3869
90019,67917,32882,35035,10944,18502,3436,10211,19434,5390
90020,42376,21374,21002,6191,13443,1740,5857,13092,2053
90021,2780,1967,813,222,1592,153,147,614,52
90022,68596,34306,34290,14679,16612,3015,13819,15939,4532
90023,47582,23988,23594,10285,11893,1810,10016,11071,2507
90024,44088,20852,23236,7514,10675,2663,8790,10885,3561
90025,41195,20730,20465,3242,14830,2658,2825,14369,3271
90026,73410,36918,36492,12134,21222,3562,11642,19861,4989
90027,48887,24227,24660,4961,15676,3590,5196,14585,4879
90028,30337,16792,13545,3770,11458,1564,3296,8162,2087
90029,41643,21435,20208,7438,12029,1968,6148,11154,2906
90031,38716,18981,19735,7504,9417,2060,7483,9492,2760
90032,46837,23056,23781,8858,11659,2539,8666,11874,3241
90033,49582,25228,24354,11156,11971,2101,10226,11033,3095
90034,58055,28461,29594,7306,18975,2180,7413,18920,3261
90035,27754,13142,14612,3063,7923,2156,2731,8700,3181
90036,33226,16177,17049,2939,11172,2066,2823,11190,3036
90037,56776,28397,28379,12765,13712,1920,11744,13667,2968
90038,32729,17354,15375,5311,10825,1218,5087,8704,1584
90039,29279,14922,14357,3959,8958,2005,3605,8336,2416
90040,9737,4710,5027,1830,2284,596,1867,2259,901
90041,27875,13443,14432,4331,7261,1851,4119,7387,2926
90042,64828,32006,32822,11930,17223,2853,11674,17318,3830
90043,44875,20579,24296,7605,10006,2968,7694,12122,4480
90044,86075,40445,45630,19108,18031,3306,19246,21332,5052
90045,39314,19051,20263,5988,10527,2536,5621,11351,3291
90046,49870,26161,23709,2931,19092,4138,2759,15302,5648
90047,47992,22228,25764,9278,9851,3099,8240,13135,4389
90048,21380,10021,11359,1216,6861,1944,1133,7047,3179
90049,33560,15347,18213,2862,9159,3326,2785,11352,4076
90056,8038,3567,4471,1005,1717,845,991,2340,1140
90057,44102,23340,20762,7821,13475,2044,7057,11113,2592
90058,3495,1756,1739,837,823,96,777,807,155
90059,37956,17587,20369,8893,7410,1284,9240,9097,2032
90061,24788,12032,12756,5681,5233,1118,5542,5754,1460
90062,29236,13776,15460,5683,6637,1456,5628,7440,2392
90063,55797,27960,27837,12001,13574,2385,11065,13182,3590
90064,24227,11526,12701,2572,6930,2024,2629,7301,2771
90065,47309,23455,23854,8122,12707,2626,7933,12573,3348
90066,55556,27800,27756,6933,17321,3546,6237,16896,4623
90067,2573,1174,1399,98,420,656,115,490,794
90068,21514,11944,9570,1314,9096,1534,1189,6774,1607
90069,20404,11917,8487,511,9477,1929,633,5738,2116
90071,0,0,0,0,0,0,0,0,0
90077,10473,5222,5251,1211,2709,1302,1131,2812,1308
90201,105277,52819,52458,24269,25955,2595,23253,25377,3828
90210,21495,9993,11502,2237,5064,2692,2318,6130,3054
90211,8413,3941,4472,1083,2219,639,1108,2472,892
90212,11310,5050,6260,1256,2815,979,1196,3814,1250
90220,47576,22629,24947,10295,9915,2419,10232,11344,3371
90221,51396,25527,25869,12271,11705,1551,11875,12061,1933
90222,29799,14711,15088,6873,6413,1425,6560,6609,1919
90230,31908,15047,16861,4546,8124,2377,4103,9613,3145
90232,15121,7533,7588,2075,4555,903,1573,4596,1419
90240,24846,12142,12704,4240,5997,1905,3958,6450,2296
90241,39879,18901,20978,6580,9790,2531,6436,10846,3696
90242,42730,21014,21716,8225,10796,1993,7696,11275,2745
90245,15970,8006,7964,2168,5049,789,2040,4763,1161
90247,47317,23207,24110,7740,12379,3088,7469,12439,4202
90248,10269,5025,5244,1499,2541,985,1621,2455,1168
90249,26015,12716,13299,4262,6889,1565,4062,7305,1932
90250,93628,45133,48495,17845,23964,3324,16575,26961,4959
90254,18557,9680,8877,1167,7621,892,1212,6767,898
90255,77926,39051,38875,16718,19715,2618,16493,18932,3450
90260,33366,16796,16570,6451,9176,1169,5764,9165,1641
90261,0,0,0,0,0,0,0,0,0
90262,69918,35964,33954,16647,17554,1763,15175,16400,2379
90263,0,0,0,0,0,0,0,0,0
90265,19816,9730,10086,3000,5077,1653,3103,5288,1695
90266,33924,17067,16857,4227,10580,2260,3950,10376,2531
90270,28083,14316,13767,6406,7150,760,6080,6696,991
90272,22636,10777,11859,2972,5348,2457,2780,6249,2830
90274,24892,12023,12869,3262,5561,3200,3320,6386,3163
90275,41431,20049,21382,5447,9636,4966,5122,10830,5430
90277,34199,17215,16984,2968,11960,2287,2865,11248,2871
90278,37297,18481,18816,4669,12114,1698,4374,12133,2309
90280,96296,47658,48638,21030,23789,2839,20115,24301,4222
90290,5418,2656,2762,614,1745,297,642,1880,240
90291,31125,16450,14675,3066,11951,1433,2657,10379,1639
90292,17751,8988,8763,783,6468,1737,704,6142,1917
90293,11241,5492,5749,675,4000,817,722,4074,953
90301,37458,18082,19376,7442,9184,1456,6912,10338,2126
90302,30902,14323,16579,5756,7472,1095,5931,9132,1516
90303,27781,13575,14206,5985,6611,979,5765,7175,1266
90304,28385,14504,13881,6659,7081,764,6237,6784,860
90305,13763,6100,7663,1988,2922,1190,1951,4071,1641
90401,5134,2726,2408,272,2051,403,286,1534,588
90402,11200,5305,5895,1211,2838,1256,1279,3195,1421
90403,23686,11090,12596,1597,7551,1942,1518,8244,2834
90404,19994,9614,10380,2201,6229,1184,1899,6404,2077
90405,26142,12801,13341,2221,8887,1693,2182,8920,2239
90501,40395,20286,20109,7353,11069,1864,6603,10935,2571
90502,17119,8120,8999,2437,4352,1331,2494,4891,1614
90503,42042,20364,21678,5749,11401,3214,5275,12041,4362
90504,31689,15661,16028,4865,8488,2308,4240,8726,3062
90505,34727,16673,18054,4666,9059,2948,4465,9691,3898
90601,31953,15015,16938,4881,8125,2009,5126,9004,2808
90602,26224,12708,13516,5034,6384,1290,5085,6633,1798
90603,19184,9373,9811,3051,4582,1740,2700,4762,2349
90604,37873,18639,19234,7174,9310,2155,6443,9960,2831
90605,38349,19169,19180,7591,9690,1888,7249,9494,2437
90606,32426,16430,15996,6938,7679,1813,5689,7847,2460
90620,44535,21956,22579,7571,11444,2941,7044,11734,3801
90621,33556,16735,16821,6471,8997,1267,6060,8925,1836
90623,15217,7592,7625,2314,4069,1209,2065,4308,1252
90630,47617,22939,24678,7681,12210,3048,7626,13105,3947
90631,67164,32979,34185,11522,17153,4304,11268,17149,5768
90638,47507,22967,24540,8281,11291,3395,7731,11855,4954
90640,62304,29951,32353,10818,15092,4041,10588,15766,5999
90650,103183,51187,51996,20584,25615,4988,18977,25805,7214
90660,63028,30735,32293,11606,15160,3969,11702,15459,5132
90670,16355,8116,8239,2712,4252,1152,2714,3881,1644
90680,29522,14810,14712,5504,7840,1466,5086,7218,2408
90701,16380,8241,8139,2919,4248,1074,2524,4045,1570
90703,51510,24887,26623,7769,13653,3465,7510,15103,4010
90704,3696,1890,1806,666,1024,200,595,955,256
90706,72829,35494,37335,13828,18266,3400,13440,19260,4635
90710,24991,12237,12754,4266,6343,1628,4233,6690,1831
90712,30182,14455,15727,4865,7647,1943,4730,8113,2884
90713,27656,13353,14303,4406,7010,1937,4153,7559,2591
90715,21023,10345,10678,4141,5228,976,3507,5909,1262
90716,14872,7837,7035,3645,3629,563,2909,3442,684
90717,21057,10051,11006,3142,5697,1212,3006,6173,1827
90720,21004,9982,11022,3184,4972,1826,2966,5643,2413
90723,55317,27000,28317,11868,13537,1595,12110,13871,2336
90731,58591,29520,29071,9914,16406,3200,9437,15696,3938
90732,21188,10107,11081,2715,5377,2015,2452,5830,2799
90740,24308,10615,13693,2010,4887,3718,1898,5218,6577
90742,1116,639,477,65,456,118,25,358,94
90743,139,74,65,22,29,23,8,27,30
90744,53271,26809,26462,11619,13316,1874,10978,12805,2679
90745,55426,27277,28149,10076,13737,3464,8784,14545,4820
90746,25390,11786,13604,4045,5789,1952,4240,6896,2468
90802,38731,19954,18777,5258,12738,1958,5466,11075,2236
90803,31174,15448,15726,2034,11019,2395,1891,10980,2855
90804,43264,20866,22398,8096,11632,1138,8437,12134,1827
90805,91456,44397,47059,19778,21630,2989,18660,23728,4671
90806,49516,24379,25137,10389,12074,1916,10017,12562,2558
90807,31819,14954,16865,4343,8478,2133,4421,9150,3294
90808,37062,17869,19193,5406,9436,3027,4997,10361,3835
90810,35627,17374,18253,7351,8136,1887,6765,8748,2740
90813,62941,31805,31136,15325,14815,1665,14261,14417,2458
90814,19198,9182,10016,2018,6242,922,2154,6374,1488
90815,39087,18358,20729,5335,9969,3054,5991,10449,4289
90822,400,321,79,57,119,145,79,0,0
91001,36310,17307,19003,5774,9223,2310,5541,10179,3283
91006,30165,14602,15563,4614,7419,2569,4181,8201,3181
91007,30901,14152,16749,4093,7361,2698,3810,8694,4245
91010,27364,13008,14356,4612,6602,1794,4796,7006,2554
91011,20317,9840,10477,3344,4684,1812,3265,5156,2056
91016,41029,19718,21311,6862,10660,2196,6305,11532,3474
91020,7343,3132,4211,810,1906,416,997,2267,947
91024,10536,4880,5656,1132,2866,882,1102,3289,1265
91030,23893,11109,12784,3165,6399,1545,3057,7591,2136
91040,18624,9152,9472,2543,5163,1446,2560,5155,1757
91042,26689,13210,13479,4250,7413,1547,4047,7436,1996
91101,16760,8163,8597,1771,5521,871,1635,5325,1637
91103,27430,13458,13972,5248,6691,1519,4668,7086,2218
91104,38615,18965,19650,6343,10506,2116,5941,10826,2883
91105,10243,4946,5297,858,2704,1384,806,2787,1704
91106,23644,11592,12052,2901,7399,1292,2778,7384,1890
91107,32512,15738,16774,4344,8886,2508,3729,9421,3624
91108,13347,6318,7029,2135,2860,1323,2039,3500,1490
91201,23886,11491,12395,3465,6553,1473,3411,6839,2145
91202,22066,10363,11703,2842,5563,1958,2743,6320,2640
91203,14497,6959,7538,2088,3960,911,1883,4210,1445
91204,17006,8317,8689,2499,4915,903,2537,4725,1427
91205,41431,19728,21703,6390,10663,2675,6043,11588,4072
91206,31152,14623,16529,3785,8175,2663,3429,8979,4121
91207,9840,4821,5019,1149,2621,1051,988,2917,1114
91208,16998,8093,8905,2160,4538,1395,2120,4827,1958
91214,29174,13905,15269,4478,7408,2019,4622,8106,2541
91301,25104,12519,12585,4596,6743,1180,3984,7356,1245
91302,23645,11471,12174,3921,6095,1455,3599,7061,1514
91303,23259,12082,11177,4331,7030,721,4033,6205,939
91304,49768,24817,24951,8555,13561,2701,7845,13407,3699
91306,43774,21946,21828,7286,12396,2264,6946,11764,3118
91307,23426,11677,11749,3572,6083,2022,3132,6184,2433
91311,34985,17120,17865,4761,9544,2815,4318,10136,3411
91316,27756,13186,14570,2780,7554,2852,2851,8052,3667
91320,37754,18754,19000,6093,10558,2103,5587,10648,2765
91321,30337,15283,15054,5449,8252,1582,4582,7771,2701
91324,25779,12818,12961,4384,6569,1865,3624,7023,2314
91325,32417,15773,16644,4952,8705,2116,5370,8719,2555
91326,28078,13602,14476,3950,7378,2274,4013,8078,2385
91331,97450,49316,48134,20863,24543,3910,19899,23140,5095
91335,68133,33239,34894,11105,18340,3794,10969,18340,5585
91340,33878,17095,16783,7373,8511,1211,6645,8174,1964
91342,81388,40863,40525,16143,20891,3829,14758,20881,4886
91343,57055,28305,28750,10803,14736,2766,10653,14443,3654
91344,48391,23722,24669,7286,12635,3801,6544,13572,4553
91345,17354,8482,8872,2787,4486,1209,2787,4374,1711
91350,39781,19915,19866,7720,10672,1523,6917,11073,1876
91351,59530,29338,30192,10977,16338,2023,10851,16837,2504
91352,46296,23484,22812,9114,12327,2043,8641,11525,2646
91354,17832,8833,8999,3345,5032,456,3126,5314,559
91355,25144,12135,13009,3940,6761,1434,3716,7228,2065
91356,27235,12964,14271,3623,6936,2405,3219,7875,3177
91360,42513,20822,21691,6912,10857,3053,6455,11147,4089
91361,18840,9358,9482,2439,4871,2048,2108,5081,2293
91362,33133,16103,17030,5224,8913,1966,4948,9774,2308
91364,25766,12748,13018,3080,7238,2430,2773,7529,2716
91367,36373,17562,18811,4082,9828,3652,3924,10425,4462
91377,14738,7072,7666,2755,3835,482,2644,4434,588
91381,10200,5251,4949,1843,3086,322,1557,3050,342
91384,22098,14905,7193,4180,10172,553,2691,4088,414
91401,40465,20113,20352,6451,11484,2178,6221,11300,2831
91402,66240,33235,33005,14150,16923,2162,13064,16611,3330
91403,21953,10444,11509,1830,6885,1729,1937,7201,2371
91405,50873,25536,25337,9655,13960,1921,8958,13488,2891
91406,50167,25424,24743,8932,14330,2162,8031,13741,2971
91411,23683,11978,11705,3743,7284,951,3692,6757,1256
91423,29336,13847,15489,2573,9045,2229,2841,9535,3113
91436,13188,6363,6825,1523,3124,1716,1498,3484,1843
91501,18305,8571,9734,2448,5032,1091,2425,5822,1487
91502,11545,5717,5828,1742,3326,649,1516,3209,1103
91504,25796,12506,13290,3677,6848,1981,3692,7269,2329
91505,29259,14359,14900,3550,8921,1888,3221,8825,2854
91506,18310,8943,9367,2510,5108,1325,1999,5199,2169
91601,36498,18208,18290,5328,11434,1446,5660,10658,1972
91602,16752,8426,8326,1380,6083,963,1193,5942,1191
91604,26324,12911,13413,2116,8630,2165,2121,8621,2671
91605,57351,28884,28467,11437,14934,2513,10901,14392,3174
91606,45396,22908,22488,8151,12563,2194,7378,12061,3049
91607,28067,13437,14630,3200,8423,1814,3178,8750,2702
91608,0,0,0,0,0,0,0,0,0
91701,38913,18985,19928,6912,10234,1839,6829,10821,2278
91702,57505,28641,28864,12038,14392,2211,11691,14070,3103
91706,76941,38359,38582,16358,19271,2730,15579,19107,3896
91709,66693,33292,33401,12966,18587,1739,11890,19270,2241
91710,75615,40469,35146,13745,23903,2821,12109,19521,3516
91711,34374,16283,18091,5935,7743,2605,5861,8501,3729
91719,179,124,55,0,66,58,0,17,38
91722,33971,16576,17395,6375,8549,1652,5766,9166,2463
91723,17601,8222,9379,3089,4221,912,2951,5091,1337
91724,24663,12085,12578,4176,6334,1575,3957,6550,2071
91730,52525,27033,25492,10003,15331,1699,8355,14598,2539
91731,29964,14910,15054,5900,7853,1157,5766,7522,1766
91732,62754,31708,31046,13394,15727,2587,12239,15487,3320
91733,45795,23154,22641,9831,11651,1672,9338,11030,2273
91737,23106,11485,11621,4369,6435,681,4032,6486,1103
91739,12838,6390,6448,2528,3502,360,2391,3661,396
91740,25200,12122,13078,4279,6371,1472,4018,6851,2209
91741,25195,12218,12977,4109,6194,1915,3615,6759,2603
91743,0,0,0,0,0,0,0,0,0
91744,84973,42305,42668,17680,21016,3609,17364,20667,4637
91745,53623,26330,27293,8623,13556,4151,7863,14684,4746
91746,31102,15672,15430,6288,7770,1614,5798,7373,2259
91748,46140,22658,23482,7460,12460,2738,7194,13260,3028
91750,35011,16884,18127,5885,8559,2440,5546,9213,3368
91752,19075,9380,9695,3646,4525,1209,3430,4615,1650
91754,33120,15840,17280,4344,8011,3485,4006,8631,4643
91755,26993,12951,14042,3691,6814,2446,3385,7443,3214
91759,36,24,12,0,16,8,0,3,9
91761,55983,28291,27692,12076,14566,1649,11156,14445,2091
91762,53962,26599,27363,10929,13398,2272,10644,13625,3094
91763,34762,17359,17403,7038,8713,1608,6564,8632,2207
91764,49216,24654,24562,10342,12689,1623,9987,12395,2180
91765,46647,22535,24112,7685,12520,2330,7435,13882,2795
91766,69757,35717,34040,15856,17559,2302,14107,17043,2890
91767,46654,23173,23481,9633,11611,1929,9049,11244,3188
91768,36286,18642,17644,8197,9042,1403,7512,8359,1773
91770,61780,29945,31835,10143,15889,3913,10356,16294,5185
91773,34674,16463,18211,5308,8829,2326,5447,9521,3243
91775,23384,11340,12044,3289,6211,1840,2857,6652,2535
91776,37969,18176,19793,5433,10140,2603,5727,10741,3325
91780,32441,15373,17068,4840,8234,2299,4774,9270,3024
91784,23222,11234,11988,3487,5903,1844,3509,6499,1980
91786,48949,23338,25611,8375,12203,2760,8177,13453,3981
91789,44901,22067,22834,7827,11919,2321,7098,13109,2627
91790,43788,21303,22485,7785,10836,2682,7286,11374,3825
91791,30885,14967,15918,5059,7513,2395,4838,7933,3147
91792,31391,15151,16240,5580,8271,1300,5398,9039,1803
91801,54432,25619,28813,7433,14555,3631,7213,16359,5241
91803,30689,14758,15931,4582,7918,2258,3984,8688,3259
91901,16348,8472,7876,2801,4605,1066,2322,4318,1236
91902,17213,8405,8808,2645,4417,1343,2526,4795,1487
91905,1418,802,616,170,477,155,144,319,153
91906,3247,1724,1523,689,849,186,480,801,242
91910,73628,35124,38504,11829,18433,4862,12119,19586,6799
91911,71348,34392,36956,12729,16917,4746,12490,18113,6353
91913,13000,6210,6790,2331,3321,558,2368,3526,896
91914,2636,1341,1295,467,822,52,386,837,72
91915,9241,4514,4727,1727,2507,280,1775,2564,388
91916,1629,817,812,215,461,141,175,496,141
91917,753,393,360,82,208,103,81,191,88
91931,708,377,331,162,182,33,116,177,38
91932,26642,13345,13297,5052,7075,1218,4777,6947,1573
91934,627,283,344,62,160,61,123,138,83
91935,8934,4572,4362,1480,2483,609,1331,2452,579
91941,44605,21465,23140,6025,11843,3597,5798,12280,5062
91942,23921,11236,12685,2817,6287,2132,2839,6377,3469
91945,25022,11989,13033,4076,6442,1471,4145,6766,2122
91948,90,48,42,0,13,35,12,23,7
91950,62518,34720,27798,14056,17481,3183,10105,13122,4571
91962,1560,770,790,186,436,148,231,406,153
91963,937,512,425,217,235,60,162,206,57
91977,56024,27165,28859,10318,13908,2939,9809,15130,3920
91978,7728,3730,3998,1224,2019,487,1094,2182,722
91980,98,54,44,12,34,8,9,24,11
92003,4060,2048,2012,628,989,431,538,1124,350
92004,2861,1460,1401,321,623,516,274,596,531
92007,10387,5242,5145,1282,3491,469,1105,3350,690
92008,35471,17834,17637,5053,9785,2996,4236,9596,3805
92009,42837,20579,22258,6066,11400,3113,5808,12584,3866
92014,14084,6997,7087,1532,4188,1277,1464,4264,1359
92019,41192,20114,21078,7003,10547,2564,6631,11439,3008
92020,55294,26763,28531,9194,14078,3491,9228,14209,5094
92021,61585,30244,31341,10387,16148,3709,9768,16547,5026
92024,47363,23414,23949,6797,13821,2796,6163,13917,3869
92025,49320,24780,24540,9729,12655,2396,9108,12103,3329
92026,43571,21154,22417,6610,10482,4062,6544,10796,5077
92027,48581,24175,24406,9048,12220,2907,8348,12098,3960
92028,42134,20843,21291,6938,9916,3989,7074,9812,4405
92029,17863,8615,9248,2452,4694,1469,2641,4846,1761
92036,3630,1793,1837,525,898,370,547,898,392
92037,42826,20215,22611,5523,10372,4320,6492,10718,5401
92040,42136,21027,21109,6975,11492,2560,6701,11218,3190
92054,98215,57069,41146,25153,28452,3464,15777,20934,4435
92056,52923,25185,27738,7920,12642,4623,8026,13297,6415
92057,46780,22716,24064,8059,11258,3399,8133,11342,4589
92059,1802,991,811,409,509,73,358,403,50
92060,224,111,113,26,59,26,37,58,18
92061,2540,1330,1210,431,547,352,412,501,297
92064,48189,23713,24476,8844,12297,2572,8333,13003,3140
92065,33038,16551,16487,5898,8576,2077,5582,8913,1992
92066,326,164,162,70,69,25,52,73,37
92067,7250,3526,3724,1144,1541,841,1065,1826,833
92069,52492,25923,26569,9070,12946,3907,8442,12695,5432
92070,1129,567,562,152,260,155,148,240,174
92071,53682,25825,27857,9052,13982,2791,8690,15372,3795
92075,12070,5972,6098,1337,3379,1256,1237,3407,1454
92078,6806,3140,3666,841,1657,642,973,1816,877
92082,14748,7470,7278,2784,3610,1076,2487,3677,1114
92083,62174,31361,30813,11302,16976,3083,10951,16052,3810
92084,44688,22115,22573,8066,11020,3029,7514,11168,3891
92086,1244,655,589,160,266,229,122,252,215
92091,1302,595,707,125,277,193,133,310,264
92101,27178,18708,8470,4583,11923,2202,1176,5271,2023
92102,47250,24062,23188,10017,12197,1848,9475,11421,2292
92103,30055,15562,14493,1791,11112,2659,1640,9307,3546
92104,47380,24098,23282,6148,15960,1990,6183,14277,2822
92105,73477,36487,36990,15911,17815,2761,15666,17856,3468
92106,18694,9487,9207,2268,5398,1821,2548,4381,2278
92107,27845,14435,13410,2662,10171,1602,2352,8863,2195
92108,11635,5734,5901,702,4435,597,884,4233,784
92109,45834,24576,21258,3513,18502,2561,3557,14417,3284
92110,23961,11946,12015,2838,7252,1856,3134,6244,2637
92111,47011,23457,23554,7174,13085,3198,6504,12438,4612
92113,47479,22890,24589,10628,10697,1565,11083,11113,2393
92114,66626,32720,33906,13608,15494,3618,12317,16920,4669
92115,56885,28353,28532,10180,15242,2931,10843,13638,4051
92116,33068,16498,16570,3683,11358,1457,3543,10991,2036
92117,51197,25134,26063,6394,14553,4187,6131,14117,5815
92118,24188,14055,10133,4542,7509,2004,2578,4924,2631
92119,21883,10479,11404,2749,5390,2340,2541,5786,3077
92120,25644,12629,13015,2943,6447,3239,2585,6549,3881
92121,4428,2319,2109,569,1593,157,489,1468,152
92122,34756,16949,17807,3907,10509,2533,3823,10667,3317
92123,25207,12315,12892,4039,6689,1587,3716,7065,2111
92124,30165,14895,15270,5184,8611,1100,5263,8805,1202
92126,74274,39284,34990,12987,23396,2901,10444,20807,3739
92127,19907,9674,10233,3533,5199,942,3236,5650,1347
92128,42642,20108,22534,5242,10057,4809,4645,11248,6641
92129,47218,23164,24054,8674,12969,1521,8256,13979,1819
92130,28172,13746,14426,4799,7932,1015,4386,8899,1141
92131,29377,14202,15175,4470,8651,1081,4901,9254,1020
92139,36383,17913,18470,6858,9329,1726,6305,9719,2446
92154,68724,36912,31812,12497,21009,3406,11272,16141,4399
92173,28471,13521,14950,6380,5930,1211,6072,7228,1650
92201,56543,28379,28164,11999,13619,2761,11385,12915,3864
92203,2661,1359,1302,424,607,328,406,587,309
92210,3814,1763,2051,133,543,1087,213,670,1168
92211,19557,9145,10412,1331,3382,4432,1451,3955,5006
92220,25751,12383,13368,4194,4823,3366,3869,5314,4185
92223,17577,8363,9214,2880,3810,1673,2972,4190,2052
92225,24666,16524,8142,3803,11480,1241,3152,3786,1204
92227,23419,11619,11800,4872,5294,1453,4569,5621,1610
92230,2442,1206,1236,414,636,156,433,621,182
92231,27792,13090,14702,5863,5551,1676,5606,7014,2082
92233,7854,5993,1861,1130,4581,282,724,897,240
92234,43093,21643,21450,7923,10449,3271,7806,9970,3674
92236,22785,11349,11436,5488,5088,773,5452,5147,837
92239,988,722,266,114,565,43,76,101,89
92240,22773,11231,11542,4290,5084,1857,4192,5151,2199
92241,5674,2777,2897,640,1211,926,810,1129,958
92242,1556,752,804,159,276,317,155,312,337
92243,43744,21916,21828,9046,10430,2440,8134,10791,2903
92249,3558,1754,1804,739,815,200,719,866,219
92250,8038,3972,4066,1675,1715,582,1509,1888,669
92251,14469,9463,5006,2304,6756,403,1799,2666,541
92252,8001,3945,4056,1148,1839,958,1012,1893,1151
92253,23931,11829,12102,3997,5634,2198,3651,6194,2257
92254,8537,4730,3807,2107,2269,354,1908,1691,208
92256,3599,1862,1737,584,932,346,538,849,350
92257,2710,1379,1331,289,420,670,331,456,544
92258,616,303,313,114,149,40,153,136,24
92259,500,284,216,39,146,99,39,112,65
92260,29435,13994,15441,3294,5720,4980,2632,6510,6299
92262,24774,12651,12123,3068,6717,2866,3215,5482,3426
92264,19022,10003,9019,1539,4594,3870,1312,3615,4092
92266,340,177,163,74,60,43,26,103,34
92267,112,63,49,16,40,7,9,40,0
92268,291,122,169,24,61,37,55,80,34
92270,12392,6054,6338,890,2031,3133,550,2253,3535
92273,1588,776,812,343,362,71,382,353,77
92274,17336,9303,8033,4258,4224,821,3809,3586,638
92275,803,445,358,129,122,194,51,158,149
92276,6306,3183,3123,891,1285,1007,725,1137,1261
92277,17145,8673,8472,3267,4281,1125,3076,4111,1285
92278,14090,11329,2761,5400,5925,4,1417,1335,9
92280,48,23,25,19,4,0,21,4,0
92281,2362,1163,1199,493,511,159,484,559,156
92282,903,527,376,157,236,134,36,163,177
92283,3622,1780,1842,704,741,335,664,841,337
92284,20668,9850,10818,3052,4354,2444,2911,4704,3203
92285,2140,1064,1076,225,484,355,223,471,382
92301,18802,10083,8719,4120,5244,719,3856,4087,776
92304,13,8,5,0,4,4,0,0,5
92305,211,107,104,26,74,7,41,59,4
92307,31664,15453,16211,5580,7002,2871,5248,7896,3067
92308,28890,13990,14900,5425,6243,2322,5258,6779,2863
92309,922,599,323,190,391,18,168,131,24
92310,9467,5385,4082,2551,2826,8,1980,2095,7
92311,31288,15785,15503,6157,7334,2294,5371,7541,2591
92313,11112,5310,5802,1866,2855,589,1820,3131,851
92314,9772,4801,4971,1490,2423,888,1346,2622,1003
92315,5362,2685,2677,733,1323,629,639,1327,711
92316,25870,12726,13144,5425,6101,1200,5706,6235,1203
92317,2180,1046,1134,341,568,137,494,509,131
92318,213,115,98,46,69,0,24,59,15
92320,7555,3542,4013,1086,1492,964,1061,1633,1319
92321,552,293,259,121,148,24,85,124,50
92323,11,3,8,3,0,0,3,2,3
92324,52370,25725,26645,10933,12753,2039,10525,13160,2960
92325,10582,5151,5431,1665,2848,638,1584,3173,674
92327,694,378,316,119,181,78,71,143,102
92328,358,196,162,31,150,15,46,96,20
92332,148,72,76,20,36,16,30,44,2
92333,447,238,209,59,114,65,24,91,94
92335,82339,41329,41010,18912,19614,2803,17664,19696,3650
92336,54879,27192,27687,12216,13741,1235,11766,14082,1839
92337,29945,15007,14938,6764,7543,700,6280,7762,896
92338,19,10,9,0,4,6,0,4,5
92339,1027,542,485,178,341,23,153,311,21
92341,288,187,101,78,72,37,7,75,19
92342,5063,2555,2508,666,1076,813,679,1151,678
92345,68700,33895,34805,13254,16369,4272,12824,16602,5379
92346,48134,23487,24647,8742,12211,2534,8695,12580,3372
92347,1909,1056,853,380,487,189,274,418,161
92352,9530,4673,4857,1588,2199,886,1568,2489,800
92354,18145,8450,9695,2661,4405,1384,2434,5200,2061
92356,5221,2669,2552,818,1274,577,757,1170,625
92358,1042,487,555,140,271,76,166,265,124
92359,7401,3638,3763,1358,1850,430,1368,1875,520
92363,5474,2636,2838,892,1196,548,803,1402,633
92364,162,97,65,36,49,12,14,47,4
92365,2804,1313,1491,341,634,338,442,723,326
92368,912,469,443,199,209,61,162,230,51
92371,12247,6116,6131,2349,3005,762,2063,3190,878
92372,4135,2034,2101,717,929,388,647,1035,419
92373,31176,14627,16549,3988,8216,2423,4046,8853,3650
92374,36581,17418,19163,7109,8516,1793,7143,9327,2693
92376,75862,36607,39255,17103,16709,2795,16678,18384,4193
92377,18633,9090,9543,3718,4643,729,3695,4854,994
92382,5366,2642,2724,892,1463,287,872,1507,345
92384,108,58,50,12,34,12,4,29,17
92386,1997,1051,946,427,453,171,314,448,184
92389,145,57,88,5,18,34,17,23,48
92392,63412,30465,32947,12333,13773,4359,11648,15383,5916
92394,12139,5745,6394,2539,2714,492,2690,2939,765
92397,4309,2212,2097,817,1097,298,600,1169,328
92398,1193,576,617,199,330,47,194,316,107
92399,41500,20369,21131,7408,9728,3233,6422,10130,4579
92401,1744,837,907,303,446,88,319,470,118
92404,53987,25977,28010,11125,11870,2982,10755,13023,4232
92405,24392,11591,12801,5076,5464,1051,5352,6013,1436
92407,49387,24766,24621,10283,12693,1790,9786,12662,2173
92408,11910,5969,5941,2629,2792,548,2483,2881,577
92410,44214,22007,22207,10207,10316,1484,10147,9995,2065
92411,23321,11364,11957,5402,4860,1102,5112,5134,1711
92501,19136,9884,9252,3608,5393,883,3225,4719,1308
92503,71714,35838,35876,15047,17750,3041,13443,18154,4279
92504,46045,22164,23881,8529,10984,2651,8000,11618,4263
92505,38534,19210,19324,7690,9873,1647,7208,9756,2360
92506,42543,20383,22160,6740,10658,2985,6753,11577,3830
92507,48508,24134,24374,10257,11787,2090,10214,11429,2731
92508,17136,8443,8693,3496,4337,610,3337,4706,650
92509,64016,32315,31701,13486,16235,2594,12692,15633,3376
92518,938,457,481,79,89,289,69,83,329
92530,38786,19499,19287,8059,9586,1854,7574,9442,2271
92532,4241,2172,2069,838,1088,246,686,1150,233
92536,2242,1146,1096,371,482,293,340,499,257
92539,3773,1898,1875,541,889,468,571,871,433
92543,29447,13168,16279,4342,5325,3501,4653,6119,5507
92544,39095,19046,20049,6556,8323,4167,5929,8810,5310
92545,25866,11613,14253,2557,3912,5144,2668,4530,7055
92548,4111,1858,2253,496,786,576,650,886,717
92549,3635,1793,1842,433,918,442,394,957,491
92551,23128,11445,11683,5507,5127,811,4803,6056,824
92553,61343,30002,31341,14457,13822,1723,13766,15288,2287
92555,12632,6027,6605,2325,3048,654,2549,3316,740
92557,46279,22505,23774,9343,11492,1670,9455,12403,1916
92561,1553,834,719,227,456,151,178,403,138
92562,36226,17802,18424,6974,8257,2571,6334,8996,3094
92563,18422,9173,9249,3466,4413,1294,3402,4271,1576
92567,7229,3621,3608,1361,1808,452,1249,1826,533
92570,36879,18483,18396,7405,8747,2331,7473,8541,2382
92571,26209,12889,13320,6092,5964,833,5729,6470,1121
92582,4243,2008,2235,791,852,365,695,979,561
92583,21735,10794,10941,4219,4650,1925,3514,4789,2638
92584,14293,7197,7096,2801,3323,1073,2385,3580,1131
92585,8404,3956,4448,1297,1798,861,1329,1906,1213
92586,18308,7872,10436,1459,2167,4246,1642,2536,6258
92587,13351,6597,6754,2189,3244,1164,2202,3266,1286
92590,2862,1548,1314,646,676,226,451,669,194
92591,25436,12595,12841,5093,6351,1151,4782,6633,1426
92592,46600,23118,23482,9216,11579,2323,8938,12229,2315
92595,19140,9547,9593,3489,4614,1444,3222,4496,1875
92596,3983,1974,2009,703,995,276,755,1019,235
92602,2806,1389,1417,423,930,36,415,939,63
92604,27452,13218,14234,4512,7240,1466,4236,8118,1880
92606,17664,8651,9013,2739,5342,570,2768,5522,723
92610,10940,5363,5577,1839,3321,203,1759,3640,178
92612,41101,19880,21221,7373,10435,2072,8404,10258,2559
92614,22314,10703,11611,3569,6307,827,3538,7227,846
92618,6252,3409,2843,811,2330,268,501,1901,441
92620,26335,12917,13418,4612,7107,1198,4181,7761,1476
92624,7563,3900,3663,1213,2129,558,962,1993,708
92625,13354,6304,7050,1119,3566,1619,1200,3978,1872
92626,48002,24113,23889,6393,14816,2904,6620,13686,3583
92627,62275,32215,30060,10037,19807,2371,8789,17589,3682
92629,27441,13692,13749,3360,8101,2231,2979,8064,2706
92630,59157,28792,30365,9542,16548,2702,9327,16819,4219
92646,56498,27936,28562,7788,15938,4210,7201,15908,5453
92647,58874,30042,28832,9834,17045,3163,8837,16221,3774
92648,42632,21455,21177,5072,14068,2315,4760,13150,3267
92649,32282,16082,16200,3702,9491,2889,3590,9673,2937
92651,24968,12652,12316,2213,8145,2294,2305,7624,2387
92653,48024,20516,27508,4716,8699,7101,5053,9464,12991
92655,8934,4400,4534,1473,2468,459,1389,2414,731
92656,41551,19885,21666,5789,13242,854,6095,14424,1147
92657,5752,2840,2912,755,1787,298,700,1948,264
92660,28755,13893,14862,3302,7290,3301,3017,8070,3775
92661,4276,2191,2085,316,1461,414,341,1226,518
92662,3120,1357,1763,186,742,429,193,980,590
92663,22066,11489,10577,1903,7794,1792,1782,6392,2403
92672,34869,17740,17129,4676,10212,2852,4100,9500,3529
92673,15186,7766,7420,2711,4042,1013,2179,4206,1035
92675,34409,16785,17624,5740,8634,2411,5543,8705,3376
92676,1791,903,888,207,620,76,227,589,72
92677,62329,30410,31919,9628,17297,3485,8881,18860,4178
92679,32205,16238,15967,6492,8876,870,5909,9227,831
92683,87867,43978,43889,13954,24174,5850,13171,23310,7408
92688,42491,20688,21803,7448,12464,776,7303,13231,1269
92691,46463,22816,23647,7800,12293,2723,6771,13459,3417
92692,46043,22374,23669,7471,11775,3128,7113,12452,4104
92694,433,261,172,117,144,0,54,118,0
92701,58329,30555,27774,13714,15451,1390,12584,13347,1843
92703,70210,37011,33199,15017,19832,2162,14028,16237,2934
92704,91106,46624,44482,18762,24739,3123,17700,22942,3840
92705,43913,21656,22257,7349,10956,3351,6708,11397,4152
92706,37890,19544,18346,7985,9964,1595,7143,9219,1984
92707,61841,32127,29714,13234,17106,1787,12396,15149,2169
92708,54588,26643,27945,7918,14491,4234,7701,15137,5107
92780,55092,26764,28328,9601,14567,2596,8775,15662,3891
92782,17470,8536,8934,2208,5669,659,2052,6204,678
92801,60696,30630,30066,11963,15948,2719,10520,15323,4223
92802,44797,22603,22194,8626,12167,1810,8328,11145,2721
92804,81362,39895,41467,14289,21607,3999,14110,21363,5994
92805,68708,35256,33452,14699,18400,2157,13796,16532,3124
92806,34112,16888,17224,5795,9291,1802,5903,9208,2113
92807,36460,17893,18567,5624,9786,2483,4946,10532,3089
92808,19613,9751,9862,3012,6090,649,3087,6013,762
92821,34122,16506,17616,5409,8944,2153,5176,9595,2845
92823,1179,597,582,149,315,133,116,347,119
92831,34680,17544,17136,5413,10288,1843,5112,9494,2530
92832,24529,12513,12016,4380,6950,1183,4152,6324,1540
92833,46263,22691,23572,7786,12164,2741,7755,12465,3352
92835,20897,9874,11023,2601,4914,2359,2617,5116,3290
92840,50702,25114,25588,8696,13570,2848,8386,13279,3923
92841,31586,15766,15820,5348,8422,1996,4882,8325,2613
92843,43788,22086,21702,8235,11991,1860,7747,11401,2554
92844,23510,11951,11559,3878,6907,1166,3680,6386,1493
92845,15907,7681,8226,2336,3969,1376,2250,4247,1729
92860,22072,12852,9220,3240,8432,1180,2729,5339,1152
92861,6002,3067,2935,942,1491,634,820,1448,667
92865,18035,9011,9024,3144,4635,1232,2612,4896,1516
92866,15532,7484,8048,2225,4418,841,2182,4560,1306
92867,40648,20267,20381,7244,10724,2299,7018,10515,2848
92868,23183,12204,10979,4054,7238,912,3528,5627,1824
92869,37962,18688,19274,5855,10660,2173,5838,10892,2544
92870,48670,23972,24698,7907,13159,2906,7856,13242,3600
92879,45028,22206,22822,8527,11837,1842,8395,11914,2513
92880,17229,8635,8594,3466,4723,446,3318,4758,518
92881,21901,10682,11219,4259,5591,832,4079,6147,993
92882,60036,29960,30076,12149,15740,2071,11326,15701,3049
92883,13396,6581,6815,2663,3598,320,2678,3767,370
92886,39242,18884,20358,6343,10173,2368,6235,11249,2874
92887,21014,10567,10447,4205,5621,741,3506,6092,849
93001,32872,16986,15886,4851,10069,2066,4566,8971,2349
93003,46827,22722,24105,6823,12422,3477,6282,12627,5196
93004,27655,13397,14258,4780,6829,1788,4327,7667,2264
93010,42984,21079,21905,6805,10811,3463,6361,10994,4550
93012,24716,11719,12997,3451,5732,2536,3487,6060,3450
93013,17341,8618,8723,2695,4685,1238,2314,4711,1698
93015,15868,8033,7835,3181,3939,913,3074,3639,1122
93021,33009,16479,16530,6577,8901,1001,6394,8956,1180
93022,6447,3018,3429,1008,1673,337,1013,1918,498
93023,21401,10241,11160,3300,5094,1847,3098,5509,2553
93030,79390,40559,38831,15519,21069,3971,14326,19403,5102
93033,77921,40236,37685,16721,20299,3216,15381,18285,4019
93035,25331,12599,12732,3617,7264,1718,3798,6999,1935
93040,1475,784,691,301,406,77,276,330,85
93041,25809,13190,12619,4926,6981,1283,4409,6293,1917
93060,32621,16918,15703,6442,8484,1992,5719,7495,2489
93063,48814,24229,24585,8273,13517,2439,7385,13966,3234
93065,65030,32240,32790,11291,17829,3120,10665,18411,3714
93066,2987,1552,1435,629,685,238,444,745,246
93067,384,145,239,14,102,29,10,173,56
93101,31778,16052,15726,4876,9755,1421,4597,9007,2122
93103,20937,10530,10407,3081,5984,1465,2951,5731,1725
93105,25853,12390,13463,2878,6910,2602,2391,7121,3951
93108,13072,6163,6909,1657,2975,1531,1992,3158,1759
93109,10730,5266,5464,1119,3191,956,1290,2962,1212
93110,15652,7345,8307,2059,3791,1495,2022,4035,2250
93111,16531,8374,8157,2493,4322,1559,2136,4236,1785
93117,49810,25259,24551,11513,11748,1998,11814,10098,2639
93201,968,517,451,232,212,73,196,190,65
93202,2965,1448,1517,639,682,127,610,754,153
93203,16508,8709,7799,4283,3838,588,3614,3611,574
93204,14724,10868,3856,2412,8053,403,1730,1862,264
93205,1925,927,998,235,338,354,276,420,302
93206,2037,1082,955,512,489,81,406,455,94
93207,201,98,103,18,38,42,27,41,35
93208,173,91,82,6,40,45,8,55,19
93210,17789,11511,6278,3108,7716,687,2558,2928,792
93212,23472,17513,5959,3166,13557,790,2454,2743,762
93215,37508,19520,17988,8320,9265,1935,7671,8205,2112
93216,4380,4380,0,364,4016,0,0,0,0
93218,838,447,391,192,211,44,168,182,41
93219,9372,4853,4519,2431,2074,348,2225,1919,375
93221,13255,6321,6934,2539,2934,848,2561,3190,1183
93222,1555,757,798,202,412,143,249,406,143
93223,8666,4361,4305,1900,2053,408,1850,2017,438
93224,608,310,298,85,190,35,106,139,53
93225,4366,2240,2126,735,1136,369,609,1174,343
93226,318,184,134,94,58,32,26,90,18
93230,53174,26470,26704,10400,12957,3113,9178,13092,4434
93234,7015,4053,2962,1779,2022,252,1365,1404,193
93235,4573,2428,2145,1099,1175,154,924,1058,163
93238,1910,989,921,225,452,312,184,329,408
93239,1768,997,771,428,488,81,332,368,71
93240,5491,2726,2765,722,1047,957,472,1104,1189
93241,15379,8013,7366,3903,3576,534,3515,3166,685
93242,2889,1506,1383,664,676,166,514,732,137
93243,1283,611,672,220,297,94,197,346,129
93244,284,152,132,51,57,44,26,70,36
93245,30367,15545,14822,6909,7628,1008,6218,7161,1443
93247,15689,8143,7546,3738,3569,836,3159,3316,1071
93249,2488,1463,1025,719,703,41,517,477,31
93250,10832,6102,4730,2363,3408,331,2248,1994,488
93251,260,144,116,35,100,9,46,58,12
93252,3031,2043,988,442,1377,224,346,484,158
93254,777,412,365,143,197,72,133,176,56
93255,713,353,360,136,128,89,77,158,125
93256,4197,2187,2010,1009,988,190,947,854,209
93257,65394,32402,32992,13641,15185,3576,12792,15404,4796
93260,257,133,124,33,61,39,29,68,27
93261,2940,1560,1380,806,645,109,680,600,100
93262,64,35,29,6,26,3,3,26,0
93263,15089,7639,7450,3240,3634,765,3311,3198,941
93265,3561,1785,1776,405,907,473,375,878,523
93266,1783,942,841,416,452,74,400,389,52
93267,5846,2954,2892,1359,1292,303,1221,1296,375
93268,16422,9078,7344,2749,5340,989,2545,3507,1292
93270,5863,3142,2721,1400,1459,283,1120,1255,346
93271,2303,1111,1192,263,534,314,300,547,345
93272,2907,1501,1406,697,686,118,640,626,140
93274,55955,27356,28599,11374,13025,2957,11151,13388,4060
93276,233,131,102,51,72,8,50,39,13
93277,44788,20857,23931,7249,10529,3079,7636,11562,4733
93280,22758,14351,8407,4375,9221,755,3716,3825,866
93282,61,28,33,8,20,0,11,21,1
93283,1931,897,1034,235,312,350,234,466,334
93285,2445,1279,1166,242,398,639,171,391,604
93286,8924,4660,4264,2049,2094,517,1690,2048,526
93287,70,30,40,3,16,11,7,24,9
93291,36877,18559,18318,7742,9069,1748,7601,8694,2023
93292,30260,14750,15510,5665,7423,1662,5669,7711,2130
93301,12919,6361,6558,2172,3362,827,2141,3020,1397
93304,44326,21427,22899,8555,10403,2469,8750,10792,3357
93305,35603,17560,18043,8152,7770,1638,7655,8140,2248
93306,53343,25662,27681,10203,12197,3262,10159,12996,4526
93307,59539,29809,29730,13789,13366,2654,12780,13585,3365
93308,44880,22509,22371,7673,11933,2903,7303,11310,3758
93309,58911,28351,30560,10698,14227,3426,9868,15864,4828
93311,20317,9958,10359,3801,5302,855,3377,5853,1129
93312,40779,20224,20555,7951,10641,1632,7541,11202,1812
93313,24859,12211,12648,5126,6200,885,4860,6596,1192
93401,27309,13612,13697,4070,7688,1854,3846,7280,2571
93402,14746,7064,7682,2070,3585,1409,1796,3873,2013
93405,31777,20273,11504,6554,12229,1490,5646,4130,1728
93420,24320,11563,12757,3349,5735,2479,3289,6154,3314
93422,29578,15262,14316,4682,8453,2127,4413,7405,2498
93424,811,370,441,34,151,185,67,150,224
93426,1471,759,712,210,384,165,215,344,153
93427,4663,2312,2351,764,1192,356,724,1192,435
93428,6634,3216,3418,725,1410,1081,654,1571,1193
93429,93,52,41,0,44,8,14,19,8
93430,3187,1632,1555,371,930,331,374,781,400
93432,1168,607,561,180,339,88,130,375,56
93433,13181,6317,6864,2062,3414,841,2053,3628,1183
93434,5686,2891,2795,1221,1397,273,1218,1203,374
93435,0,0,0,0,0,0,0,0,0
93436,51743,26874,24869,9052,14222,3600,8530,11986,4353
93437,6162,3158,3004,1391,1762,5,1331,1664,9
93440,1344,669,675,265,341,63,238,355,82
93441,1336,651,685,209,369,73,231,384,70
93442,11001,5196,5805,1149,2656,1391,1050,2776,1979
93444,15293,7530,7763,2621,3600,1309,2483,3858,1422
93445,7264,3560,3704,1242,1859,459,1271,1862,571
93446,35077,17258,17819,6081,8327,2850,5637,8780,3402
93447,859,855,4,816,35,4,0,4,0
93449,8571,4180,4391,800,2230,1150,807,2095,1489
93450,737,372,365,139,191,42,166,158,41
93451,2675,1319,1356,424,697,198,408,755,193
93452,496,275,221,101,146,28,48,119,54
93453,2549,1328,1221,380,747,201,337,713,171
93454,30597,15402,15195,5251,7809,2342,4394,7358,3443
93455,37517,18078,19439,6012,8445,3621,5857,8943,4639
93458,43667,22419,21248,9783,10575,2061,9197,9538,2513
93460,5819,2749,3070,745,1399,605,773,1676,621
93461,1237,628,609,255,305,68,255,277,77
93463,7809,3821,3988,1126,1783,912,928,1851,1209
93465,8249,4085,4164,1498,2000,587,1275,2136,753
93501,5102,2666,2436,1012,1268,386,824,1191,421
93505,8204,4027,4177,1335,2100,592,1460,2061,656
93510,8077,4086,3991,1406,2198,482,1376,2080,535
93512,279,133,146,55,50,28,44,55,47
93513,1769,823,946,241,386,196,224,414,308
93514,13403,6625,6778,2007,3183,1435,1824,3238,1716
93516,2308,1157,1151,258,598,301,350,568,233
93517,836,444,392,83,286,75,102,217,73
93518,1062,559,503,141,281,137,115,270,118
93522,69,42,27,2,16,24,2,16,9
93523,7671,4135,3536,1852,2206,77,1480,1992,64
93526,748,366,382,92,177,97,105,181,96
93527,2127,1078,1049,263,598,217,302,543,204
93528,130,61,69,16,31,14,10,33,26
93529,566,297,269,53,210,34,87,155,27
93530,71,34,37,0,14,20,4,21,12
93531,1327,677,650,233,313,131,164,365,121
93532,2761,1521,1240,652,744,125,391,706,143
93534,35015,17066,17949,6903,8001,2162,6136,8347,3466
93535,57928,28016,29912,11714,13470,2832,12097,14347,3468
93536,49379,26428,22951,8525,15416,2487,8111,11774,3066
93541,517,283,234,74,167,42,43,143,48
93543,11171,5560,5611,2156,2790,614,2186,2643,782
93544,1180,610,570,115,308,187,135,262,173
93545,1908,915,993,270,439,206,300,447,246
93546,8105,4594,3511,1182,3021,391,1043,2181,287
93549,298,147,151,46,75,26,57,59,35
93550,67384,32789,34595,15157,15467,2165,14701,16732,3162
93551,33821,16737,17084,6432,8632,1673,6295,8940,1849
93552,25374,12428,12946,5719,5940,769,5499,6317,1130
93553,1542,755,787,182,452,121,236,411,140
93554,97,67,30,0,22,45,0,30,0
93555,29828,14981,14847,5166,7594,2221,4739,7451,2657
93560,14847,7602,7245,2990,3856,756,2575,3716,954
93561,25607,14706,10901,4039,8703,1964,3560,5115,2226
93562,1918,1007,911,379,474,154,289,455,167
93563,384,263,121,27,204,32,31,59,31
93591,6761,3522,3239,1579,1597,346,1196,1707,336
93601,1828,896,932,331,396,169,252,464,216
93602,3422,1718,1704,510,867,341,415,911,378
93603,196,97,99,53,44,0,18,64,17
93604,517,235,282,15,87,133,39,92,151
93605,237,132,105,50,68,14,32,62,11
93606,810,441,369,203,196,42,145,178,46
93608,1717,1098,619,537,495,66,219,329,71
93609,5491,2897,2594,1212,1351,334,1130,1086,378
93610,19283,6253,13030,2530,2918,805,2440,9430,1160
93611,46907,22992,23915,8597,11986,2409,8107,12735,3073
93612,33577,15983,17594,5896,8264,1823,5584,8992,3018
93614,9191,4574,4617,1305,2076,1193,1127,2265,1225
93615,5519,3069,2450,1302,1487,280,1118,1060,272
93616,2139,1038,1101,421,438,179,461,455,185
93618,24283,12354,11929,5337,5853,1164,4923,5272,1734
93620,9282,4645,4637,1974,2129,542,1759,2135,743
93621,349,172,177,56,101,15,34,82,61
93622,9374,4950,4424,2211,2400,339,2020,2033,371
93623,29,15,14,0,8,7,0,6,8
93624,1949,1084,865,551,509,24,409,438,18
93625,5438,2852,2586,1248,1204,400,909,1169,508
93626,1167,658,509,161,383,114,89,299,121
93627,269,98,171,37,61,0,112,52,7
93628,201,82,119,35,39,8,68,36,15
93630,14094,7138,6956,3040,3359,739,2822,3268,866
93631,14128,7017,7111,2534,3367,1116,2380,3363,1368
93634,32,14,18,2,12,0,3,12,3
93635,28990,14442,14548,5840,7041,1561,5666,6868,2014
93637,28355,14198,14157,5636,6981,1581,5257,6809,2091
93638,49333,25316,24017,10733,12230,2353,10093,11156,2768
93640,9138,5159,3979,2023,2894,242,1700,2001,278
93641,490,301,189,80,178,43,51,95,43
93643,3580,1688,1892,474,782,432,521,978,393
93644,8601,4105,4496,1022,1911,1172,1031,1956,1509
93645,209,136,73,62,49,25,28,45,0
93646,8371,4282,4089,2110,1871,301,1921,1835,333
93647,9735,4981,4754,2094,2363,524,2160,2025,569
93648,12480,6587,5893,2982,3159,446,2731,2598,564
93650,3264,1658,1606,892,623,143,728,677,201
93651,1310,640,670,266,255,119,234,331,105
93652,154,65,89,9,40,16,39,39,11
93653,973,462,511,122,222,118,138,232,141
93654,26150,13229,12921,5190,6414,1625,4792,5985,2144
93656,5716,3000,2716,1298,1366,336,1023,1285,408
93657,28710,14429,14281,5755,6747,1927,5303,6591,2387
93660,4258,2238,2020,1055,1057,126,1016,865,139
93662,26105,13177,12928,5306,6397,1474,4813,5964,2151
93664,647,352,295,80,166,106,42,167,86
93665,463,234,229,82,118,34,109,73,47
93666,103,55,48,30,22,3,20,23,5
93667,2728,1255,1473,478,583,194,616,679,178
93668,1243,702,541,288,355,59,233,248,60
93669,292,159,133,4,94,61,29,25,79
93673,595,318,277,120,158,40,113,118,46
93675,3268,1629,1639,439,760,430,412,840,387
93701,14195,7188,7007,3778,3094,316,3561,2935,511
93702,47635,23803,23832,11687,10234,1882,11413,9704,2715
93703,31429,15653,15776,6948,6945,1760,6373,7061,2342
93704,26617,12505,14112,3971,6463,2071,3883,6895,3334
93705,35351,16672,18679,6927,7727,2018,7167,8420,3092
93706,36072,17868,18204,7718,8159,1991,7821,7675,2708
93710,29406,13966,15440,4982,7080,1904,5686,7095,2659
93711,36503,17665,18838,5171,9364,3130,4779,10317,3742
93720,45159,21800,23359,7727,11906,2167,7218,13217,2924
93721,6321,4222,2099,975,2729,518,595,1079,425
93722,60556,29865,30691,11862,15396,2607,11414,16234,3043
93725,20946,10672,10274,4519,5071,1082,4205,4715,1354
93726,39020,18623,20397,7077,9213,2333,7238,9574,3585
93727,55048,26621,28427,11179,12238,3204,11058,13033,4336
93728,16365,8160,8205,3227,4181,752,2779,4184,1242
93901,35590,21135,14455,4908,14148,2079,4256,7226,2973
93905,58471,30623,27848,14175,15051,1397,12980,12849,2019
93906,53771,27000,26771,10939,13727,2334,10059,13532,3180
93907,22360,11151,11209,3731,6141,1279,3654,6088,1467
93908,13038,6521,6517,2097,3350,1074,1846,3628,1043
93920,1049,568,481,141,359,68,99,314,68
93921,3057,1366,1691,238,627,501,152,810,729
93923,12986,5862,7124,1081,2653,2128,1122,3122,2880
93924,6737,3302,3435,808,1741,753,714,2024,697
93925,1121,610,511,236,331,43,179,290,42
93926,9205,4846,4359,2283,2267,296,1982,2033,344
93927,14051,7297,6754,3245,3544,508,3125,2959,670
93928,305,143,162,35,93,15,79,81,2
93930,14568,7772,6796,3331,3918,523,2696,3444,656
93932,515,286,229,103,163,20,84,119,26
93933,21686,10381,11305,3611,5682,1088,3374,6470,1461
93940,32924,16066,16858,4159,9293,2614,3926,9370,3562
93950,15405,7153,8252,1790,3920,1443,1466,4533,2253
93953,4556,2105,2451,360,802,943,367,936,1148
93954,488,254,234,120,107,27,110,105,19
93955,38305,21616,16689,6799,13274,1543,5847,8729,2113
93960,12831,6666,6165,2881,3230,555,2632,2867,666
93962,486,231,255,110,106,15,69,153,33
94002,25481,12543,12938,2903,7663,1977,2825,7638,2475
94005,3600,1844,1756,348,1269,227,383,1109,264
94010,40184,19194,20990,4884,10755,3555,4698,11545,4747
94014,47363,23119,24244,6989,12999,3131,6892,13128,4224
94015,63386,31256,32130,8916,17801,4539,7992,17880,6258
94019,17867,9423,8444,2752,5576,1095,2238,5116,1090
94020,1556,894,662,225,582,87,147,448,67
94021,96,33,63,7,19,7,31,23,9
94022,18645,9093,9552,2456,4422,2215,2120,4801,2631
94024,21381,10386,10995,2815,5241,2330,2851,5576,2568
94025,39044,18810,20234,4751,11122,2937,4744,11278,4212
94027,6872,3347,3525,1116,1367,864,862,1683,980
94028,6658,3322,3336,858,1642,822,751,1669,916
94030,20359,9588,10771,2438,4945,2205,2368,5292,3111
94037,2372,1157,1215,355,705,97,368,750,97
94038,3000,1483,1517,484,904,95,429,898,190
94040,32339,16695,15644,4015,10560,2120,3258,9438,2948
94041,13422,6998,6424,1366,5148,484,1275,4298,851
94043,27732,14334,13398,3088,9901,1345,2741,8643,2014
94044,38807,19106,19701,5522,11229,2355,5172,11436,3093
94060,2131,1187,944,335,724,128,334,509,101
94061,35802,17520,18282,5032,10160,2328,4625,10293,3364
94062,25398,12394,13004,2952,7363,2079,3039,7411,2554
94063,32459,17650,14809,6368,10145,1137,5391,8119,1299
94065,10551,5084,5467,1138,3471,475,1171,3718,578
94066,39510,19343,20167,5512,11297,2534,5459,11380,3328
94070,28180,13576,14604,3718,7720,2138,3285,8360,2959
94074,360,216,144,65,134,17,43,96,5
94080,60755,30059,30696,9223,16465,4371,8831,16057,5808
94086,63655,33660,29995,7327,23353,2980,7161,18932,3902
94087,49904,24832,25072,6156,14666,4010,6120,13944,5008
94089,17096,8575,8521,2123,5247,1205,1751,4888,1882
94102,29059,17568,11491,1897,12917,2754,1884,7431,2176
94103,23343,13975,9368,2005,10409,1561,1689,5964,1715
94104,395,205,190,14,126,65,37,103,50
94105,1997,1227,770,50,1124,53,11,700,59
94107,17308,9567,7741,1179,7234,1154,1104,5247,1390
94108,13563,6637,6926,885,4076,1676,822,3856,2248
94109,56346,29373,26973,2934,21157,5282,2781,17607,6585
94110,74513,38807,35706,8736,26671,3400,7788,22872,5046
94111,3302,1724,1578,121,1045,558,91,937,550
94112,72917,35651,37266,9871,20357,5423,8997,19771,8498
94114,30545,18387,12158,1368,15286,1733,1104,9260,1794
94115,33112,16062,17050,2333,11288,2441,2294,11330,3426
94116,42645,20573,22072,4762,11824,3987,4414,12098,5560
94117,38168,20338,17830,1994,16799,1545,2660,13454,1716
94118,39209,18543,20666,3358,12429,2756,3126,13211,4329
94121,42706,20620,22086,4046,12704,3870,3696,13289,5101
94122,55780,26908,28872,4963,17454,4491,4721,18068,6083
94123,23051,10860,12191,850,8403,1607,840,9107,2244
94124,32908,15634,17274,6259,7374,2001,5581,8831,2862
94127,20607,10339,10268,2680,5623,2036,1927,5390,2951
94128,0,0,0,0,0,0,0,0,0
94129,2251,1197,1054,257,929,11,242,800,12
94130,1455,914,541,278,621,15,157,384,0
94131,27943,14634,13309,2126,10495,2013,1860,8847,2602
94132,26376,12233,14143,2993,7169,2071,3353,7476,3314
94133,27056,13323,13733,1754,8503,3066,1837,7798,4098
94134,40178,19712,20466,6217,10569,2926,5357,10889,4220
94301,16103,7696,8407,1433,4942,1321,1607,4800,2000
94303,45543,22894,22649,8356,12248,2290,8663,11118,2868
94304,1707,877,830,146,513,218,114,463,253
94305,13356,7229,6127,3359,3515,355,3229,2539,359
94306,24374,11982,12392,3220,6830,1932,2733,7175,2484
94401,32312,16133,16179,4312,9752,2069,3819,9077,3283
94402,23695,11408,12287,3093,6148,2167,2881,6606,2800
94403,37778,18442,19336,4631,10617,3194,4214,10771,4351
94404,31954,15599,16355,3787,9707,2105,3563,10166,2626
94501,58535,28195,30340,7170,17056,3969,7084,17484,5772
94502,13977,6583,7394,1960,3592,1031,1924,4061,1409
94506,19487,9611,9876,3366,5327,918,3171,5767,938
94507,14801,7238,7563,2308,3760,1170,2287,4112,1164
94508,3616,1758,1858,698,886,174,738,867,253
94509,91177,44713,46464,17553,23435,3725,16419,24823,5222
94510,25929,12376,13553,3966,6740,1670,3992,7603,1958
94511,2394,1257,1137,206,692,359,236,563,338
94512,140,84,56,27,33,24,26,25,5
94513,26702,13318,13384,4894,6746,1678,4827,6638,1919
94514,10064,5099,4965,1511,2804,784,1364,2917,684
94515,7390,3735,3655,1043,1920,772,821,1811,1023
94517,14160,7068,7092,2149,3925,994,1965,4086,1041
94518,27447,13057,14390,3793,7327,1937,3735,7826,2829
94519,18567,9358,9209,3071,5028,1259,2477,5039,1693
94520,36190,18724,17466,6320,10874,1530,5499,9486,2481
94521,39920,19255,20665,6098,10670,2487,5967,11367,3331
94523,32747,15748,16999,4236,9194,2318,4082,9554,3363
94525,3291,1616,1675,375,931,310,377,973,325
94526,33277,16105,17172,5168,8511,2426,4801,9417,2954
94530,23190,10905,12285,2329,6192,2384,2135,6704,3446
94533,77699,38372,39327,14246,19510,4616,12747,20073,6507
94535,9966,5556,4410,2546,3010,0,2086,2292,32
94536,66535,32871,33664,9383,19590,3898,9414,19144,5106
94538,55993,28744,27249,8479,17612,2653,7736,15959,3554
94539,46997,23224,23773,7728,12890,2606,7366,13432,2975
94541,60285,30029,30256,9893,16682,3454,8976,16462,4818
94542,11228,5593,5635,1321,3647,625,1710,3208,717
94544,72702,36648,36054,13168,19727,3753,11993,18820,5241
94545,27287,13307,13980,4316,7165,1826,3988,7513,2479
94546,41504,19757,21747,5671,10917,3169,5424,11151,5172
94547,22288,10373,11915,3361,5870,1142,3689,6561,1665
94549,23794,11594,12200,3338,6003,2253,3279,6425,2496
94550,75841,37936,37905,12513,21643,3780,11864,21554,4487
94552,13396,6663,6733,2065,3824,774,1848,4111,774
94553,46704,23042,23662,6505,13698,2839,6112,13799,3751
94555,33811,16761,17050,5290,10097,1374,5074,10115,1861
94556,16893,7956,8937,2849,3551,1556,2935,4168,1834
94558,64051,32040,32011,9846,16578,5616,8867,16089,7055
94559,26780,13587,13193,4269,7634,1684,3583,7193,2417
94560,42471,21289,21182,7196,11970,2123,6832,11757,2593
94561,27402,13652,13750,5198,7326,1128,5305,7054,1391
94563,17770,8445,9325,2493,3984,1968,2506,4611,2208
94564,16972,8116,8856,2642,4207,1267,2489,4632,1735
94565,78794,39233,39561,15327,20355,3551,14114,20694,4753
94566,36734,17926,18808,5824,9973,2129,5644,10556,2608
94567,479,227,252,76,129,22,99,128,25
94568,29626,15630,13996,4009,10501,1120,3559,9244,1193
94569,152,85,67,21,39,25,23,19,25
94571,5278,2609,2669,805,1255,549,738,1259,672
94572,8441,4069,4372,1521,2032,516,1412,2326,634
94574,9384,4493,4891,1324,2324,845,1273,2508,1110
94576,270,114,156,44,58,12,35,96,25
94577,41950,20250,21700,5785,11308,3157,5338,11488,4874
94578,36775,18144,18631,5759,10082,2303,5110,10293,3228
94579,19790,9660,10130,2956,4930,1774,2397,5218,2515
94580,26147,12725,13422,4111,6527,2087,3700,6910,2812
94583,43992,21763,22229,6754,13091,1918,6137,13675,2417
94585,39275,19435,19840,7282,10391,1762,7258,10706,1876
94586,801,382,419,116,213,53,107,278,34
94587,66591,33494,33097,11780,18550,3164,10198,18508,4391
94588,28516,14152,14364,4518,8461,1173,4218,8840,1306
94589,42100,20391,21709,7402,10198,2791,7008,10937,3764
94590,37324,18030,19294,6231,9654,2145,6131,10091,3072
94591,51311,25205,26106,8751,13513,2941,7908,14112,4086
94592,156,59,97,12,41,6,46,51,0
94595,18099,7369,10730,1294,2690,3385,1095,2959,6676
94596,40979,20053,20926,4656,12448,2949,4005,12972,3949
94598,26000,12454,13546,3356,6469,2629,3203,6972,3371
94599,2891,1529,1362,164,535,830,190,583,589
94601,55130,27451,27679,10897,14369,2185,10389,14009,3281
94602,28996,13394,15602,3758,7729,1907,3650,9472,2480
94603,31239,15120,16119,6357,7351,1412,6148,7954,2017
94605,42775,20048,22727,7206,10271,2571,6833,12613,3281
94606,41911,20828,21083,6801,11898,2129,6413,11798,2872
94607,20822,10276,10546,3212,5456,1608,3235,5284,2027
94608,24981,11959,13022,3378,7114,1467,3489,7542,1991
94609,20494,9583,10911,2347,6199,1037,2587,6789,1535
94610,29897,14046,15851,2789,9699,1558,2497,10853,2501
94611,36627,17200,19427,3803,10486,2911,3792,11729,3906
94612,11958,6225,5733,1169,3841,1215,1132,3045,1556
94618,15328,7371,7957,1351,4940,1080,1297,5313,1347
94619,23833,11203,12630,3362,6180,1661,3517,7071,2042
94621,31233,15283,15950,6997,6924,1362,6350,7629,1971
94702,15528,7125,8403,1719,4475,931,1855,4864,1684
94703,19808,9730,10078,2809,6061,860,2230,6445,1403
94704,21471,11109,10362,4411,6204,494,5096,4583,683
94705,12327,5943,6384,1299,3663,981,1323,3864,1197
94706,16036,7532,8504,2149,4385,998,1871,5138,1495
94707,11796,5558,6238,1315,3012,1231,1229,3446,1563
94708,10571,5126,5445,975,2860,1291,875,3098,1472
94709,10219,5222,4997,1317,3534,371,1085,3262,650
94710,8015,3912,4103,1062,2508,342,1120,2507,476
94801,28726,14249,14477,5773,7338,1138,5687,7149,1641
94803,25285,12312,12973,3766,6821,1725,3626,7185,2162
94804,38950,18326,20624,6333,9785,2208,6384,10884,3356
94805,14075,6927,7148,2035,3881,1011,1774,4086,1288
94806,55405,27042,28363,9705,14419,2918,9533,14728,4102
94901,40246,20404,19842,5272,12689,2443,4698,11886,3258
94903,28422,13322,15100,3450,7118,2754,2911,7719,4470
94904,11947,5560,6387,1389,2762,1409,1196,3243,1948
94920,13119,6155,6964,1602,3025,1528,1412,3792,1760
94922,500,250,250,67,165,18,68,166,16
94923,1926,970,956,172,444,354,159,532,265
94924,1513,806,707,218,498,90,152,487,68
94925,8967,4315,4652,1092,2464,759,1142,2659,851
94928,42727,20626,22101,7074,11795,1757,7586,11762,2753
94929,302,157,145,25,89,43,20,77,48
94930,8480,4213,4267,1106,2536,571,821,2786,660
94931,7958,3925,4033,1230,2358,337,1132,2365,536
94933,1006,490,516,130,341,19,122,363,31
94937,876,411,465,90,201,120,123,222,120
94938,817,387,430,100,257,30,116,250,64
94939,6778,3122,3656,690,1866,566,642,2332,682
94940,438,258,180,82,120,56,49,88,43
94941,28554,13551,15003,3294,7987,2270,3152,9119,2732
94945,16522,8029,8493,2401,4398,1230,2156,4901,1436
94946,580,313,267,98,190,25,66,167,34
94947,24753,11755,12998,3443,6470,1842,3323,7039,2636
94949,13225,6455,6770,1645,3752,1058,1613,3845,1312
94950,262,125,137,61,47,17,0,126,11
94951,3724,1803,1921,478,1015,310,428,1147,346
94952,31837,15704,16133,4686,8976,2042,4421,8985,2727
94954,35431,17459,17972,6061,9374,2024,5336,9823,2813
94956,2018,968,1050,221,583,164,181,603,266
94960,16835,7958,8877,2252,4478,1228,2136,5278,1463
94963,486,240,246,20,190,30,63,165,18
94964,6438,6324,114,244,5935,145,27,77,10
94965,11382,5336,6046,720,3687,929,756,4494,796
94970,789,424,365,74,281,69,109,199,57
94971,398,187,211,48,119,20,60,126,25
94972,38,28,10,0,23,5,0,10,0
94973,1488,747,741,238,417,92,181,474,86
95002,2166,1182,984,372,741,69,355,510,119
95003,24021,11519,12502,2850,6886,1783,3059,7146,2297
95004,3364,1703,1661,523,972,208,562,883,216
95005,6282,3266,3016,1052,1917,297,859,1808,349
95006,10386,5380,5006,1556,3343,481,1368,3204,434
95007,1087,596,491,143,415,38,145,291,55
95008,45423,22590,22833,5739,14288,2563,5687,13763,3383
95010,9696,4589,5107,1084,2877,628,1014,2989,1104
95012,8688,4411,4277,1822,2174,415,1775,2040,462
95014,54597,27166,27431,8258,15543,3365,8124,15045,4262
95017,837,485,352,138,321,26,127,199,26
95018,8711,4410,4301,1561,2494,355,1535,2357,409
95019,4927,2480,2447,933,1292,255,1009,1056,382
95020,49906,24889,25017,9304,13540,2045,9124,13086,2807
95023,47773,24255,23518,9667,12346,2242,8487,12411,2620
95030,13226,6390,6836,1662,3589,1139,1537,3880,1419
95032,24498,11743,12755,3195,6569,1979,3008,6970,2777
95033,10262,5243,5019,1380,3188,675,1335,3005,679
95035,62870,33034,29836,10042,20117,2875,9065,17160,3611
95037,41769,20916,20853,7579,11177,2160,6812,11598,2443
95039,764,406,358,99,277,30,107,224,27
95041,63,25,38,0,25,0,20,18,0
95043,773,393,380,116,201,76,103,196,81
95045,3229,1648,1581,537,923,188,502,876,203
95046,5719,2937,2782,1084,1526,327,871,1452,459
95050,36490,18385,18105,5442,10931,2012,5231,9613,3261
95051,53051,26931,26120,6805,16785,3341,6371,15372,4377
95054,12860,6853,6007,1737,4516,600,1706,3570,731
95060,42995,21616,21379,5602,13672,2342,5914,12549,2916
95062,36466,18266,18200,5092,11489,1685,4413,10735,3052
95064,4546,2061,2485,1455,591,15,1890,573,22
95065,8511,4202,4309,1146,2446,610,1178,2337,794
95066,14679,7270,7409,2263,4086,921,2134,3922,1353
95070,30590,14914,15676,4520,7299,3095,4278,7763,3635
95073,9865,4846,5019,1430,2796,620,1293,2811,915
95076,81131,41051,40080,16087,20835,4129,14947,19514,5619
95110,18220,10520,7700,3659,6236,625,2755,4148,797
95111,57486,29259,28227,10643,16462,2154,10515,14958,2754
95112,51902,28090,23812,8640,17108,2342,8096,12817,2899
95113,548,243,305,10,171,62,22,133,150
95116,51733,26595,25138,10202,14200,2193,9757,12403,2978
95117,29887,15291,14596,4432,9506,1353,3884,8496,2216
95118,32185,15992,16193,4894,9209,1889,4623,9079,2491
95119,10146,5172,4974,1924,2857,391,1573,2901,500
95120,37175,18427,18748,5793,9865,2769,5423,10418,2907
95121,36764,18875,17889,6609,10589,1677,6006,9878,2005
95122,60193,31263,28930,12482,16595,2186,11294,14936,2700
95123,59607,29290,30317,9295,17351,2644,9305,17660,3352
95124,45052,22441,22611,6853,12468,3120,6355,12339,3917
95125,45881,22069,23812,5639,12936,3494,5307,13363,5142
95126,26833,13652,13181,3604,8866,1182,3608,7764,1809
95127,60349,30577,29772,10991,16443,3143,10226,15522,4024
95128,32779,16290,16489,4423,10027,1840,4135,9468,2886
95129,37674,18870,18804,5574,10812,2484,5029,10607,3168
95130,13312,6788,6524,2022,4041,725,1897,3781,846
95131,26523,13342,13181,3903,8390,1049,3769,8059,1353
95132,40506,20308,20198,6234,11886,2188,5829,11884,2485
95133,25850,13170,12680,4568,7377,1225,3962,7305,1413
95134,9662,5024,4638,1028,3652,344,1090,3259,289
95135,15931,7736,8195,2166,3591,1979,2045,3716,2434
95136,36962,18546,18416,5818,11063,1665,5099,11369,1948
95138,15212,7450,7762,2397,4612,441,2565,4765,432
95139,6943,3606,3337,1302,1999,305,1035,1942,360
95140,9,0,9,0,0,0,0,9,0
95148,44401,22376,22025,7854,12451,2071,7401,12303,2321
95202,7370,3735,3635,1248,1835,652,1333,1648,654
95203,16040,8281,7759,3196,4195,890,2752,3969,1038
95204,30616,14361,16255,5084,6794,2483,5221,7439,3595
95205,34081,17179,16902,7457,7948,1774,6834,7947,2121
95206,49427,24847,24580,10985,11631,2231,10124,11489,2967
95207,49971,23664,26307,9314,10856,3494,9080,12272,4955
95209,31014,14978,16036,5955,7359,1664,5609,8145,2282
95210,40708,19782,20926,8845,8929,2008,8637,9655,2634
95212,6886,3316,3570,951,1623,742,934,1778,858
95215,23666,12522,11144,5633,5323,1566,3576,5724,1844
95219,18871,9159,9712,2997,4972,1190,2797,5499,1416
95220,6470,3211,3259,992,1527,692,983,1619,657
95221,573,302,271,81,132,89,40,112,119
95222,4379,2156,2223,662,1059,435,569,1100,554
95223,5130,2678,2452,649,1212,817,437,1297,718
95224,69,34,35,0,22,12,0,13,22
95225,6,0,6,0,0,0,6,0,0
95226,62,33,29,25,8,0,0,29,0
95227,598,283,315,49,131,103,76,187,52
95228,2533,1245,1288,279,620,346,338,613,337
95230,429,217,212,67,120,30,58,115,39
95231,5321,3260,2061,1070,1881,309,779,1009,273
95232,24,6,18,0,6,0,11,7,0
95233,262,123,139,21,67,35,33,84,22
95236,3403,1795,1608,696,828,271,537,837,234
95237,3293,1723,1570,617,803,303,520,740,310
95240,45383,22359,23024,8125,11193,3041,7788,10732,4504
95242,22338,10786,11552,3370,5404,2012,3433,5449,2670
95245,2684,1323,1361,351,674,298,283,739,339
95246,1784,894,890,260,368,266,181,429,280
95247,4303,1931,2372,465,814,652,516,1035,821
95249,3813,1926,1887,637,866,423,431,872,584
95250,85,55,30,10,37,8,0,30,0
95251,612,385,227,177,141,67,43,117,67
95252,11230,5586,5644,1726,2752,1108,1607,3009,1028
95254,368,213,155,112,72,29,33,102,20
95255,2224,1067,1157,261,475,331,313,531,313
95257,372,208,164,32,96,80,33,60,71
95258,3904,1825,2079,500,997,328,709,1031,339
95301,27657,13513,14144,5613,6431,1469,5521,6599,2024
95303,711,360,351,117,187,56,130,155,66
95305,147,90,57,21,38,31,8,31,18
95306,1030,479,551,177,209,93,192,301,58
95307,32862,16225,16637,6844,7627,1754,6333,7991,2313
95310,2046,894,1152,220,416,258,255,500,397
95311,2307,1179,1128,293,548,338,329,514,285
95312,57,33,24,16,16,1,14,8,2
95313,1577,823,754,322,405,96,267,338,149
95315,10165,5224,4941,2175,2640,409,2089,2397,455
95316,5631,2662,2969,1002,1344,316,1116,1385,468
95317,732,408,324,177,187,44,118,165,41
95318,564,283,281,81,194,8,89,183,9
95320,11672,5813,5859,2171,2854,788,2021,2776,1062
95321,3585,1785,1800,313,735,737,321,810,669
95322,7941,4078,3863,1585,1895,598,1363,1793,707
95323,1080,543,537,178,292,73,182,258,97
95324,7315,3718,3597,1350,1823,545,1189,1840,568
95325,102,62,40,0,21,41,0,27,13
95326,6776,3476,3300,1377,1581,518,1069,1666,565
95327,9597,6842,2755,1355,4883,604,644,1323,788
95328,2009,969,1040,451,452,66,451,507,82
95329,1870,857,1013,223,428,206,359,464,190
95330,10711,5310,5401,2221,2617,472,2074,2773,554
95333,3168,1614,1554,717,693,204,634,681,239
95334,12555,6196,6359,2826,2890,480,2785,2899,675
95335,856,467,389,77,259,131,102,150,137
95336,37030,18253,18777,7000,9061,2192,6514,9402,2861
95337,19733,9697,10036,3707,4942,1048,3481,5236,1319
95338,10193,5011,5182,1486,2248,1277,1313,2376,1493
95340,59473,29359,30114,12474,13648,3237,11774,14045,4295
95345,466,215,251,74,114,27,77,139,35
95346,1257,624,633,147,369,108,227,330,76
95348,23061,10931,12130,4468,5232,1231,4497,5682,1951
95350,53028,24847,28181,8717,12106,4024,8445,13446,6290
95351,47753,23607,24146,10482,11140,1985,10426,11164,2556
95354,26742,13082,13660,4732,6912,1438,5012,6671,1977
95355,47389,22888,24501,8083,11703,3102,7427,12761,4313
95356,26033,12788,13245,4664,6659,1465,4047,7134,2064
95357,13485,6682,6803,2559,3393,730,2383,3467,953
95358,30989,15638,15351,6225,7942,1471,6294,7336,1721
95360,8444,4221,4223,1726,1986,509,1669,1951,603
95361,25314,12537,12777,4313,6287,1937,3796,6600,2381
95363,15604,8044,7560,3357,3932,755,3059,3608,893
95364,99,47,52,4,33,10,5,9,38
95365,4252,2231,2021,1093,969,169,952,863,206
95366,12590,6209,6381,2339,3058,812,2192,3146,1043
95367,16524,8242,8282,3488,3907,847,3081,4190,1011
95368,12503,6244,6259,2542,3334,368,2484,3325,450
95369,1165,586,579,203,296,87,224,277,78
95370,25541,12251,13290,3502,5820,2929,3473,6410,3407
95372,1529,778,751,295,317,166,253,324,174
95374,2202,1111,1091,434,562,115,401,576,114
95376,69758,36858,32900,13321,20745,2792,11903,17385,3612
95379,3954,1931,2023,647,991,293,617,1051,355
95380,39898,19726,20172,7856,9426,2444,7268,9603,3301
95382,25002,11883,13119,4257,5872,1754,4339,6395,2385
95383,4689,2407,2282,698,1079,630,482,1106,694
95385,255,154,101,53,60,41,28,66,7
95386,8194,3996,4198,1552,2050,394,1695,1985,518
95387,883,532,351,256,238,38,147,182,22
95388,11303,5724,5579,2565,2499,660,2280,2702,597
95389,1698,1085,613,193,813,79,74,516,23
95401,36354,18095,18259,5829,10321,1945,5531,10124,2604
95403,40230,20373,19857,6622,11410,2341,5801,10398,3658
95404,35188,17135,18053,4993,9604,2538,4686,9897,3470
95405,22215,10507,11708,3192,5529,1786,2950,6337,2421
95407,30457,15382,15075,5518,8655,1209,5539,7847,1689
95409,25802,12088,13714,3300,5263,3525,2904,5627,5183
95410,878,399,479,98,199,102,105,284,90
95412,698,363,335,94,184,85,76,184,75
95415,1314,686,628,254,345,87,210,325,93
95417,161,79,82,16,51,12,26,53,3
95419,437,221,216,38,154,29,56,130,30
95420,398,186,212,8,116,62,39,116,57
95421,1589,761,828,184,437,140,234,465,129
95422,13515,6504,7011,2067,2902,1535,1882,3222,1907
95423,3550,1751,1799,406,717,628,396,732,671
95424,88,46,42,0,29,17,0,9,33
95425,9163,4518,4645,1485,2303,730,1433,2204,1008
95426,1592,843,749,327,396,120,200,457,92
95427,385,214,171,18,129,67,15,95,61
95428,2300,1101,1199,378,562,161,411,581,207
95429,62,31,31,3,19,9,8,11,12
95430,151,73,78,17,56,0,23,55,0
95431,373,254,119,9,230,15,5,96,18
95432,383,180,203,47,120,13,60,114,29
95436,6077,3152,2925,957,1808,387,696,1835,394
95437,14378,7197,7181,1918,3954,1325,1973,3622,1586
95439,462,222,240,96,113,13,71,139,30
95441,2353,1354,999,406,781,167,336,529,134
95442,3939,2060,1879,501,1299,260,400,1167,312
95443,175,81,94,0,42,39,0,63,31
95444,365,179,186,72,88,19,38,135,13
95445,1928,1029,899,264,553,212,165,467,267
95446,4735,2506,2229,537,1637,332,426,1418,385
95448,17896,9073,8823,2812,4918,1343,2410,4686,1727
95449,1419,779,640,272,425,82,278,288,74
95450,408,196,212,33,125,38,36,120,56
95451,9879,4704,5175,1385,2222,1097,1412,2500,1263
95452,1728,847,881,219,466,162,194,520,167
95453,10986,5479,5507,1528,2760,1191,1559,2463,1485
95454,2704,1389,1315,407,792,190,362,752,201
95456,1002,452,550,80,167,205,58,268,224
95457,2788,1377,1411,348,697,332,284,773,354
95458,3118,1518,1600,359,767,392,421,639,540
95459,563,261,302,85,123,53,87,151,64
95460,2225,985,1240,208,492,285,272,653,315
95461,7671,3903,3768,1186,1946,771,1030,2014,724
95462,1573,824,749,151,561,112,176,447,126
95463,127,70,57,13,50,7,0,32,25
95464,2181,1044,1137,275,436,333,285,552,300
95465,1723,859,864,206,535,118,188,509,167
95466,1216,684,532,258,354,72,164,327,41
95468,1343,669,674,206,334,129,211,347,116
95469,1964,1002,962,283,520,199,297,526,139
95470,5948,2993,2955,971,1609,413,913,1625,417
95471,301,192,109,48,124,20,28,64,17
95472,31478,15135,16343,4403,8222,2510,4278,9036,3029
95476,34318,16555,17763,4588,8552,3415,4209,8967,4587
95480,29,17,12,3,8,6,5,5,2
95481,143,87,56,32,55,0,0,8,48
95482,30879,15226,15653,5464,7579,2183,4813,7873,2967
95485,2416,1107,1309,317,489,301,409,595,305
95488,309,188,121,34,114,40,35,64,22
95490,13420,6503,6917,2153,3243,1107,2112,3494,1311
95492,23720,11741,11979,4332,6023,1386,3926,6283,1770
95493,218,111,107,39,72,0,38,48,21
95494,268,148,120,34,82,32,26,69,25
95497,766,378,388,17,152,209,20,180,188
95501,23172,11346,11826,3383,6402,1561,3125,6398,2303
95502,0,0,0,0,0,0,0,0,0
95503,23475,11365,12110,3485,6008,1872,3327,6280,2503
95511,263,126,137,30,80,16,69,68,0
95514,216,109,107,38,60,11,56,46,5
95519,15897,7851,8046,2650,4237,964,2296,4530,1220
95521,19602,9859,9743,3103,5820,936,3058,5388,1297
95524,1935,975,960,275,540,160,333,472,155
95525,1561,771,790,221,450,100,181,486,123
95526,708,387,321,121,189,77,83,174,64
95527,484,287,197,77,148,62,66,107,24
95528,1108,549,559,188,261,100,178,295,86
95531,23662,13244,10418,3516,7984,1744,3326,4961,2131
95536,2951,1454,1497,442,750,262,401,775,321
95537,208,102,106,25,69,8,23,56,27
95540,12244,5840,6404,1973,2758,1109,1918,3062,1424
95542,2214,1196,1018,353,706,137,255,641,122
95543,646,347,299,159,156,32,129,142,28
95545,124,62,62,30,28,4,23,37,2
95546,3078,1516,1562,694,645,177,677,684,201
95547,1186,585,601,198,296,91,175,312,114
95548,1126,650,476,237,314,99,127,242,107
95549,276,133,143,47,80,6,54,77,12
95550,149,85,64,43,35,7,30,28,6
95551,1462,744,718,226,406,112,219,378,121
95552,250,128,122,42,63,23,39,56,27
95553,880,461,419,135,299,27,139,230,50
95554,740,333,407,116,168,49,147,215,45
95555,521,269,252,87,120,62,59,151,42
95556,585,310,275,119,132,59,80,148,47
95558,276,152,124,43,79,30,26,84,14
95559,158,70,88,32,22,16,10,60,18
95560,1828,948,880,216,562,170,193,516,171
95562,3202,1589,1613,541,756,292,476,804,333
95563,641,290,351,84,150,56,108,163,80
95564,376,200,176,86,98,16,51,109,16
95565,1127,563,564,219,310,34,234,292,38
95567,2073,991,1082,322,487,182,334,497,251
95568,175,87,88,18,52,17,34,43,11
95569,374,218,156,39,134,45,57,79,20
95570,2333,1174,1159,294,638,242,232,714,213
95571,288,154,134,55,65,34,43,67,24
95573,1648,869,779,231,435,203,166,388,225
95585,328,156,172,80,64,12,77,68,27
95587,177,107,70,28,61,18,9,61,0
95589,694,338,356,48,174,116,61,184,111
95595,234,137,97,50,63,24,25,55,17
95601,233,118,115,49,51,18,27,64,24
95602,18385,8988,9397,2636,4174,2178,2469,4428,2500
95603,24773,11631,13142,3342,6042,2247,3303,6487,3352
95605,12757,6406,6351,2567,3002,837,2450,2895,1006
95606,382,202,180,69,77,56,27,113,40
95607,271,124,147,46,67,11,41,80,26
95608,59064,27913,31151,8288,14232,5393,7854,15544,7753
95610,43895,21399,22496,7206,11523,2670,7010,11857,3629
95612,1291,666,625,232,349,85,205,326,94
95613,22,16,6,0,8,8,0,6,0
95614,3954,1994,1960,611,1027,356,602,1002,356
95615,642,338,304,103,153,82,94,123,87
95616,67583,32055,35528,12820,16929,2306,14215,18061,3252
95618,635,316,319,69,105,142,32,139,148
95619,4672,2296,2376,908,1088,300,745,1140,491
95620,18626,9388,9238,3579,4954,855,3298,4861,1079
95621,41591,20082,21509,6458,10552,3072,5880,10797,4832
95623,3812,1851,1961,440,943,468,417,882,662
95624,38546,18933,19613,7146,9893,1894,6690,10518,2405
95625,56,45,11,0,30,15,0,11,0
95626,6411,3208,3203,1239,1636,333,1168,1671,364
95627,2777,1475,1302,535,678,262,441,628,233
95628,40603,20077,20526,6045,10336,3696,5238,11175,4113
95629,865,458,407,93,231,134,94,208,105
95630,51913,28825,23088,7358,19043,2424,6730,13032,3326
95631,5777,2904,2873,849,1495,560,836,1489,548
95632,24042,11906,12136,4617,5904,1385,4531,5965,1640
95633,2622,1280,1342,378,617,285,340,772,230
95634,2816,1413,1403,377,813,223,375,791,237
95635,1128,643,485,240,295,108,126,266,93
95636,658,354,304,99,172,83,58,173,73
95637,165,89,76,19,41,29,30,46,0
95638,1800,931,869,331,520,80,227,547,95
95639,192,120,72,73,32,15,10,40,22
95640,9715,7066,2649,2020,4594,452,755,1433,461
95641,2124,1161,963,308,563,290,218,489,256
95642,6401,3064,3337,748,1511,805,692,1545,1100
95645,1852,888,964,309,446,133,353,484,127
95646,114,73,41,43,30,0,18,23,0
95648,14816,7328,7488,2547,3597,1184,2397,3746,1345
95650,11524,5661,5863,1802,2953,906,1724,3029,1110
95651,303,161,142,31,86,44,23,80,39
95653,845,407,438,137,253,17,229,184,25
95655,520,286,234,83,203,0,90,144,0
95658,6290,3135,3155,923,1557,655,797,1664,694
95659,751,401,350,108,216,77,79,188,83
95660,32201,15822,16379,6461,7430,1931,5908,7767,2704
95661,25161,11786,13375,3799,6226,1761,3880,6638,2857
95662,31903,15805,16098,5237,8432,2136,4856,8613,2629
95663,1765,910,855,248,459,203,257,421,177
95664,897,480,417,99,256,125,82,265,70
95665,4354,2180,2174,609,942,629,483,957,734
95666,5201,2540,2661,488,1128,924,551,1235,875
95667,34556,16753,17803,4960,8579,3214,4658,8950,4195
95668,928,501,427,182,237,82,124,230,73
95669,2197,1013,1184,266,516,231,301,596,287
95670,50135,24329,25806,8447,12717,3165,8062,13394,4350
95672,3870,1977,1893,737,1010,230,571,1029,293
95673,13775,6794,6981,2367,3551,876,2319,3591,1071
95674,854,434,420,149,200,85,136,205,79
95675,322,145,177,58,75,12,39,102,36
95676,406,267,139,114,144,9,54,74,11
95677,20859,10382,10477,3565,5513,1304,3178,5521,1778
95678,30483,14791,15692,4944,8182,1665,4917,8369,2406
95681,1396,718,678,242,413,63,213,359,106
95682,24585,12007,12578,3967,6236,1804,3786,6780,2012
95683,4572,2248,2324,496,1097,655,459,1165,700
95684,2887,1408,1479,357,720,331,398,805,276
95685,4558,2170,2388,563,1082,525,590,1158,640
95686,1292,663,629,299,288,76,290,276,63
95687,63232,35662,27570,9895,22961,2806,9153,14756,3661
95688,32432,15963,16469,5582,8536,1845,5282,8858,2329
95689,1428,743,685,201,330,212,155,332,198
95690,2132,1190,942,402,571,217,271,463,208
95691,19011,9235,9776,3227,4589,1419,3080,4797,1899
95692,3548,1759,1789,714,772,273,584,881,324
95693,6015,3008,3007,1078,1441,489,877,1624,506
95694,8454,4268,4186,1645,2206,417,1514,2148,524
95695,38432,19010,19422,6605,9665,2740,6182,9766,3474
95701,751,409,342,128,233,48,98,204,40
95703,1432,724,708,137,428,159,134,378,196
95709,4602,2260,2342,574,1026,660,571,1131,640
95713,8593,4271,4322,1388,2206,677,1270,2308,744
95714,347,162,185,50,90,22,58,89,38
95715,180,94,86,24,60,10,23,48,15
95717,337,203,134,57,100,46,23,69,42
95720,140,87,53,29,44,14,3,25,25
95721,44,34,10,22,12,0,10,0,0
95722,3789,1900,1889,606,919,375,489,1037,363
95726,8565,4288,4277,1241,2118,929,1198,2187,892
95728,59,35,24,0,0,35,0,0,24
95735,12,5,7,0,3,2,0,7,0
95736,10,5,5,0,0,5,0,0,5
95742,283,192,91,100,59,33,0,50,41
95746,20568,10209,10359,3618,5317,1274,3492,5553,1314
95747,25521,12153,13368,3694,5471,2988,3704,6155,3509
95758,47081,23508,23573,8884,13120,1504,7907,13787,1879
95762,21934,11005,10929,4170,5743,1092,3867,5893,1169
95765,16267,7803,8464,3004,4299,500,3091,4810,563
95776,15053,7545,7508,2913,4055,577,2800,3895,813
95814,16577,9546,7031,1464,6675,1407,1186,4366,1479
95815,25244,12721,12523,4723,6576,1422,4266,6560,1697
95816,15809,7873,7936,1133,5899,841,1074,5395,1467
95817,14950,7222,7728,2703,3724,795,2466,4054,1208
95818,21656,10094,11562,2710,5883,1501,2568,6824,2170
95819,15950,7160,8790,1519,4339,1302,1768,4774,2248
95820,37028,17849,19179,6967,8551,2331,6660,9438,3081
95821,35250,16807,18443,5183,8705,2919,4886,9421,4136
95822,44521,20776,23745,7474,9440,3862,7660,10629,5456
95823,72064,34521,37543,14643,16351,3527,14377,18395,4771
95824,30682,15245,15437,6690,7003,1552,6291,6950,2196
95825,30752,14477,16275,3886,8538,2053,4084,8870,3321
95826,38768,19207,19561,5903,11046,2258,5511,11102,2948
95827,19538,9519,10019,3300,5198,1021,2916,5571,1532
95828,55077,26756,28321,11262,12633,2861,10215,14164,3942
95829,11273,5653,5620,2113,2919,621,1810,3203,607
95830,655,327,328,102,184,41,123,148,57
95831,42821,20368,22453,5891,10848,3629,5137,12846,4470
95832,9079,4523,4556,2412,1683,428,2068,1956,532
95833,31434,15511,15923,5491,8767,1253,5268,9132,1523
95834,8444,4163,4281,1553,2342,268,1529,2391,361
95835,830,401,429,151,221,29,138,253,38
95836,0,0,0,0,0,0,0,0,0
95837,214,109,105,24,38,47,5,58,42
95838,35008,16913,18095,7598,7842,1473,7663,8524,1908
95841,21129,9921,11208,3285,5213,1423,3474,5818,1916
95842,31326,14891,16435,5785,7847,1259,5890,8743,1802
95843,36429,17947,18482,7425,9549,973,6809,10420,1253
95864,23228,10913,12315,2793,5488,2632,2898,6019,3398
95901,38412,19131,19281,7731,9140,2260,7100,9301,2880
95903,5641,2994,2647,1422,1572,0,1240,1407,0
95910,166,84,82,22,39,23,25,35,22
95912,4733,2462,2271,943,1190,329,786,1087,398
95913,222,114,108,45,69,0,28,80,0
95914,616,287,329,66,125,96,96,161,72
95916,1289,671,618,189,314,168,141,319,158
95917,3187,1587,1600,637,761,189,556,761,283
95918,1242,648,594,138,297,213,33,334,227
95919,1268,706,562,184,317,205,88,225,249
95920,272,133,139,42,70,21,51,56,32
95922,632,318,314,92,188,38,125,146,43
95923,61,23,38,0,13,10,5,19,14
95925,269,152,117,33,90,29,43,48,26
95926,35923,17832,18091,6612,9267,1953,6217,8883,2991
95928,32915,16529,16386,6041,8972,1516,5825,8389,2172
95930,317,168,149,23,116,29,28,78,43
95932,7436,3715,3721,1318,1879,518,1313,1779,629
95934,186,83,103,10,36,37,45,41,17
95935,645,273,372,79,161,33,52,242,78
95936,397,202,195,51,81,70,58,75,62
95937,0,0,0,0,0,0,0,0,0
95938,3418,1707,1711,621,842,244,525,858,328
95939,577,334,243,70,200,64,72,107,64
95941,369,170,199,27,89,54,8,89,102
95942,1496,781,715,209,420,152,182,371,162
95943,1480,789,691,305,397,87,252,332,107
95944,67,28,39,6,16,6,16,17,6
95945,23957,11475,12482,3742,5383,2350,2967,5957,3558
95946,9746,4726,5020,1162,1903,1661,1144,2312,1564
95947,2027,1059,968,334,469,256,258,479,231
95948,9782,4760,5022,1735,2188,837,1727,2146,1149
95949,17761,8793,8968,2410,3986,2397,2039,4461,2468
95950,470,218,252,107,80,31,107,100,45
95951,1882,1001,881,396,514,91,346,427,108
95953,8707,4193,4514,1563,2060,570,1611,2171,732
95954,11162,5457,5705,1509,2204,1744,1369,2456,1880
95955,1181,580,601,235,257,88,228,295,78
95956,304,167,137,48,68,51,24,78,35
95957,753,395,358,110,214,71,121,172,65
95959,17367,8674,8693,2466,4502,1706,2125,4750,1818
95960,492,280,212,62,164,54,39,147,26
95961,6361,3231,3130,1089,1638,504,1126,1476,528
95962,1375,670,705,150,386,134,125,411,169
95963,13674,6853,6821,2481,3225,1147,2338,3149,1334
95965,17834,9025,8809,3450,4042,1533,2987,4198,1624
95966,28384,13819,14565,4664,5990,3165,4128,6354,4083
95968,1295,638,657,264,291,83,231,290,136
95969,28184,12991,15193,3362,5862,3767,3499,6393,5301
95970,573,278,295,107,125,46,119,134,42
95971,6120,3083,3037,910,1610,563,824,1600,613
95972,106,25,81,10,13,2,33,27,21
95973,26672,12978,13694,4206,7002,1770,3881,7359,2454
95974,59,33,26,14,13,6,0,21,5
95975,1597,764,833,203,417,144,214,442,177
95977,1010,552,458,198,258,96,127,267,64
95978,8,8,0,0,8,0,0,0,0
95979,774,430,344,164,163,103,108,132,104
95981,90,40,50,17,17,6,39,11,0
95982,3191,1596,1595,642,753,201,580,817,198
95983,557,285,272,99,114,72,35,142,95
95984,51,27,24,0,19,8,0,19,5
95986,101,49,52,8,30,11,10,37,5
95987,4572,2360,2212,981,1131,248,856,1034,322
95988,8845,4472,4373,1732,2090,650,1413,2130,830
95991,35029,17058,17971,6372,8317,2369,6022,8660,3289
95993,27679,13801,13878,4454,7111,2236,4290,7032,2556
96001,31624,15320,16304,5026,7594,2700,4687,8160,3457
96002,30337,14715,15622,5429,6850,2436,4961,7488,3173
96003,41566,19993,21573,6460,9992,3541,6413,10584,4576
96006,652,305,347,79,151,75,80,165,102
96007,20968,9962,11006,3446,4640,1876,3344,5256,2406
96008,919,491,428,158,261,72,118,222,88
96009,595,270,325,109,130,31,124,153,48
96010,236,125,111,46,45,34,28,47,36
96011,231,122,109,27,69,26,39,55,15
96013,4550,2193,2357,615,1125,453,698,1124,535
96014,353,159,194,37,83,39,75,66,53
96015,337,161,176,78,65,18,1,109,66
96016,366,194,172,38,87,69,21,108,43
96017,206,105,101,31,53,21,35,41,25
96019,6250,3040,3210,1077,1509,454,966,1578,666
96020,2553,1264,1289,288,641,335,328,632,329
96021,13848,6898,6950,2477,3189,1232,2349,3083,1518
96022,12702,6181,6521,2107,2974,1100,2085,3271,1165
96023,1133,536,597,181,241,114,171,270,156
96024,923,466,457,143,240,83,138,238,81
96025,2595,1298,1297,337,687,274,288,608,401
96027,2124,1096,1028,339,485,272,279,484,265
96028,1783,928,855,304,408,216,236,437,182
96029,74,30,44,5,19,6,14,25,5
96031,155,87,68,13,57,17,13,44,11
96032,2353,1159,1194,343,560,256,295,588,311
96033,368,211,157,66,110,35,40,93,24
96034,339,162,177,46,72,44,46,80,51
96035,3333,1661,1672,585,806,270,618,737,317
96037,258,127,131,31,67,29,19,77,35
96038,643,326,317,103,152,71,95,162,60
96039,1319,682,637,193,349,140,178,314,145
96040,340,187,153,42,104,41,25,91,37
96041,2546,1291,1255,402,655,234,302,685,268
96044,1047,505,542,109,231,165,115,235,192
96046,234,108,126,25,75,8,18,76,32
96047,879,440,439,113,241,86,123,228,88
96048,723,370,353,75,225,70,76,187,90
96050,439,235,204,49,110,76,41,113,50
96051,1222,633,589,141,329,163,84,353,152
96052,1892,1060,832,235,552,273,193,439,200
96054,344,174,170,31,79,64,44,77,49
96055,3778,1817,1961,591,824,402,511,984,466
96056,1695,866,829,324,379,163,248,376,205
96057,1600,763,837,204,350,209,232,367,238
96058,832,442,390,150,217,75,133,197,60
96059,488,236,252,38,89,109,37,126,89
96061,84,48,36,12,23,13,9,17,10
96062,821,401,420,125,204,72,104,214,102
96063,110,55,55,12,31,12,6,41,8
96064,4603,2261,2342,675,1081,505,620,1167,555
96065,460,249,211,91,120,38,65,109,37
96067,7286,3483,3803,1016,1778,689,925,2015,863
96068,183,125,58,15,100,10,14,31,13
96069,799,393,406,104,183,106,109,223,74
96071,129,78,51,3,32,43,2,4,45
96073,4915,2457,2458,816,1126,515,681,1273,504
96074,200,154,46,44,100,10,12,22,12
96075,420,265,155,80,136,49,56,64,35
96076,208,113,95,10,79,24,9,53,33
96080,26483,12916,13567,4274,6112,2530,4032,6255,3280
96084,412,200,212,42,98,60,57,103,52
96085,85,45,40,9,19,17,3,28,9
96086,311,163,148,43,74,46,21,83,44
96087,497,235,262,65,135,35,95,116,51
96088,4391,2239,2152,574,1031,634,454,1064,634
96090,400,199,201,68,82,49,75,78,48
96091,733,380,353,80,161,139,55,166,132
96092,397,249,148,104,132,13,26,100,22
96093,3709,1787,1922,500,952,335,428,1033,461
96094,5902,2887,3015,922,1314,651,902,1370,743
96095,0,0,0,0,0,0,0,0,0
96096,773,401,372,112,210,79,108,191,73
96097,9460,4524,4936,1417,2058,1049,1336,2285,1315
96101,5179,2562,2617,853,1174,535,745,1350,522
96103,1908,879,1029,158,399,322,234,453,342
96104,848,420,428,112,202,106,100,190,138
96105,512,264,248,75,143,46,85,144,19
96106,86,38,48,0,19,19,21,7,20
96107,1404,763,641,369,267,127,154,355,132
96108,84,52,32,36,16,0,19,13,0
96109,1079,545,534,142,294,109,146,268,120
96110,109,59,50,14,23,22,13,25,12
96112,199,90,109,34,26,30,32,54,23
96113,910,454,456,144,226,84,111,226,119
96114,3058,1567,1491,526,824,217,457,807,227
96115,145,74,71,11,47,16,15,41,15
96116,265,136,129,58,47,31,42,51,36
96117,300,156,144,49,76,31,25,91,28
96118,1807,886,921,327,418,141,243,454,224
96119,49,28,21,8,8,12,1,8,12
96120,992,494,498,136,260,98,152,261,85
96121,580,304,276,113,132,59,63,149,64
96122,4283,2090,2193,646,1040,404,683,1040,470
96123,56,34,22,9,18,7,8,14,0
96124,296,147,149,32,93,22,24,86,39
96125,333,175,158,24,78,73,15,76,67
96126,213,97,116,26,54,17,31,59,26
96128,423,227,196,81,114,32,59,108,29
96130,19527,12016,7511,3057,7939,1020,2573,3730,1208
96132,61,38,23,9,18,11,5,12,6
96133,103,75,28,16,44,15,0,17,11
96134,2587,1307,1280,486,604,217,468,549,263
96136,125,62,63,24,29,9,16,36,11
96137,4251,2157,2094,681,939,537,508,1036,550
96140,1916,931,985,238,586,107,190,677,118
96141,775,395,380,57,298,40,92,243,45
96142,1406,753,653,203,467,83,168,391,94
96143,4755,2572,2183,829,1594,149,728,1277,178
96145,4051,2242,1809,423,1527,292,360,1165,284
96146,912,565,347,68,414,83,66,247,34
96148,717,352,365,99,206,47,151,169,45
96150,32969,16809,16160,5076,9849,1884,4944,9091,2125
96161,15840,8293,7547,2519,5062,712,2241,4698,608
96701,41544,21562,19982,5542,12460,3560,5224,10770,3988
96703,2278,1146,1132,422,604,120,408,583,141
96704,6700,3380,3320,1087,1731,562,963,1806,551
96705,1955,971,984,341,451,179,303,441,240
96706,43959,22258,21701,8121,12178,1959,7573,11661,2467
96707,25030,12698,12332,4790,6882,1026,4294,6899,1139
96708,8519,4292,4227,1207,2771,314,1222,2586,419
96710,322,177,145,64,63,50,15,80,50
96712,7772,4094,3678,1240,2477,377,1211,1989,478
96713,1670,822,848,301,419,102,307,420,121
96714,2335,1245,1090,338,771,136,349,587,154
96716,2447,1209,1238,384,615,210,415,590,233
96717,5049,2414,2635,965,1157,292,1084,1217,334
96718,0,0,0,0,0,0,0,0,0
96719,2582,1303,1279,424,676,203,323,717,239
96720,42953,20938,22015,6776,10174,3988,6517,10351,5147
96722,1160,529,631,134,255,140,119,334,178
96725,2783,1368,1415,398,800,170,368,814,233
96727,4579,2249,2330,711,1093,445,726,1139,465
96728,597,292,305,87,137,68,95,137,73
96729,1111,560,551,218,260,82,209,256,86
96730,1560,785,775,272,415,98,209,462,104
96731,2763,1411,1352,550,664,197,473,648,231
96732,19192,9325,9867,2887,4519,1919,2788,4494,2585
96734,51113,25929,25184,8581,13819,3529,7530,13450,4204
96737,2119,1159,960,324,638,197,270,514,176
96738,5252,2669,2583,936,1507,226,826,1478,279
96740,25301,12861,12440,3899,6960,2002,3346,7114,1980
96741,6110,3114,2996,976,1649,489,799,1620,577
96742,147,88,59,0,29,59,0,15,44
96743,8463,4175,4288,1336,2249,590,1298,2339,651
96744,54411,26861,27550,8128,14406,4327,7990,14373,5187
96746,16187,8079,8108,2755,4304,1020,2505,4300,1303
96747,607,308,299,107,141,60,85,130,84
96748,4702,2267,2435,840,1017,410,895,1082,458
96749,11407,5877,5530,2270,2853,754,1830,2970,730
96750,2533,1293,1240,439,633,221,355,614,271
96751,206,92,114,40,28,24,7,59,48
96752,2874,1466,1408,470,709,287,419,699,290
96753,22393,11360,11033,3042,6907,1411,2993,6581,1459
96754,2005,1061,944,362,592,107,285,539,120
96755,2989,1464,1525,527,661,276,505,733,287
96756,5340,2693,2647,830,1323,540,676,1355,616
96757,829,443,386,174,187,82,126,178,82
96759,614,345,269,129,157,59,99,133,37
96760,2149,1060,1089,333,593,134,361,575,153
96761,18578,9496,9082,2425,5817,1254,2500,5198,1384
96762,4862,2339,2523,985,1160,194,1098,1215,210
96763,3193,1580,1613,563,721,296,495,763,355
96764,827,412,415,153,187,72,106,174,135
96766,12022,5963,6059,1858,2967,1138,1624,2922,1513
96768,15869,7904,7965,2693,4309,902,2386,4530,1049
96769,635,339,296,172,127,40,123,126,47
96770,615,269,346,120,120,29,173,114,59
96771,4515,2390,2125,819,1306,265,662,1222,241
96772,1915,941,974,321,432,188,344,451,179
96773,183,95,88,21,54,20,28,37,23
96774,104,60,44,10,23,27,12,17,15
96776,1365,701,664,215,361,125,202,310,152
96777,1520,770,750,240,371,159,243,322,185
96778,10636,5355,5281,1868,2696,791,1808,2711,762
96779,2875,1475,1400,565,779,131,441,767,192
96780,589,304,285,88,181,35,114,148,23
96781,1575,765,810,202,351,212,216,384,210
96782,37649,19885,17764,5977,10195,3713,4396,9095,4273
96783,1912,925,987,262,460,203,285,441,261
96785,2807,1514,1293,399,916,199,344,740,209
96786,41552,22399,19153,9235,11131,2033,7508,9085,2560
96789,45087,22852,22235,7602,13143,2107,6990,12979,2266
96790,6739,3255,3484,816,1916,523,894,1966,624
96791,7863,4137,3726,1338,2102,697,1057,1896,773
96792,42451,21174,21277,9082,9949,2143,8105,10687,2485
96793,21780,10938,10842,3661,5741,1536,3498,5489,1855
96795,9868,4839,5029,1799,2451,589,1751,2567,711
96796,2261,1117,1144,332,542,243,281,533,330
96797,63166,31450,31716,10158,17064,4228,9990,16852,4874
96813,21198,10692,10506,2027,6511,2154,2118,5753,2635
96814,13694,6584,7110,1115,4110,1359,1138,4217,1755
96815,27582,14117,13465,2049,8728,3340,1852,7820,3793
96816,48860,23572,25288,5294,12708,5570,5610,12159,7519
96817,52104,24755,27349,6467,12673,5615,6225,13146,7978
96818,54939,27955,26984,9600,16053,2302,9472,14663,2849
96819,47382,23799,23583,7379,12032,4388,7144,11260,5179
96821,18626,9219,9407,2155,4827,2237,2020,4597,2790
96822,44008,21120,22888,4695,12145,4280,4589,12213,6086
96825,27657,13444,14213,3348,7608,2488,3450,8005,2758
96826,31311,15213,16098,3571,9016,2626,3162,9035,3901
96862,0,0,0,0,0,0,0,0,0
96863,2482,2423,59,1472,951,0,10,49,0
97001,158,82,76,22,46,14,11,44,21
97002,5800,3074,2726,921,1628,525,831,1420,475
97004,4428,2277,2151,754,1260,263,641,1239,271
97005,24384,12403,11981,3790,7420,1193,3338,6580,2063
97006,50885,25578,25307,8738,15040,1800,8243,14817,2247
97007,55503,27416,28087,9460,15664,2292,8953,16032,3102
97008,27210,13381,13829,4230,7584,1567,3879,7766,2184
97009,12737,6487,6250,1961,3422,1104,1780,3385,1085
97011,891,428,463,112,262,54,152,220,91
97013,19458,9634,9824,3370,5001,1263,3231,4919,1674
97014,1304,640,664,208,347,85,216,351,97
97015,23451,11488,11963,3552,6781,1155,3672,6890,1401
97016,6037,3038,2999,990,1460,588,877,1485,637
97017,2690,1350,1340,494,765,91,479,724,137
97018,1560,812,748,261,413,138,188,419,141
97019,2874,1480,1394,464,860,156,410,813,171
97020,128,69,59,28,41,0,22,37,0
97021,1020,518,502,169,234,115,157,225,120
97022,3778,1840,1938,672,892,276,705,997,236
97023,9743,4971,4772,1702,2678,591,1473,2505,794
97024,8630,4500,4130,1634,2450,416,1215,2345,570
97026,3253,1803,1450,708,946,149,584,696,170
97027,12084,5805,6279,1924,3092,789,1918,3243,1118
97028,297,212,85,64,117,31,7,64,14
97029,364,179,185,75,66,38,57,86,42
97030,31854,15288,16566,5120,8238,1930,5140,8297,3129
97031,16655,8283,8372,2659,4466,1158,2839,3956,1577
97032,4326,2222,2104,905,1105,212,752,1055,297
97033,67,39,28,4,17,18,0,15,13
97034,18998,9316,9682,2915,5042,1359,2510,5281,1891
97035,23863,11497,12366,3308,6814,1375,3082,7385,1899
97037,1026,576,450,181,251,144,102,225,123
97038,12849,6378,6471,2258,3259,861,2168,3279,1024
97039,463,238,225,76,120,42,75,112,38
97040,1045,485,560,143,268,74,190,294,76
97041,2631,1359,1272,421,735,203,385,657,230
97042,2956,1511,1445,415,819,277,373,774,298
97045,45166,22557,22609,7438,12301,2818,6774,12230,3605
97048,6534,3213,3321,984,1666,563,970,1780,571
97049,1897,1018,879,314,605,99,248,549,82
97050,404,220,184,47,98,75,46,92,46
97051,12998,6514,6484,2195,3520,799,2091,3406,987
97053,3211,1582,1629,428,821,333,427,923,279
97054,1392,765,627,286,402,77,215,357,55
97055,13440,6896,6544,2340,3700,856,1902,3703,939
97056,9423,4603,4820,1272,2571,760,1472,2498,850
97058,18838,9274,9564,2836,4688,1750,2680,4644,2240
97060,17764,8946,8818,3152,5103,691,3114,4916,788
97062,24152,12053,12099,4060,7105,888,3942,7052,1105
97063,1049,539,510,117,198,224,84,250,176
97064,3548,1778,1770,618,894,266,602,903,265
97065,636,317,319,88,167,62,97,143,79
97067,1554,801,753,198,419,184,209,365,179
97068,24781,12378,12403,4306,6692,1380,3771,7079,1553
97070,15638,7678,7960,2316,4179,1183,2251,4213,1496
97071,25192,13018,12174,5171,5690,2157,4300,4973,2901
97080,35049,17314,17735,5931,9724,1659,5856,9774,2105
97101,3760,1897,1863,678,957,262,634,953,276
97102,221,109,112,24,50,35,42,38,32
97103,17213,8579,8634,2859,4319,1401,2443,4353,1838
97106,4242,2190,2052,722,1216,252,687,1153,212
97107,1463,675,788,196,327,152,226,384,178
97108,419,227,192,57,113,57,44,82,66
97109,598,284,314,64,173,47,127,137,50
97110,1210,548,662,129,313,106,208,345,109
97111,2699,1427,1272,504,741,182,421,654,197
97112,2524,1219,1305,312,605,302,378,588,339
97113,12108,6319,5789,2335,3331,653,2000,2959,830
97114,4481,2266,2215,819,1138,309,778,1074,363
97115,3430,1699,1731,574,893,232,547,953,231
97116,21012,10009,11003,3698,5096,1215,3790,5109,2104
97117,584,290,294,74,175,41,63,188,43
97118,764,378,386,75,184,119,71,159,156
97119,5206,2666,2540,968,1380,318,808,1452,280
97121,1145,532,613,201,290,41,263,309,41
97122,452,234,218,79,88,67,53,105,60
97123,36299,18744,17555,6692,10487,1565,6100,9400,2055
97124,37927,19432,18495,6042,11926,1464,5802,10747,1946
97125,83,41,42,12,29,0,15,27,0
97127,2660,1330,1330,481,733,116,484,708,138
97128,30076,14774,15302,5287,7290,2197,5212,6929,3161
97130,400,190,210,33,93,64,26,103,81
97131,2380,1189,1191,233,551,405,173,564,454
97132,24074,11826,12248,4381,5971,1474,4176,6221,1851
97133,3821,2003,1818,695,1071,237,558,1015,245
97134,40,22,18,0,12,10,0,18,0
97135,304,153,151,30,78,45,9,65,77
97136,1869,915,954,165,415,335,160,428,366
97137,1592,893,699,280,532,81,271,343,85
97138,9443,4631,4812,1287,2397,947,1160,2366,1286
97140,16469,8160,8309,2678,4727,755,2537,4973,799
97141,12686,6453,6233,2212,3112,1129,1810,3031,1392
97143,88,42,46,17,25,0,8,33,5
97144,113,28,85,10,18,0,16,61,8
97145,414,192,222,42,92,58,41,105,76
97146,4911,2560,2351,807,1259,494,530,1280,541
97147,311,149,162,38,62,49,25,50,87
97148,3035,1541,1494,475,853,213,502,763,229
97149,448,195,253,26,78,91,37,115,101
97201,25197,12374,12823,2271,8315,1788,2318,8039,2466
97202,37407,18315,19092,4423,11838,2054,4557,11434,3101
97203,27704,13751,13953,5094,7255,1402,4911,7027,2015
97204,1268,936,332,47,802,87,21,276,35
97205,6146,3599,2547,431,2604,564,235,1678,634
97206,45332,22588,22744,6583,13392,2613,5894,12715,4135
97209,8106,4843,3263,336,3971,536,331,2541,391
97210,10217,5263,4954,764,3989,510,692,3597,665
97211,30936,14712,16224,4744,8611,1357,4696,9436,2092
97212,23231,11313,11918,3100,7127,1086,3000,7314,1604
97213,29464,14165,15299,3908,8495,1762,3385,9089,2825
97214,22585,11246,11339,1723,8632,891,1767,8034,1538
97215,16605,7983,8622,1917,5069,997,1906,5244,1472
97216,13117,6462,6655,2175,3374,913,1939,3396,1320
97217,29683,14623,15060,4089,8783,1751,3816,8766,2478
97218,14003,7171,6832,2305,4098,768,2068,3619,1145
97219,36755,17848,18907,5061,10873,1914,5188,11064,2655
97220,27368,13271,14097,4026,7210,2035,3962,7061,3074
97221,11489,5590,5899,1505,3045,1040,1334,3218,1347
97222,35033,16939,18094,5216,9362,2361,4632,9494,3968
97223,44604,22128,22476,6886,13108,2134,6383,13293,2800
97224,24726,11524,13202,3274,5914,2336,3081,6204,3917
97225,21305,10282,11023,2476,6070,1736,2471,6325,2227
97227,3748,1847,1901,603,1034,210,531,1102,268
97229,43561,21542,22019,7144,12369,2029,6971,12816,2232
97230,35205,17245,17960,4880,9291,3074,4673,8742,4545
97231,4285,2187,2098,514,1349,324,537,1271,290
97232,10557,5050,5507,803,3613,634,901,3523,1083
97233,34437,17300,17137,6338,9107,1855,5896,8645,2596
97236,33103,16166,16937,5582,8430,2154,5563,8488,2886
97266,38167,18967,19200,6201,10505,2261,5969,9984,3247
97267,28702,13915,14787,4117,7470,2328,3940,7763,3084
97301,52952,28040,24912,8990,15815,3235,8002,12215,4695
97302,36736,17578,19158,5424,9252,2902,5306,9800,4052
97303,53428,26373,27055,9411,13886,3076,8897,13955,4203
97304,22114,10589,11525,3228,5415,1946,3061,5602,2862
97305,34904,17410,17494,6273,8986,2151,5856,8885,2753
97306,22692,10923,11769,3565,5868,1490,3640,6420,1709
97321,48912,24120,24792,7908,12825,3387,7422,12803,4567
97324,1167,598,569,236,276,86,159,301,109
97325,5674,2763,2911,963,1348,452,966,1486,459
97326,816,418,398,143,195,80,111,200,87
97327,2573,1280,1293,422,617,241,428,649,216
97329,43,18,25,7,6,5,0,7,18
97330,40760,20412,20348,7048,10957,2407,6188,10750,3410
97331,1390,540,850,440,90,10,807,43,0
97333,17538,8781,8757,3047,4740,994,3195,4299,1263
97338,17952,8823,9129,3053,4247,1523,2582,4411,2136
97341,2240,1119,1121,232,506,381,117,560,444
97342,455,212,243,77,94,41,68,136,39
97343,483,256,227,116,120,20,68,140,19
97344,861,421,440,168,206,47,155,204,81
97345,656,373,283,111,180,82,74,150,59
97346,945,464,481,127,224,113,112,231,138
97347,1519,894,625,257,505,132,185,348,92
97348,1314,725,589,249,360,116,139,344,106
97350,177,82,95,26,43,13,41,48,6
97351,7034,3596,3438,1427,1713,456,1153,1828,457
97352,4972,2519,2453,913,1316,290,907,1215,331
97355,26479,13022,13457,4211,6375,2436,4038,6312,3107
97357,238,114,124,26,65,23,35,77,12
97358,2391,1163,1228,313,599,251,352,623,253
97360,1850,962,888,333,458,171,281,421,186
97361,10335,4844,5491,1894,2370,580,2328,2372,791
97362,4356,2281,2075,791,1167,323,670,915,490
97364,423,193,230,54,69,70,75,82,73
97365,10665,5203,5462,1412,2710,1081,1359,2704,1399
97366,1065,513,552,157,271,85,141,273,138
97367,10035,4740,5295,1328,2232,1180,1111,2591,1593
97368,3408,1748,1660,467,859,422,398,883,379
97370,8458,4202,4256,1488,2204,510,1513,2194,549
97371,604,289,315,115,118,56,81,145,89
97374,5016,2522,2494,744,1261,517,660,1334,500
97375,1339,717,622,245,368,104,195,322,105
97376,1030,436,594,65,244,127,109,303,182
97377,890,421,469,124,217,80,176,202,91
97378,8206,5204,3002,1355,3225,624,963,1462,577
97380,2243,1077,1166,318,568,191,374,597,195
97381,13203,6356,6847,2448,2925,983,2342,3199,1306
97383,8968,4451,4517,1634,2214,603,1539,2127,851
97385,2673,1245,1428,407,502,336,359,547,522
97386,12807,6178,6629,1939,2995,1244,2012,2989,1628
97389,1388,680,708,183,377,120,236,356,116
97390,592,317,275,80,144,93,50,162,63
97391,5236,2616,2620,855,1379,382,791,1434,395
97392,4806,2533,2273,660,1372,501,684,1134,455
97394,4775,2295,2480,578,1006,711,511,1114,855
97396,2969,1476,1493,492,747,237,455,787,251
97401,37063,18174,18889,5708,10399,2067,5851,9453,3585
97402,45071,22601,22470,6847,13156,2598,6656,12299,3515
97403,10138,5105,5033,2029,2582,494,2278,2142,613
97404,28668,14146,14522,4421,7696,2029,4276,7931,2315
97405,43777,21212,22565,6117,12001,3094,5753,12586,4226
97406,106,65,41,11,30,24,1,21,19
97408,9468,4504,4964,1366,2217,921,1280,2522,1162
97410,600,294,306,72,141,81,60,145,101
97411,6664,3064,3600,676,1416,972,738,1679,1183
97412,614,291,323,92,161,38,89,169,65
97413,851,392,459,112,154,126,81,244,134
97414,171,95,76,32,27,36,21,32,23
97415,13315,6646,6669,1595,2768,2283,1310,2860,2499
97416,790,386,404,112,173,101,112,221,71
97417,1798,891,907,276,414,201,239,441,227
97419,1283,670,613,186,304,180,162,308,143
97420,26848,13010,13838,3628,6390,2992,3701,6677,3460
97423,7037,3535,3502,872,1798,865,844,1762,896
97424,16668,8145,8523,2610,4008,1527,2372,4212,1939
97425,108,56,52,6,19,31,7,28,17
97426,7460,3568,3892,1162,1815,591,1252,1959,681
97427,402,201,201,70,99,32,57,125,19
97428,173,84,89,29,42,13,29,45,15
97429,568,293,275,83,143,67,66,141,68
97430,404,210,194,73,111,26,54,111,29
97431,2684,1338,1346,451,730,157,447,696,203
97434,366,202,164,72,76,54,62,78,24
97435,2126,1060,1066,311,518,231,295,539,232
97436,838,407,431,99,186,122,135,175,121
97437,2659,1291,1368,377,658,256,404,672,292
97438,1553,779,774,223,444,112,226,458,90
97439,12986,6115,6871,1265,2415,2435,1263,2755,2853
97441,344,197,147,86,80,31,36,84,27
97442,2112,1013,1099,326,493,194,352,521,226
97443,2368,1217,1151,453,537,227,341,598,212
97444,4746,2320,2426,543,1114,663,493,1215,718
97446,4208,2125,2083,801,1062,262,711,1055,317
97447,887,514,373,182,297,35,127,199,47
97448,12149,5993,6156,1868,3223,902,1743,3223,1190
97449,1519,767,752,125,365,277,144,354,254
97450,551,294,257,74,111,109,58,103,96
97451,354,180,174,43,124,13,45,105,24
97452,862,453,409,148,255,50,129,233,47
97453,961,443,518,125,203,115,149,237,132
97454,1107,576,531,194,289,93,100,343,88
97455,3039,1554,1485,481,771,302,355,809,321
97456,2550,1283,1267,407,688,188,364,702,201
97457,9884,4858,5026,1579,2244,1035,1406,2547,1073
97458,5228,2617,2611,774,1155,688,707,1203,701
97459,14490,7077,7413,2039,3707,1331,1991,3713,1709
97461,759,409,350,110,240,59,92,201,57
97462,4002,2065,1937,597,991,477,497,1012,428
97463,3760,1937,1823,589,918,430,501,813,509
97465,2129,1069,1060,237,481,351,186,512,362
97466,808,408,400,114,179,115,87,186,127
97467,5702,2835,2867,700,1259,876,583,1310,974
97469,2782,1336,1446,453,611,272,425,681,340
97470,46080,22404,23676,6463,11277,4664,6421,11516,5739
97473,332,178,154,62,70,46,39,81,34
97476,304,142,162,53,43,46,59,67,36
97477,35729,17230,18499,5522,9377,2331,5658,9315,3526
97478,32221,16056,16165,5377,8451,2228,4910,8693,2562
97479,8317,3954,4363,1204,1812,938,1158,2022,1183
97480,399,210,189,58,118,34,43,102,44
97481,682,365,317,152,177,36,94,174,49
97484,336,162,174,41,83,38,47,103,24
97486,652,349,303,78,165,106,73,136,94
97487,6592,3233,3359,1051,1760,422,1039,1803,517
97488,1142,635,507,166,331,138,114,297,96
97489,736,369,367,85,208,76,77,226,64
97490,338,164,174,44,86,34,77,80,17
97492,640,343,297,106,167,70,67,168,62
97493,253,135,118,35,50,50,11,44,63
97496,6867,3393,3474,1054,1661,678,988,1671,815
97497,1651,815,836,158,459,198,223,438,175
97498,1501,754,747,258,279,217,143,363,241
97499,2031,991,1040,294,495,202,293,518,229
97501,37045,18384,18661,6099,9615,2670,5621,9534,3506
97502,23514,11512,12002,3834,5641,2037,3614,5961,2427
97503,8892,4689,4203,1448,2429,812,1456,2154,593
97504,41019,19253,21766,5852,9319,4082,5719,10224,5823
97520,23761,10998,12763,3321,5762,1915,3630,6640,2493
97522,644,309,335,115,141,53,121,163,51
97523,6106,3041,3065,945,1390,706,783,1557,725
97524,10890,5384,5506,1806,2770,808,1815,2947,744
97525,5084,2454,2630,554,1289,611,637,1377,616
97526,32126,15138,16988,4604,7040,3494,4490,7841,4657
97527,28978,14089,14889,3922,6505,3662,3797,7032,4060
97530,6598,3310,3288,920,1635,755,807,1730,751
97531,348,183,165,24,114,45,31,80,54
97532,2085,1039,1046,233,497,309,194,602,250
97534,548,305,243,74,159,72,77,132,34
97535,4410,2175,2235,585,1129,461,446,1121,668
97536,927,482,445,119,231,132,115,222,108
97537,6816,3351,3465,876,1497,978,753,1628,1084
97538,2008,1079,929,365,475,239,278,461,190
97539,2692,1319,1373,308,644,367,348,644,381
97540,7553,3672,3881,1269,1776,627,1169,1837,875
97541,1204,634,570,144,314,176,102,332,136
97543,58,23,35,0,23,0,7,28,0
97544,2024,1017,1007,301,434,282,201,533,273
97601,21886,11037,10849,3807,5577,1653,3492,5448,1909
97603,28537,13972,14565,4434,6904,2634,4134,7078,3353
97604,25,13,12,0,7,6,0,12,0
97620,101,52,49,13,30,9,16,28,5
97621,480,245,235,85,111,49,103,101,31
97622,502,263,239,85,121,57,51,129,59
97623,2151,1083,1068,350,494,239,304,502,262
97624,3214,1621,1593,432,756,433,414,814,365
97625,83,44,39,15,22,7,7,32,0
97626,76,41,35,17,15,9,17,18,0
97627,1075,562,513,157,303,102,102,304,107
97630,5027,2483,2544,729,1172,582,697,1219,628
97632,1155,576,579,216,288,72,179,284,116
97633,1340,668,672,197,315,156,213,323,136
97634,73,49,24,21,28,0,10,7,7
97635,283,128,155,13,61,54,18,82,55
97636,420,219,201,57,112,50,48,98,55
97637,94,51,43,13,28,10,5,21,17
97638,441,216,225,72,115,29,73,129,23
97639,365,189,176,40,121,28,49,93,34
97640,85,47,38,21,20,6,10,20,8
97641,991,521,470,144,251,126,117,251,102
97701,44462,21665,22797,6435,12225,3005,6697,12471,3629
97702,29046,14353,14693,4386,7874,2093,4501,7682,2510
97707,4963,2565,2398,632,1194,739,485,1234,679
97710,69,40,29,16,24,0,0,27,2
97711,103,42,61,8,25,9,26,23,12
97712,34,17,17,0,10,7,0,15,2
97720,6482,3261,3221,997,1598,666,875,1584,762
97721,266,147,119,61,73,13,40,64,15
97722,47,29,18,9,14,6,5,7,6
97730,272,133,139,34,66,33,38,75,26
97731,437,240,197,69,118,53,50,98,49
97732,143,64,79,23,29,12,29,34,16
97733,766,366,400,109,176,81,107,221,72
97734,2160,1125,1035,348,516,261,311,491,233
97735,112,58,54,10,29,19,11,23,20
97736,85,47,38,24,18,5,17,17,4
97737,435,250,185,81,106,63,57,52,76
97738,244,111,133,22,73,16,59,63,11
97739,8688,4451,4237,1095,2056,1300,932,2099,1206
97741,10437,5304,5133,1851,2738,715,1731,2551,851
97750,419,212,207,57,94,61,48,104,55
97751,95,60,35,19,34,7,0,35,0
97752,150,101,49,70,31,0,14,35,0
97753,1907,969,938,269,531,169,227,575,136
97754,16847,8283,8564,2656,4031,1596,2686,4086,1792
97756,22002,10724,11278,3448,5390,1886,3352,5662,2264
97758,91,41,50,14,25,2,27,21,2
97759,4831,2446,2385,678,1191,577,653,1206,526
97760,5863,3003,2860,790,1415,798,709,1486,665
97761,3261,1654,1607,799,760,95,756,730,121
97801,21658,11428,10230,3371,6477,1580,3218,5038,1974
97810,806,401,405,109,198,94,135,208,62
97812,778,409,369,117,230,62,104,191,74
97813,1355,702,653,283,316,103,204,312,137
97814,12478,6053,6425,1775,2925,1353,1744,3014,1667
97817,13,5,8,0,2,3,0,2,6
97818,3888,2028,1860,842,1016,170,793,906,161
97819,64,37,27,12,16,9,4,17,6
97820,983,489,494,156,228,105,135,249,110
97823,1137,565,572,150,256,159,124,259,189
97824,1503,732,771,228,349,155,218,392,161
97825,229,112,117,23,54,35,22,55,40
97826,1047,527,520,188,259,80,181,235,104
97827,2411,1193,1218,366,575,252,343,599,276
97828,3079,1513,1566,414,704,395,389,728,449
97830,751,361,390,90,157,114,104,158,128
97833,1002,512,490,171,208,133,172,215,103
97834,1117,557,560,173,252,132,165,246,149
97835,380,209,171,95,84,30,70,76,25
97836,2067,1052,1015,329,470,253,249,510,256
97837,140,73,67,18,34,21,22,30,15
97838,22236,11304,10932,3819,6127,1358,3614,5474,1844
97839,443,236,207,62,116,58,54,102,51
97840,140,74,66,15,48,11,13,34,19
97841,396,192,204,72,97,23,66,100,38
97842,188,110,78,51,36,23,20,39,19
97843,708,362,346,106,174,82,128,155,63
97844,3833,1959,1874,741,956,262,652,964,258
97845,2767,1353,1414,432,633,288,476,641,297
97846,1970,1012,958,263,506,243,245,508,205
97848,220,111,109,23,56,32,26,47,36
97850,16464,8005,8459,2745,3926,1334,2715,4039,1705
97856,363,182,181,46,77,59,45,86,50
97857,490,236,254,65,118,53,77,130,47
97859,116,54,62,14,31,9,21,36,5
97862,11242,5429,5813,1886,2574,969,1824,2712,1277
97864,230,125,105,43,68,14,16,74,15
97865,1176,589,587,186,272,131,132,309,146
97867,725,367,358,126,177,64,112,187,59
97868,2116,1065,1051,331,539,195,338,513,200
97869,1387,691,696,241,312,138,199,326,171
97870,602,288,314,54,105,129,53,130,131
97872,29,15,14,2,9,4,0,11,3
97873,338,164,174,50,94,20,54,95,25
97874,369,187,182,55,76,56,38,88,56
97875,2653,1382,1271,483,710,189,469,618,184
97876,745,392,353,117,201,74,82,210,61
97877,180,101,79,8,51,42,5,39,35
97880,372,187,185,52,83,52,49,102,34
97882,5209,2610,2599,999,1286,325,1059,1201,339
97883,2246,1106,1140,351,502,253,321,545,274
97884,234,109,125,41,54,14,54,45,26
97885,1493,748,745,255,353,140,204,358,183
97886,1328,670,658,235,329,106,215,309,134
97901,734,376,358,160,148,68,130,149,79
97903,127,68,59,8,19,41,8,25,26
97904,136,72,64,23,36,13,17,33,14
97905,142,89,53,16,46,27,5,24,24
97906,262,142,120,53,56,33,39,65,16
97907,634,334,300,82,154,98,78,135,87
97908,62,26,36,6,8,12,10,13,13
97909,17,7,10,0,0,7,6,0,4
97910,660,316,344,105,151,60,107,164,73
97911,115,57,58,21,22,14,19,29,10
97913,5639,2785,2854,1118,1220,447,1094,1267,493
97914,19269,10730,8539,3265,6054,1411,2864,3792,1883
97918,4716,2437,2279,842,1153,442,805,1029,445
97920,38,19,19,6,10,3,4,15,0
98001,25495,12830,12665,4185,7198,1447,4250,6705,1710
98002,30905,15170,15735,5222,7786,2162,4704,7890,3141
98003,42614,20665,21949,6929,11385,2351,6892,11901,3156
98004,22903,10899,12004,2574,5955,2370,2450,6215,3339
98005,17150,8504,8646,1882,5208,1414,1834,5094,1718
98006,35140,17505,17635,5358,9595,2552,4714,10262,2659
98007,22814,11635,11179,2997,7306,1332,2635,6589,1955
98008,23490,11545,11945,3100,6351,2094,2786,6543,2616
98010,4435,2347,2088,965,1190,192,614,1286,188
98011,26395,12838,13557,4066,7525,1247,3836,8078,1643
98012,38398,18882,19516,6206,11075,1601,6150,11334,2032
98014,6936,3518,3418,1253,1963,302,1164,1974,280
98019,8162,4053,4109,1365,2467,221,1347,2537,225
98020,17942,8250,9692,2082,4110,2058,2154,4594,2944
98021,20308,10194,10114,3420,5544,1230,3015,5512,1587
98022,21830,10759,11071,3792,5522,1445,3604,5575,1892
98023,47500,23299,24201,8071,13183,2045,7988,13864,2349
98024,4981,2545,2436,913,1361,271,750,1389,297
98025,17,8,9,0,8,0,0,9,0
98026,34760,17034,17726,5185,9524,2325,4612,10274,2840
98027,22271,10937,11334,3359,6334,1244,2965,6755,1614
98028,18194,9071,9123,2676,5327,1068,2465,5219,1439
98029,28497,13965,14532,5169,7545,1251,4839,7985,1708
98031,64181,31759,32422,11666,17549,2544,11053,18050,3319
98032,28756,14448,14308,4273,8734,1441,4196,8094,2018
98033,30185,14837,15348,3377,9648,1812,3578,9387,2383
98034,40127,19763,20364,5855,11966,1942,5169,12537,2658
98036,33844,16700,17144,5364,9670,1666,5248,9560,2336
98037,43659,21312,22347,6874,12111,2327,6877,12408,3062
98038,22453,11329,11124,4037,6245,1047,3752,6360,1012
98039,3037,1490,1547,469,702,319,421,789,337
98040,22036,10642,11394,3229,5137,2276,3062,5414,2918
98042,38249,19302,18947,6958,10635,1709,6390,10660,1897
98043,20384,10164,10220,3272,5823,1069,3043,5706,1471
98045,13777,7130,6647,2429,4074,627,2037,3781,829
98047,5164,2542,2622,992,1369,181,936,1505,181
98051,2875,1452,1423,461,807,184,424,849,150
98052,50138,24921,25217,6821,15827,2273,6526,15282,3409
98053,31050,15814,15236,5944,8939,931,5191,9207,838
98055,26819,13296,13523,3682,8034,1580,3530,7682,2311
98056,24363,12130,12233,3457,7278,1395,3083,7143,2007
98058,37695,18815,18880,6319,10583,1913,5765,11073,2042
98059,28181,14127,14054,4277,8471,1379,3859,8539,1656
98065,3710,1853,1857,522,1167,164,591,1077,189
98068,212,110,102,35,62,13,32,65,5
98070,10123,4943,5180,1366,2692,885,1247,2993,940
98072,35549,17794,17755,6308,10079,1407,6058,10192,1505
98092,24972,12802,12170,4583,7154,1065,4088,6843,1239
98101,8753,4665,4088,233,3484,948,378,2374,1336
98102,19407,10680,8727,879,8939,862,724,7023,980
98103,42011,20629,21382,3203,15809,1617,3361,15301,2720
98104,13159,8644,4515,913,6809,922,644,2801,1070
98105,39168,20315,18853,7613,11232,1470,7450,9655,1748
98106,23106,11606,11500,4072,6522,1012,3579,6635,1286
98107,18314,8568,9746,1272,6216,1080,1565,6458,1723
98108,21376,10674,10702,3068,6091,1515,3423,5508,1771
98109,16090,7866,8224,733,6225,908,839,6092,1293
98110,20308,9837,10471,3155,5083,1599,2833,5744,1894
98112,20418,9808,10610,1861,6636,1311,1835,6855,1920
98115,43263,20841,22422,4452,13438,2951,4312,13875,4235
98116,20815,9974,10841,1679,6709,1586,1763,6722,2356
98117,29868,14661,15207,3028,9612,2021,2867,9561,2779
98118,40409,19675,20734,6431,10708,2536,5958,11116,3660
98119,19493,9458,10035,1859,6675,924,2382,6220,1433
98121,8628,5092,3536,699,3803,590,424,2531,581
98122,28985,15303,13682,3408,10376,1519,3040,8747,1895
98125,34926,17062,17864,4040,10435,2587,3741,10204,3919
98126,19435,9329,10106,2424,5733,1172,2401,5798,1907
98133,43121,20755,22366,5114,12503,3138,4921,12247,5198
98134,607,452,155,0,357,95,72,45,38
98136,13969,6639,7330,1243,4231,1165,1336,4428,1566
98144,25067,12437,12630,3085,7444,1908,3117,7007,2506
98146,25593,12549,13044,3761,6963,1825,3856,6957,2231
98148,9533,4624,4909,1314,2702,608,1248,2842,819
98154,0,0,0,0,0,0,0,0,0
98155,33958,16638,17320,4572,9717,2349,4319,9826,3175
98164,0,0,0,0,0,0,0,0,0
98166,20163,9724,10439,2432,5248,2044,2633,5448,2358
98168,30412,15646,14766,4961,8975,1710,4589,7954,2223
98174,169,0,169,0,0,0,41,128,0
98177,18829,9073,9756,2411,4774,1888,2389,5043,2324
98178,21956,10689,11267,3038,5826,1825,3036,5957,2274
98188,22269,11623,10646,3336,7007,1280,2778,6196,1672
98198,33807,16576,17231,5100,9185,2291,4895,8976,3360
98199,19287,9396,9891,1902,5910,1584,1736,6188,1967
98201,30252,16053,14199,5159,9196,1698,4257,7308,2634
98203,31615,15679,15936,4922,8700,2057,4570,8564,2802
98204,31686,16184,15502,5281,9577,1326,5250,8513,1739
98205,17611,8765,8846,3185,4848,732,3120,4886,840
98208,45296,22556,22740,7755,12764,2037,7344,12784,2612
98220,563,318,245,71,188,59,47,152,46
98221,18524,8987,9537,2479,4218,2290,2350,4577,2610
98222,33,16,17,0,0,16,0,0,17
98223,33784,16910,16874,5786,9281,1843,5547,9100,2227
98224,193,114,79,23,69,22,11,49,19
98225,42629,20668,21961,6478,11726,2464,7810,10458,3693
98226,56513,27806,28707,8964,14859,3983,8663,15355,4689
98230,10704,5313,5391,1637,2620,1056,1477,2877,1037
98232,3614,1774,1840,599,937,238,572,1001,267
98233,12461,6175,6286,2178,3085,912,2037,3056,1193
98235,59,41,18,0,30,11,0,8,10
98236,5677,2781,2896,798,1417,566,720,1578,598
98237,2856,1423,1433,477,750,196,520,701,212
98238,49,26,23,7,19,0,7,16,0
98239,5845,2746,3099,655,1313,778,738,1464,897
98240,2561,1400,1161,568,638,194,301,676,184
98241,2120,1040,1080,351,497,192,318,509,253
98243,116,70,46,0,16,54,0,19,27
98244,2459,1361,1098,511,695,155,317,644,137
98245,3318,1627,1691,432,902,293,400,967,324
98247,7812,3905,3907,1431,2049,425,1444,1970,493
98248,18521,9332,9189,3411,4674,1247,3119,4784,1286
98249,3582,1675,1907,383,745,547,375,980,552
98250,6894,3374,3520,910,1620,844,771,1827,922
98251,4202,2204,1998,684,1294,226,657,1140,201
98252,6587,3289,3298,1123,1795,371,1175,1806,317
98253,1339,636,703,105,337,194,134,369,200
98256,513,293,220,56,195,42,42,156,22
98257,3708,1815,1893,470,773,572,432,859,602
98258,16637,8407,8230,2927,4695,785,2729,4602,899
98260,4895,2309,2586,668,1187,454,756,1256,574
98261,2304,1141,1163,245,547,349,233,611,319
98262,821,390,431,83,223,84,106,227,98
98264,16789,8180,8609,3093,3857,1230,2998,3938,1673
98267,609,320,289,55,170,95,96,132,61
98270,34908,16885,18023,5992,9056,1837,6081,9335,2607
98271,23421,11903,11518,4194,6243,1466,3888,6097,1533
98272,23059,12297,10762,3718,7614,965,3774,5748,1240
98273,25426,12499,12927,4454,6467,1578,4543,6285,2099
98274,13481,6459,7022,2072,3298,1089,2027,3521,1474
98275,19264,9670,9594,3281,5557,832,3056,5535,1003
98277,36691,18887,17804,6891,9811,2185,5919,9175,2710
98279,678,303,375,11,146,146,55,157,163
98280,349,180,169,20,100,60,22,79,68
98281,1287,625,662,124,379,122,149,352,161
98283,354,226,128,48,134,44,28,68,32
98284,22575,11228,11347,3764,5701,1763,3655,5738,1954
98286,234,109,125,33,32,44,22,50,53
98288,452,228,224,55,112,61,45,139,40
98290,29742,14984,14758,5418,7896,1670,4736,8107,1915
98292,31514,15841,15673,4997,8024,2820,4458,7954,3261
98294,5647,2877,2770,1057,1498,322,930,1416,424
98295,4962,2478,2484,1022,1198,258,999,1226,259
98296,19202,9795,9407,3545,5470,780,3091,5617,699
98297,132,76,56,31,38,7,13,28,15
98303,2270,1841,429,207,1441,193,56,194,179
98304,895,469,426,102,260,107,126,228,72
98305,345,194,151,52,127,15,34,89,28
98310,18691,8847,9844,2715,4577,1555,2641,4693,2510
98311,23604,11630,11974,4058,6159,1413,3924,6334,1716
98312,31833,15964,15869,5401,8638,1925,5152,8434,2283
98315,7253,4865,2388,1657,3208,0,1114,1274,0
98320,1194,602,592,102,247,253,110,249,233
98321,14662,7366,7296,2504,4074,788,2589,4001,706
98323,846,435,411,181,219,35,165,216,30
98325,1383,672,711,168,416,88,225,402,84
98326,553,270,283,96,137,37,98,139,46
98327,2173,1060,1113,300,663,97,325,663,125
98328,8712,4522,4190,1645,2209,668,1340,2152,698
98329,9387,4781,4606,1709,2599,473,1429,2656,521
98330,69,28,41,0,25,3,20,15,6
98331,6268,3371,2897,1240,1764,367,1070,1436,391
98332,12975,6017,6958,1765,3109,1143,1736,4050,1172
98333,2803,1391,1412,450,732,209,415,772,225
98335,23291,11257,12034,3611,5830,1816,3469,6268,2297
98336,1208,605,603,150,301,154,191,287,125
98337,8524,5105,3419,1907,2951,247,1268,1758,393
98338,20719,10381,10338,3786,5734,861,3557,5768,1013
98339,3386,1628,1758,534,784,310,537,875,346
98340,1908,921,987,213,399,309,214,445,328
98342,723,354,369,83,188,83,81,230,58
98345,444,234,210,75,126,33,95,109,6
98346,8389,4198,4191,1405,2319,474,1322,2358,511
98349,3630,1950,1680,556,1034,360,457,854,369
98350,364,214,150,97,96,21,66,75,9
98351,1139,565,574,99,317,149,161,288,125
98353,100,65,35,20,34,11,8,27,0
98354,5730,2765,2965,901,1489,375,774,1594,597
98355,596,322,274,77,201,44,60,168,46
98356,2162,1038,1124,312,491,235,310,510,304
98357,1356,731,625,307,363,61,267,290,68
98358,876,473,403,100,213,160,48,199,156
98359,3825,1925,1900,603,1107,215,582,1042,276
98360,7432,3912,3520,1387,2017,508,1174,1878,468
98361,1094,531,563,102,291,138,167,226,170
98362,21199,10309,10890,2978,4993,2338,2712,5131,3047
98363,12252,5991,6261,1874,3007,1110,1848,3214,1199
98364,39,25,14,0,10,15,0,9,5
98365,3575,1811,1764,290,716,805,222,826,716
98366,31643,15912,15731,5459,8439,2014,4894,8352,2485
98367,24601,12422,12179,4234,6596,1592,3926,6854,1399
98368,12736,6074,6662,1360,3151,1563,1382,3383,1897
98370,25302,12520,12782,4060,6564,1896,3558,6813,2411
98371,20185,10000,10185,3194,5157,1649,2968,5290,1927
98372,20914,10016,10898,3219,5457,1340,3176,5700,2022
98373,16595,8144,8451,2620,4640,884,2696,4807,948
98374,29246,14251,14995,5253,7692,1306,5386,7913,1696
98375,14207,7114,7093,2955,3594,565,2488,3928,677
98376,1812,962,850,295,472,195,221,459,170
98377,2120,1047,1073,278,502,267,290,557,226
98380,3328,1730,1598,511,946,273,494,824,280
98381,1479,1193,286,364,768,61,65,154,67
98382,21647,10233,11414,2223,4003,4007,2155,4632,4627
98383,19153,9665,9488,3391,5410,864,3146,5113,1229
98385,198,116,82,54,54,8,28,44,10
98387,35760,18007,17753,6595,9806,1606,6178,9965,1610
98388,6183,2998,3185,878,1549,571,795,1679,711
98390,45092,22700,22392,8061,12633,2006,7617,12389,2386
98392,2387,1164,1223,368,668,128,350,721,152
98394,905,442,463,119,219,104,97,238,128
98396,411,191,220,68,98,25,87,108,25
98402,4939,2948,1991,475,2154,319,255,1111,625
98403,7749,3816,3933,801,2533,482,753,2470,710
98404,30646,15272,15374,6330,7479,1463,5424,7738,2212
98405,22362,10849,11513,3800,5752,1297,3321,5897,2295
98406,23407,10892,12515,3480,5571,1841,3614,5911,2990
98407,20696,9855,10841,2911,5279,1665,2805,5716,2320
98408,29121,14292,14829,4743,7766,1783,4614,7690,2525
98409,21920,10723,11197,3688,5992,1043,3784,5756,1657
98421,565,541,24,7,534,0,6,18,0
98422,19689,9707,9982,3153,5559,995,3009,5964,1009
98424,4851,2479,2372,776,1488,215,828,1288,256
98433,19628,12352,7276,5871,6422,59,3631,3623,22
98439,6944,3564,3380,1699,1799,66,1667,1637,76
98443,5667,2718,2949,847,1435,436,901,1492,556
98444,31682,15236,16446,5737,7954,1545,6042,8077,2327
98445,22044,10914,11130,3794,5715,1405,3414,5952,1764
98446,9518,4655,4863,1462,2441,752,1505,2459,899
98465,6502,3253,3249,946,1753,554,705,1800,744
98466,24567,11636,12931,3609,6116,1911,3364,6974,2593
98467,15190,7219,7971,2599,3825,795,2595,4333,1043
98498,28612,14045,14567,3977,7486,2582,3710,7657,3200
98499,29303,14300,15003,5033,7457,1810,4692,7572,2739
98501,33292,16088,17204,5158,8903,2027,5071,9435,2698
98502,26111,12690,13421,3855,7059,1776,4016,7231,2174
98503,32211,15104,17107,4750,7992,2362,4994,8791,3322
98506,17287,8302,8985,2164,4908,1230,2273,4818,1894
98512,23988,12014,11974,3651,6700,1663,3302,6555,2117
98513,24043,11950,12093,4055,6537,1358,3641,6942,1510
98516,14611,7180,7431,2397,4008,775,2259,4198,974
98520,21650,10699,10951,3477,5438,1784,3415,5247,2289
98524,1542,729,813,113,329,287,201,315,297
98526,487,268,219,98,138,32,91,116,12
98527,247,131,116,44,58,29,36,54,26
98528,7939,4140,3799,1389,2117,634,1165,1940,694
98530,582,304,278,122,150,32,117,131,30
98531,21806,10565,11241,3396,5299,1870,3304,5082,2855
98532,20040,10093,9947,3549,4963,1581,3083,4836,2028
98533,486,259,227,69,100,90,66,111,50
98535,509,241,268,43,130,68,62,97,109
98536,272,118,154,24,73,21,17,103,34
98537,1797,898,899,292,441,165,277,461,161
98538,349,158,191,54,78,26,83,84,24
98539,211,118,93,57,46,15,27,48,18
98541,9219,4681,4538,1544,2296,841,1449,2243,846
98542,548,303,245,122,126,55,47,125,73
98546,2164,1055,1109,246,463,346,287,498,324
98547,1583,797,786,156,366,275,150,401,235
98548,1790,931,859,157,381,393,112,379,368
98550,11773,5740,6033,2012,2824,904,1859,2877,1297
98552,625,332,293,115,174,43,101,150,42
98555,546,253,293,41,68,144,57,63,173
98557,2863,1383,1480,448,680,255,423,744,313
98559,65,33,32,21,12,0,17,15,0
98560,164,72,92,17,48,7,36,43,13
98562,174,82,92,0,53,29,11,57,24
98563,7323,3616,3707,1122,1909,585,1047,1872,788
98564,2212,1122,1090,373,526,223,354,517,219
98565,457,200,257,72,97,31,96,112,49
98568,2332,1153,1179,407,549,197,415,584,180
98569,4155,2040,2115,392,917,731,422,896,797
98570,3577,1790,1787,639,823,328,569,857,361
98571,525,295,230,134,113,48,64,122,44
98572,865,436,429,152,204,80,134,215,80
98575,153,73,80,26,36,11,16,49,15
98576,3298,1683,1615,562,890,231,510,852,253
98577,6437,3196,3241,977,1558,661,838,1517,886
98579,9903,4951,4952,1691,2482,778,1694,2617,641
98580,9465,4800,4665,1631,2662,507,1472,2620,573
98581,426,182,244,2,21,159,3,31,210
98582,340,185,155,57,92,36,42,81,32
98584,31065,16256,14809,4761,8664,2831,4319,7264,3226
98585,640,365,275,123,148,94,80,128,67
98586,2285,1106,1179,342,534,230,335,545,299
98587,855,459,396,188,222,49,168,190,38
98588,1496,766,730,186,364,216,168,352,210
98589,6475,3281,3194,1071,1688,522,934,1735,525
98590,440,257,183,77,118,62,71,73,39
98591,3101,1543,1558,512,743,288,463,768,327
98592,1328,656,672,152,308,196,123,349,200
98593,1071,548,523,211,262,75,191,263,69
98595,2856,1434,1422,404,659,371,335,668,419
98596,6589,3276,3313,1061,1606,609,1052,1626,635
98597,14475,7040,7435,2513,3618,909,2429,3954,1052
98601,2280,1216,1064,416,661,139,344,601,119
98602,214,107,107,29,52,26,30,67,10
98603,725,363,362,120,197,46,144,187,31
98604,24731,12427,12304,5021,6170,1236,4468,6449,1387
98605,1130,565,565,195,297,73,183,309,73
98606,8409,4263,4146,1526,2280,457,1439,2239,468
98607,18256,8990,9266,3152,4828,1010,3019,5000,1247
98610,2746,1342,1404,415,699,228,462,710,232
98611,8197,4039,4158,1261,2116,662,1222,2127,809
98612,2595,1319,1276,385,612,322,348,589,339
98613,518,271,247,87,145,39,76,138,33
98614,545,291,254,97,112,82,46,111,97
98616,27,9,18,0,9,0,7,11,0
98617,1062,496,566,150,214,132,195,265,106
98619,481,257,224,78,132,47,53,135,36
98620,6969,3233,3736,855,1673,705,1213,1748,775
98621,233,114,119,34,58,22,32,64,23
98624,1304,634,670,211,295,128,159,319,192
98625,4486,2250,2236,689,1186,375,677,1160,399
98626,22623,11177,11446,3778,5676,1723,3754,5768,1924
98628,335,169,166,76,78,15,70,77,19
98629,7099,3566,3533,1244,1948,374,1195,2027,311
98631,3450,1607,1843,352,766,489,349,841,653
98632,47215,23050,24165,7594,11912,3544,7186,12039,4940
98635,2060,1054,1006,321,502,231,266,506,234
98638,1362,717,645,266,315,136,174,336,135
98639,521,253,268,57,151,45,84,142,42
98640,3768,1836,1932,353,640,843,309,871,752
98641,62,33,29,0,33,0,0,18,11
98642,12528,6292,6236,2023,3377,892,1835,3384,1017
98643,397,197,200,60,92,45,54,101,45
98644,536,287,249,40,140,107,25,116,108
98645,1260,673,587,226,328,119,181,345,61
98647,384,181,203,12,141,28,22,125,56
98648,2780,1360,1420,410,708,242,422,745,253
98649,725,350,375,118,155,77,126,193,56
98650,752,383,369,128,180,75,123,178,68
98651,1005,548,457,179,290,79,127,271,59
98660,10118,5170,4948,1372,3132,666,1501,2580,867
98661,36762,17950,18812,5956,9813,2181,5984,9767,3061
98662,23738,11706,12032,4008,6313,1385,3639,6555,1838
98663,13969,6995,6974,2184,3853,958,1888,3750,1336
98664,20450,9720,10730,2971,5178,1571,2968,5700,2062
98665,20751,10141,10610,3405,5374,1362,3156,5477,1977
98670,138,65,73,31,26,8,23,32,18
98671,15109,7522,7587,2549,4017,956,2403,4042,1142
98672,5149,2565,2584,823,1329,413,773,1310,501
98673,155,79,76,19,41,19,11,39,26
98674,9155,4697,4458,1639,2391,667,1378,2365,715
98675,4914,2643,2271,1040,1439,164,991,1097,183
98682,42977,21483,21494,8358,11736,1389,7996,11837,1661
98683,28203,13593,14610,4283,7376,1934,4316,7803,2491
98684,20781,10472,10309,3922,5688,862,3465,5801,1043
98685,21223,10392,10831,3668,5467,1257,3498,5789,1544
98686,13393,6619,6774,2256,3597,766,2137,3791,846
98801,36655,17990,18665,6281,8948,2761,6133,8862,3670
98802,23173,11195,11978,3838,5579,1778,3841,5968,2169
98811,76,33,43,10,20,3,16,25,2
98812,5310,2670,2640,1083,1269,318,1015,1203,422
98813,2451,1307,1144,601,543,163,460,545,139
98814,568,303,265,76,147,80,67,134,64
98815,7754,4054,3700,1521,1957,576,1143,1867,690
98816,6220,3089,3131,1035,1454,600,860,1603,668
98817,217,107,110,25,75,7,33,47,30
98819,260,127,133,16,51,60,18,79,36
98821,299,156,143,47,88,21,66,60,17
98822,1883,943,940,335,467,141,329,466,145
98823,9880,4986,4894,1930,2307,749,1715,2280,899
98826,6546,3256,3290,914,1569,773,853,1636,801
98827,498,257,241,58,118,81,63,96,82
98828,1846,951,895,344,464,143,346,409,140
98829,508,267,241,81,95,91,70,89,82
98830,470,212,258,48,112,52,66,132,60
98831,3224,1648,1576,617,795,236,589,724,263
98832,337,214,123,55,124,35,42,63,18
98833,66,28,38,0,10,18,0,38,0
98834,298,157,141,70,63,24,61,66,14
98836,374,175,199,68,96,11,92,78,29
98837,32410,16007,16403,6137,7708,2162,6076,7677,2650
98840,4765,2374,2391,783,1183,408,705,1247,439
98841,9035,4367,4668,1506,2157,704,1555,2212,901
98843,1465,785,680,281,432,72,293,341,46
98844,4493,2269,2224,751,1060,458,694,1020,510
98845,66,32,34,2,23,7,9,22,3
98846,1010,496,514,171,241,84,153,244,117
98847,1421,664,757,226,344,94,321,366,70
98848,9796,5156,4640,2096,2324,736,1879,2025,736
98849,959,516,443,124,284,108,144,209,90
98850,1895,928,967,374,431,123,415,438,114
98851,3785,1905,1880,608,822,475,477,852,551
98852,95,52,43,8,44,0,17,26,0
98853,51,26,25,6,7,13,2,15,8
98855,5317,2618,2699,772,1352,494,853,1295,551
98856,2181,1059,1122,244,585,230,252,617,253
98857,3719,1944,1775,873,852,219,711,833,231
98858,1658,833,825,256,407,170,236,402,187
98859,334,175,159,91,75,9,60,96,3
98860,248,124,124,35,51,38,23,69,32
98862,1938,954,984,218,547,189,221,563,200
98901,28799,14887,13912,5783,7448,1656,5348,6622,1942
98902,42803,20496,22307,7480,10263,2753,7197,10547,4563
98903,13737,6905,6832,2300,3474,1131,2010,3378,1444
98908,31682,15394,16288,4972,7994,2428,4563,8362,3363
98922,4687,2320,2367,569,1183,568,619,1197,551
98923,1512,737,775,319,343,75,320,365,90
98925,614,348,266,92,172,84,65,153,48
98926,24857,12214,12643,4349,6339,1526,4700,6030,1913
98930,12863,6384,6479,2706,2887,791,2675,2911,893
98932,4046,2059,1987,967,886,206,933,835,219
98933,1201,590,611,267,269,54,284,283,44
98934,494,269,225,92,148,29,68,125,32
98935,3829,1966,1863,840,906,220,897,771,195
98936,3397,1683,1714,584,879,220,600,898,216
98937,3104,1530,1574,429,726,375,391,798,385
98938,2143,1129,1014,462,531,136,424,474,116
98940,436,244,192,49,134,61,12,135,45
98941,994,491,503,149,238,104,111,262,130
98942,15655,7590,8065,2846,3779,965,2833,4094,1138
98943,469,234,235,88,107,39,74,115,46
98944,20117,10142,9975,4489,4685,968,4224,4401,1350
98946,475,252,223,99,111,42,66,127,30
98947,2818,1384,1434,530,683,171,584,667,183
98948,13247,6782,6465,3039,3106,637,2779,2750,936
98950,91,46,45,10,27,9,14,27,4
98951,13634,6817,6817,2955,3100,762,2920,3017,880
98952,2693,1469,1224,733,620,116,604,514,106
98953,6116,3037,3079,1177,1507,353,1226,1397,456
99001,1330,678,652,240,350,88,213,355,84
99003,4725,2342,2383,749,1207,386,796,1265,322
99004,14480,6952,7528,2761,3401,790,3234,3447,847
99005,6803,3426,3377,1269,1764,393,1114,1880,383
99006,9028,4550,4478,1644,2215,691,1414,2325,739
99008,718,356,362,91,190,75,110,189,63
99009,3494,1852,1642,655,947,250,539,844,259
99011,4686,2537,2149,1151,1369,17,982,1148,19
99012,1017,550,467,195,246,109,117,229,121
99013,910,484,426,172,263,49,157,215,54
99016,7112,3527,3585,1207,1817,503,1032,1935,618
99017,213,108,105,26,56,26,34,38,33
99018,318,150,168,53,76,21,61,77,30
99019,5423,2710,2713,953,1397,360,855,1490,368
99020,54,27,27,0,18,9,7,12,8
99021,8431,4222,4209,1538,2216,468,1382,2235,592
99022,7244,3772,3472,1281,2006,485,986,2057,429
99023,331,162,169,45,95,22,34,104,31
99025,4792,2460,2332,972,1284,204,797,1341,194
99026,7500,3739,3761,1356,1981,402,1281,2039,441
99027,6297,3048,3249,951,1673,424,1028,1684,537
99029,1341,702,639,261,316,125,154,336,149
99030,754,380,374,144,164,72,124,178,72
99031,885,490,395,132,228,130,95,229,71
99032,701,348,353,109,163,76,109,168,76
99033,914,425,489,125,187,113,143,195,151
99034,231,107,124,41,51,15,40,68,16
99036,776,405,371,101,249,55,89,222,60
99037,11759,5769,5990,2060,2980,729,1973,2979,1038
99040,1012,496,516,239,220,37,234,236,46
99101,1407,739,668,268,361,110,253,325,90
99102,547,253,294,61,155,37,89,169,36
99103,570,283,287,96,136,51,107,136,44
99105,54,30,24,10,16,4,6,14,4
99109,4334,2081,2253,725,932,424,637,1050,566
99110,1271,602,669,199,298,105,226,306,137
99111,4166,2064,2102,603,1042,419,565,982,555
99113,721,345,376,100,190,55,133,179,64
99114,12154,5907,6247,1934,2916,1057,1777,3062,1408
99115,1132,600,532,145,296,159,127,264,141
99116,1628,837,791,252,411,174,193,397,201
99117,541,283,258,70,125,88,46,133,79
99118,1234,680,554,339,281,60,205,277,72
99119,1102,533,569,148,272,113,154,282,133
99121,92,44,48,5,30,9,15,23,10
99122,3263,1586,1677,467,728,391,447,762,468
99123,891,420,471,102,207,111,120,235,116
99124,124,71,53,19,33,19,6,29,18
99125,885,455,430,189,227,39,118,242,70
99126,779,371,408,129,206,36,173,202,33
99128,414,197,217,82,85,30,91,92,34
99129,723,349,374,136,135,78,141,179,54
99130,885,442,443,141,214,87,115,218,110
99131,199,102,97,27,52,23,32,43,22
99133,1660,786,874,230,347,209,209,446,219
99134,585,294,291,83,140,71,73,138,80
99135,232,125,107,52,55,18,25,48,34
99136,43,24,19,4,10,10,2,7,10
99137,329,163,166,50,70,43,56,76,34
99138,1178,594,584,199,306,89,200,278,106
99139,1160,560,600,162,242,156,162,279,159
99140,431,223,208,97,87,39,65,106,37
99141,5159,2590,2569,807,1237,546,726,1287,556
99143,797,430,367,155,189,86,96,165,106
99146,38,16,22,3,7,6,10,4,8
99148,1966,1059,907,328,473,258,236,453,218
99149,209,101,108,25,47,29,36,48,24
99150,250,133,117,46,57,30,38,53,26
99151,137,67,70,20,33,14,18,43,9
99152,209,115,94,43,47,25,37,42,15
99153,462,259,203,76,141,42,69,100,34
99154,20,10,10,0,8,2,2,6,2
99155,1257,605,652,279,270,56,282,298,72
99156,7008,3489,3519,1081,1696,712,1045,1771,703
99157,685,359,326,128,171,60,83,189,54
99158,614,304,310,97,143,64,80,152,78
99159,1730,905,825,323,386,196,219,374,232
99160,106,56,50,9,28,19,15,20,15
99161,1454,723,731,213,380,130,207,387,137
99163,26222,13393,12829,5730,6947,716,6083,5869,877
99166,2974,1510,1464,446,776,288,401,783,280
99167,618,316,302,103,140,73,110,139,53
99169,2545,1230,1315,336,602,292,333,623,359
99170,1167,583,584,188,279,116,155,302,127
99171,1061,530,531,139,245,146,140,228,163
99173,1280,665,615,239,306,120,184,315,116
99176,256,123,133,45,59,19,59,60,14
99179,511,263,248,90,113,60,79,113,56
99180,814,407,407,129,193,85,118,207,82
99181,1873,925,948,308,496,121,346,476,126
99185,1393,670,723,185,293,192,184,342,197
99201,11302,6198,5104,1501,3900,797,1479,2703,922
99202,19696,9601,10095,3351,5079,1171,3617,4607,1871
99203,20990,9693,11297,2843,5031,1819,2800,5645,2852
99204,9924,4668,5256,1007,3186,475,1215,3041,1000
99205,43910,20891,23019,6936,10701,3254,6667,11529,4823
99206,31581,15351,16230,5186,7919,2246,4973,8103,3154
99207,38460,18342,20118,6459,9683,2200,6342,10130,3646
99208,34492,16825,17667,5557,8473,2795,5152,8730,3785
99212,18394,9085,9309,2532,4989,1564,2477,4945,1887
99216,21961,10535,11426,3457,5526,1552,3456,5683,2287
99217,11249,5705,5544,2074,2989,642,1916,2940,688
99218,13117,6112,7005,2314,2798,1000,2460,3134,1411
99223,25680,12376,13304,4216,6414,1746,3947,7086,2271
99224,15971,9037,6934,2032,5900,1105,1785,4043,1106
99301,40936,21060,19876,8768,10040,2252,7946,9418,2512
99320,8187,4158,4029,1516,2086,556,1487,2097,445
99321,585,277,308,143,128,6,165,128,15
99322,254,132,122,48,77,7,47,65,10
99323,3604,1815,1789,644,966,205,596,960,233
99324,8286,4003,4283,1496,1826,681,1365,1884,1034
99326,3567,2043,1524,698,1155,190,639,694,191
99328,3739,1796,1943,526,890,380,542,927,474
99329,217,115,102,31,60,24,19,48,35
99330,712,399,313,160,201,38,78,189,46
99332,57,29,28,13,16,0,10,18,0
99335,336,177,159,61,95,21,54,91,14
99336,41030,20146,20884,7343,10565,2238,7517,10379,2988
99337,25050,12503,12547,4384,6459,1660,4065,6502,1980
99338,7726,3891,3835,1442,2100,349,1325,2087,423
99341,974,499,475,183,240,76,147,227,101
99343,3023,1630,1393,805,712,113,699,556,138
99344,13839,7136,6703,3112,3305,719,2917,2991,795
99345,261,147,114,74,71,2,64,48,2
99346,335,161,174,56,75,30,60,80,34
99347,2514,1262,1252,393,571,298,342,571,339
99348,1736,948,788,436,435,77,343,385,60
99349,5545,3132,2413,1393,1483,256,1104,1101,208
99350,11388,5838,5550,2364,2775,699,2088,2637,825
99352,38686,18991,19695,6244,9836,2911,5908,10105,3682
99353,9213,4560,4653,1607,2581,372,1641,2596,416
99356,223,128,95,63,48,17,39,42,14
99357,3896,2172,1724,995,1053,124,842,747,135
99359,63,32,31,4,14,14,7,11,13
99360,1109,560,549,189,268,103,177,288,84
99361,1955,988,967,354,436,198,308,469,190
99362,38215,19767,18448,6453,10367,2947,5869,8295,4284
99363,260,121,139,55,57,9,53,55,31
99371,396,197,199,47,94,56,49,91,59
99401,190,101,89,26,46,29,13,42,34
99402,1742,847,895,287,411,149,276,484,135
99403,18619,8835,9784,2875,4294,1666,2718,4752,2314
99501,16276,8494,7782,1981,5495,1018,1944,4269,1569
99502,18626,9270,9356,3290,5376,604,3247,5441,668
99503,13827,7224,6603,2062,4477,685,1943,3767,893
99504,37315,18403,18912,6576,10320,1507,6576,10391,1945
99505,5323,3153,2170,1467,1686,0,1064,1106,0
99506,6626,3581,3045,1843,1738,0,1583,1462,0
99507,27331,13799,13532,5214,7903,682,4615,8121,796
99508,33815,16704,17111,6140,9046,1518,6289,8980,1842
99513,182,42,140,42,0,0,29,111,0
99515,21309,10610,10699,3881,6052,677,3543,6433,723
99516,21679,10935,10744,3838,6297,800,3614,6410,720
99517,16716,8408,8308,2481,5157,770,2565,4881,862
99518,9245,4593,4652,1405,2831,357,1352,2919,381
99540,212,116,96,14,84,18,37,51,8
99546,279,182,97,36,141,5,24,66,7
99547,93,55,38,7,34,14,18,14,6
99548,132,62,70,24,32,6,35,27,8
99549,93,47,46,15,26,6,20,22,4
99550,289,138,151,44,75,19,64,74,13
99551,590,323,267,170,132,21,132,123,12
99552,280,147,133,78,54,15,61,49,23
99553,653,546,107,44,474,28,31,74,2
99554,662,344,318,186,105,53,159,126,33
99555,233,121,112,57,51,13,58,51,3
99556,2430,1292,1138,467,656,169,433,582,123
99557,803,423,380,183,205,35,176,182,22
99558,120,61,59,36,23,2,29,24,6
99559,7047,3686,3361,1611,1886,189,1436,1704,221
99561,355,183,172,88,86,9,95,66,11
99563,786,408,378,258,134,16,211,143,24
99564,89,56,33,25,20,11,10,20,3
99565,111,62,49,27,33,2,30,19,0
99566,153,80,73,26,40,14,27,39,7
99567,7649,3949,3700,1371,2320,258,1244,2169,287
99568,259,145,114,53,69,23,29,66,19
99569,84,43,41,16,22,5,17,16,8
99571,179,105,74,15,81,9,18,53,3
99572,322,183,139,58,94,31,23,75,41
99573,1207,646,561,235,325,86,210,288,63
99574,2557,1391,1166,484,773,134,365,701,100
99575,146,82,64,37,38,7,35,21,8
99576,2774,1413,1361,581,718,114,529,716,116
99577,22239,11286,10953,4320,6460,506,3948,6501,504
99578,260,142,118,60,66,16,52,63,3
99579,118,76,42,37,31,8,15,27,0
99580,106,54,52,26,24,4,29,20,3
99581,751,414,337,205,182,27,167,146,24
99583,75,44,31,13,29,2,12,17,2
99585,356,172,184,80,86,6,97,75,12
99586,590,342,248,100,187,55,73,152,23
99587,1884,1091,793,260,795,36,223,532,38
99588,1169,635,534,223,347,65,193,288,53
99589,236,125,111,51,67,7,59,46,6
99590,172,86,86,44,32,10,42,41,3
99591,140,68,72,27,39,2,31,37,4
99602,254,155,99,68,74,13,46,43,10
99603,8525,4275,4250,1481,2301,493,1475,2274,501
99604,1022,504,518,245,225,34,315,161,42
99605,127,88,39,23,51,14,10,29,0
99606,462,257,205,125,118,14,93,94,18
99607,252,121,131,59,50,12,69,52,10
99608,28,15,13,6,9,0,1,12,0
99609,545,268,277,141,107,20,147,114,16
99610,1639,830,809,279,477,74,287,448,74
99611,12126,6170,5956,2216,3416,538,2239,3159,558
99612,813,477,336,122,314,41,95,219,22
99613,443,257,186,82,156,19,54,122,10
99614,700,390,310,206,169,15,157,125,28
99615,13017,6976,6041,2571,3934,471,2255,3380,406
99620,608,329,279,198,117,14,147,109,23
99621,727,409,318,229,159,21,174,118,26
99622,317,183,134,101,71,11,58,67,9
99624,88,52,36,20,30,2,11,21,4
99625,110,65,45,24,33,8,18,22,5
99626,256,124,132,72,43,9,57,68,7
99627,417,215,202,87,106,22,82,110,10
99628,402,215,187,112,88,15,86,78,23
99630,193,104,89,32,60,12,37,38,14
99631,209,102,107,25,62,15,46,51,10
99632,723,356,367,169,165,22,193,148,26
99633,671,355,316,121,209,25,139,159,18
99634,339,199,140,111,79,9,55,67,18
99635,957,530,427,184,298,48,136,239,52
99636,479,269,210,128,114,27,96,98,16
99637,516,282,234,125,137,20,126,87,21
99638,58,29,29,12,11,6,10,13,6
99639,1000,521,479,135,299,87,137,275,67
99640,231,114,117,48,52,14,57,42,18
99641,439,225,214,106,109,10,114,90,10
99643,244,139,105,72,59,8,54,44,7
99644,229,115,114,27,64,24,46,56,12
99645,18941,9841,9100,3704,5260,877,3431,4744,925
99647,50,18,32,4,11,3,15,14,3
99648,100,49,51,26,20,3,26,25,0
99649,133,60,73,22,34,4,38,35,0
99650,543,297,246,178,102,17,124,98,24
99651,50,26,24,2,19,5,7,12,5
99652,3470,1842,1628,646,983,213,584,918,126
99653,135,67,68,19,37,11,28,34,6
99654,31091,16095,14996,6275,8662,1158,5635,8283,1078
99655,544,280,264,122,126,32,111,131,22
99656,44,23,21,5,12,6,10,10,1
99657,287,144,143,82,50,12,68,59,16
99658,656,375,281,178,168,29,124,138,19
99659,331,177,154,88,83,6,75,69,10
99660,590,336,254,121,204,11,87,137,30
99661,975,608,367,129,448,31,103,253,11
99662,441,221,220,123,81,17,110,98,12
99663,798,406,392,144,196,66,122,213,57
99664,4933,2871,2062,838,1807,226,670,1180,212
99665,142,76,66,40,36,0,30,27,9
99666,179,103,76,66,37,0,42,32,2
99667,144,97,47,38,53,6,13,30,4
99668,78,38,40,18,18,2,10,22,8
99669,13710,7060,6650,2611,3713,736,2063,3794,793
99670,144,86,58,26,49,11,13,36,9
99671,585,318,267,153,150,15,154,100,13
99672,2440,1191,1249,382,692,117,503,631,115
99674,901,447,454,140,238,69,150,241,63
99675,40,21,19,7,8,6,6,11,2
99676,1429,758,671,208,456,94,184,409,78
99677,95,49,46,20,25,4,19,20,7
99678,834,429,405,197,197,35,196,177,32
99679,438,226,212,98,110,18,88,108,16
99680,319,163,156,92,60,11,74,64,18
99681,286,174,112,77,80,17,56,49,7
99682,211,132,79,51,59,22,32,43,4
99683,452,242,210,44,167,31,70,140,0
99684,756,399,357,162,197,40,150,162,45
99685,783,423,360,89,324,10,94,262,4
99686,4065,2088,1977,707,1275,106,674,1179,124
99687,235,185,50,33,144,8,0,41,9
99688,2023,1064,959,308,607,149,311,522,126
99689,681,379,302,131,225,23,106,179,17
99690,243,127,116,70,49,8,53,56,7
99691,81,49,32,14,21,14,4,18,10
99692,3500,2421,1079,291,2048,82,214,817,48
99693,229,132,97,26,99,7,23,63,11
99694,556,327,229,117,177,33,63,140,26
99695,31,19,12,7,9,3,2,4,6
99697,18,11,7,2,8,1,0,7,0
99701,17554,8801,8753,2972,4855,974,2988,4586,1179
99702,5512,2844,2668,1412,1432,0,1366,1285,17
99703,7381,4151,3230,2024,2127,0,1577,1646,7
99704,223,188,35,23,151,14,4,23,8
99705,16421,8710,7711,3187,4985,538,2914,4377,420
99709,24230,12420,11810,3982,7432,1006,3822,7084,904
99712,9478,5031,4447,1792,2944,295,1528,2684,235
99714,986,508,478,101,315,92,108,314,56
99720,196,98,98,41,50,7,44,44,10
99721,316,163,153,69,84,10,85,56,12
99722,123,59,64,26,33,0,29,35,0
99723,4581,2411,2170,980,1297,134,929,1098,143
99724,137,85,52,39,45,1,28,19,5
99725,188,110,78,34,76,0,13,65,0
99726,93,49,44,16,33,0,18,23,3
99727,411,237,174,142,80,15,98,67,9
99729,258,122,136,17,87,18,36,82,18
99730,138,81,57,20,50,11,11,38,8
99732,5,4,1,0,2,2,0,0,1
99733,69,36,33,8,22,6,16,16,1
99736,139,67,72,29,34,4,33,30,9
99737,3930,2014,1916,814,1037,163,718,1021,177
99738,197,100,97,22,64,14,23,65,9
99739,356,209,147,107,80,22,66,66,15
99740,674,359,315,143,173,43,119,170,26
99741,679,398,281,183,196,19,100,157,24
99742,590,336,254,138,167,31,117,118,19
99743,995,553,442,160,369,24,160,258,24
99744,238,132,106,41,76,15,32,68,6
99745,75,40,35,17,16,7,14,14,7
99746,311,153,158,71,68,14,81,62,15
99747,274,145,129,55,77,13,51,58,20
99748,243,138,105,69,58,11,42,53,10
99749,361,208,153,126,70,12,78,63,12
99750,375,205,170,100,84,21,97,62,11
99751,126,62,64,39,16,7,37,22,5
99752,3082,1553,1529,666,791,96,699,726,104
99753,299,168,131,81,74,13,57,68,6
99754,94,44,50,12,28,4,20,20,10
99755,173,101,72,22,74,5,3,69,0
99756,81,45,36,12,26,7,2,24,10
99757,32,17,15,2,11,4,0,13,2
99758,249,128,121,52,61,15,62,42,17
99759,245,142,103,76,56,10,50,50,3
99760,773,424,349,133,226,65,113,180,56
99761,426,210,216,99,99,12,111,86,19
99762,3884,2115,1769,806,1142,167,661,917,191
99763,676,399,277,192,177,30,130,117,30
99764,359,183,176,58,102,23,81,88,7
99765,332,166,166,67,84,15,87,67,12
99766,760,421,339,221,176,24,165,142,32
99767,39,25,14,7,14,4,4,10,0
99768,186,95,91,50,38,7,37,46,8
99769,702,347,355,136,184,27,171,152,32
99770,764,407,357,220,162,25,217,116,24
99771,230,127,103,50,67,10,53,43,7
99772,549,311,238,146,135,30,98,118,22
99773,291,140,151,60,67,13,87,53,11
99774,85,50,35,15,27,8,15,16,4
99775,1049,591,458,401,190,0,301,157,0
99776,151,75,76,23,39,13,26,38,12
99777,305,172,133,76,89,7,49,68,16
99778,252,137,115,58,61,18,53,46,16
99779,95,66,29,27,34,5,12,13,4
99780,1414,706,708,236,380,90,245,387,76
99781,208,113,95,48,58,7,47,37,11
99782,558,288,270,118,137,33,128,119,23
99783,153,73,80,29,41,3,46,29,5
99784,210,107,103,50,39,18,57,36,10
99785,278,130,148,71,52,7,85,58,5
99786,245,114,131,63,45,6,66,54,11
99788,57,36,21,5,17,14,7,10,4
99789,422,259,163,138,104,17,66,79,18
99791,203,102,101,46,53,3,50,42,9
99801,28721,14502,14219,4901,8424,1177,4363,8481,1375
99820,573,312,261,117,159,36,102,132,27
99824,1990,984,1006,244,651,89,254,647,105
99825,78,41,37,3,30,8,14,14,9
99826,425,241,184,56,156,29,50,128,6
99827,2505,1266,1239,375,721,170,372,694,173
99829,1002,526,476,204,247,75,192,224,60
99830,715,374,341,137,203,34,126,174,41
99832,162,102,60,24,68,10,13,38,9
99833,3468,1829,1639,603,1009,217,528,904,207
99835,8764,4460,4304,1507,2447,506,1375,2382,547
99840,870,451,419,104,295,52,102,264,53
99841,85,36,49,6,28,2,14,26,9
99850,16,12,4,0,6,6,0,0,4
99901,14023,7092,6931,2371,4017,704,2253,3866,812
99903,20,8,12,0,4,4,2,6,4
99918,223,141,82,38,78,25,15,60,7
99919,576,306,270,82,193,31,102,150,18
99921,1907,1031,876,369,592,70,315,515,46
99922,398,226,172,92,96,38,72,84,16
99923,98,51,47,14,20,17,23,24,0
99925,959,538,421,177,296,65,151,225,45
99926,1447,768,679,297,404,67,283,332,64
99927,136,85,51,20,52,13,10,38,3
99929,2424,1247,1177,402,651,194,358,608,211
99950,47,27,20,6,21,0,8,12,0
